player_id,rank,name,tier,lp,win_rate,played,wins,losses,region
1,1,Mismatched Socks,CHALLENGER I,1569,21.4,499,107,392,na
2,2,Ms MatchedSocks,CHALLENGER I,1507,21.7,465,101,364,na
3,3,GrandVice8,CHALLENGER I,1480,19.9,801,159,642,na
4,4,Salvyyy,CHALLENGER I,1434,26.4,292,77,215,na
5,5,Kurumx,CHALLENGER I,1412,20.8,696,145,551,na
6,6,FluffyHS,CHALLENGER I,1338,18.4,461,85,376,na
7,7,gv8,CHALLENGER I,1260,21.2,598,127,471,na
8,8,bertasaurus,CHALLENGER I,1218,17.7,949,168,781,na
9,9,Naturesbf,CHALLENGER I,1168,15.5,976,151,825,na
10,10,Krmx,CHALLENGER I,1141,20.3,644,131,513,na
11,11,111094 R,CHALLENGER I,1117,13.8,1715,236,1479,na
12,12,JIGEJIUWO,CHALLENGER I,1107,16.6,535,89,446,na
13,13,ajmonsta,CHALLENGER I,1025,16.4,544,89,455,na
14,14,Old Lodo,CHALLENGER I,1008,16.8,411,69,342,na
15,15,Cottontail,CHALLENGER I,930,15.8,766,121,645,na
16,16,EAOST,CHALLENGER I,927,15.6,628,98,530,na
17,17,The Cxk,CHALLENGER I,907,17.5,584,102,482,na
18,18,Silliest,CHALLENGER I,880,25.3,367,93,274,na
19,19,ItzYaBoyBeasty,CHALLENGER I,869,17.2,1018,175,843,na
20,20,lLykus,CHALLENGER I,860,16.3,887,145,742,na
21,21,Inphinit3,CHALLENGER I,843,16.1,498,80,418,na
22,22,Grillsyy,CHALLENGER I,838,15.7,737,116,621,na
23,23,ttv KitingisHard,CHALLENGER I,819,17.2,958,165,793,na
24,24,M35S,CHALLENGER I,812,15.3,991,152,839,na
25,25,Kalsuo,CHALLENGER I,810,16.7,917,153,764,na
26,26,Kled Bundy,CHALLENGER I,807,13.6,1373,187,1186,na
27,27,Hiraino,CHALLENGER I,807,15.6,980,153,827,na
28,28,BIuePrincess,CHALLENGER I,801,18.3,251,46,205,na
29,29,enchabi,CHALLENGER I,799,16.1,299,48,251,na
30,30,dowfu ph,CHALLENGER I,793,20.1,273,55,218,na
31,31,inay,CHALLENGER I,786,15.9,1007,160,847,na
32,32,Agon,CHALLENGER I,779,17.7,835,148,687,na
33,33,Ripple Overdrive,CHALLENGER I,778,15.3,313,48,265,na
34,34,ttvGooGieGaminG,CHALLENGER I,775,14.9,462,69,393,na
35,35,Gunmay,CHALLENGER I,768,10.8,565,61,504,na
36,36,Flandre Bot,CHALLENGER I,762,16.4,250,41,209,na
37,37,Live for the Day,CHALLENGER I,760,19.4,846,164,682,na
38,38,TempestLife,CHALLENGER I,758,20.1,289,58,231,na
39,39,pastafartianist,CHALLENGER I,758,22.4,241,54,187,na
40,40,McDull,CHALLENGER I,756,14.6,837,122,715,na
41,41,C9 k3soju,CHALLENGER I,754,20.6,1035,213,822,na
42,42,Ol Lodo,CHALLENGER I,748,16.0,481,77,404,na
43,43,Me Starship,CHALLENGER I,748,17.2,326,56,270,na
44,44,Xeno,CHALLENGER I,742,20.4,308,63,245,na
45,45,wo chi bu pang,CHALLENGER I,741,17.8,303,54,249,na
46,46,HiROKKKKJP,CHALLENGER I,740,16.3,626,102,524,na
47,47,VX15152242663,CHALLENGER I,739,19.7,604,119,485,na
48,48,Nice Mister Kien,CHALLENGER I,736,16.8,494,83,411,na
49,49,Wrackle,CHALLENGER I,736,13.9,395,55,340,na
50,50,wx qq258790278,CHALLENGER I,735,19.2,432,83,349,na
51,51,PureAlohaa,CHALLENGER I,724,16.9,391,66,325,na
52,52,GoyoTV,CHALLENGER I,719,15.4,883,136,747,na
53,53,Kiyoon,CHALLENGER I,713,18.5,1016,188,828,na
54,54,WhySofaKing,CHALLENGER I,706,14.6,514,75,439,na
55,55,TwitchTV Odyceuz,CHALLENGER I,703,17.9,490,88,402,na
56,56,Sun Astronaut,CHALLENGER I,699,14.6,349,51,298,na
57,57,Zadust TFT,CHALLENGER I,695,15.7,592,93,499,na
58,58,matchedsock,CHALLENGER I,694,18.8,138,26,112,na
59,59,NA SMURF KEKW,CHALLENGER I,684,17.0,224,38,186,na
60,60,ChrisKillsX,CHALLENGER I,683,19.2,167,32,135,na
61,61,Fxxx Yaaa,CHALLENGER I,681,17.8,422,75,347,na
62,62,Broccóli,CHALLENGER I,680,14.4,534,77,457,na
63,63,Ex Railgun,CHALLENGER I,674,16.7,789,132,657,na
64,64,bu sheng qi,CHALLENGER I,671,18.8,549,103,446,na
65,65,Jangsterang,CHALLENGER I,669,15.4,403,62,341,na
66,66,Xerluk,CHALLENGER I,666,13.8,682,94,588,na
67,67,lilsteppy,CHALLENGER I,665,20.7,401,83,318,na
68,68,morellos,CHALLENGER I,660,17.6,279,49,230,na
69,69,Stompalittle,CHALLENGER I,657,14.6,1277,187,1090,na
70,70,ogapmaler cuck,CHALLENGER I,657,24.2,153,37,116,na
71,71,Simple Plan,CHALLENGER I,654,14.3,631,90,541,na
72,72,MaskedPatel,CHALLENGER I,649,15.7,249,39,210,na
73,73,Kira,CHALLENGER I,647,16.7,588,98,490,na
74,74,Jaekun2maX,CHALLENGER I,647,18.2,274,50,224,na
75,75,BentoBot,CHALLENGER I,644,15.4,696,107,589,na
76,76,influrrier,CHALLENGER I,642,16.1,953,153,800,na
77,77,WANG SHUO ZHE,CHALLENGER I,641,18.1,292,53,239,na
78,78,Sphinx,CHALLENGER I,640,9.9,759,75,684,na
79,79,theMaskedPatel,CHALLENGER I,640,16.5,328,54,274,na
80,80,Moggy Mako,CHALLENGER I,638,9.1,670,61,609,na
81,81,A shadowy figure,CHALLENGER I,636,15.8,603,95,508,na
82,82,BeIiever,CHALLENGER I,635,21.0,629,132,497,na
83,83,FroSteeMate,CHALLENGER I,633,15.0,1192,179,1013,na
84,84,zzzzzzZ7,CHALLENGER I,632,19.3,259,50,209,na
85,85,Eason with U,CHALLENGER I,628,20.0,310,62,248,na
86,86,MegaInfernoBomb,CHALLENGER I,628,16.1,286,46,240,na
87,87,TheMagykal,CHALLENGER I,627,16.6,935,155,780,na
88,88,Akurai,CHALLENGER I,627,18.0,355,64,291,na
89,89,Ian952,CHALLENGER I,626,17.4,569,99,470,na
90,90,TFTbigJB,CHALLENGER I,624,17.2,460,79,381,na
91,91,Elvisbeback,CHALLENGER I,622,11.0,327,36,291,na
92,92,Cris,CHALLENGER I,621,14.1,1506,213,1293,na
93,93,Midrash,CHALLENGER I,620,16.1,410,66,344,na
94,94,firest0ne,CHALLENGER I,618,7.5,1644,124,1520,na
95,95,TTV iantyler,CHALLENGER I,615,17.2,360,62,298,na
96,96,DxnTFT,CHALLENGER I,611,15.9,830,132,698,na
97,97,ME EIGHTH,CHALLENGER I,605,16.5,242,40,202,na
98,98,Doublezzzz,CHALLENGER I,604,13.5,695,94,601,na
99,99,Me Predator,CHALLENGER I,604,18.1,321,58,263,na
100,100,Agaze,CHALLENGER I,604,17.2,233,40,193,na
101,101,DreamErica,CHALLENGER I,603,14.5,1028,149,879,na
102,102,Ashe The Frost,CHALLENGER I,602,11.3,689,78,611,na
103,103,SalvyWintrade69,CHALLENGER I,602,15.9,258,41,217,na
104,104,Aesah,CHALLENGER I,601,19.3,638,123,515,na
105,105,PockyGom,CHALLENGER I,600,15.7,738,116,622,na
106,106,slippinbug,CHALLENGER I,600,17.3,306,53,253,na
107,107,DoraAmon,CHALLENGER I,600,27.4,124,34,90,na
108,108,17º C,CHALLENGER I,596,18.6,458,85,373,na
109,109,piggy2448,CHALLENGER I,596,18.7,380,71,309,na
110,110,birdwings,CHALLENGER I,594,13.3,352,47,305,na
111,111,chainpullz,CHALLENGER I,593,13.9,338,47,291,na
112,112,P1KACHuuuuuuu,CHALLENGER I,593,31.1,103,32,71,na
113,113,Sojin,CHALLENGER I,589,15.6,854,133,721,na
114,114,TTV Kenya1,CHALLENGER I,589,15.3,710,109,601,na
115,115,Stonerule,CHALLENGER I,587,17.1,456,78,378,na
116,116,Humilis,CHALLENGER I,585,13.1,291,38,253,na
117,117,Souless,CHALLENGER I,584,23.1,190,44,146,na
118,118,Visual,CHALLENGER I,583,16.8,495,83,412,na
119,119,H2211,CHALLENGER I,582,19.3,1287,249,1038,na
120,120,21 Zsy,CHALLENGER I,576,21.1,512,108,404,na
121,121,garet,CHALLENGER I,575,14.0,573,80,493,na
122,122,El Conejo Malo,CHALLENGER I,569,20.3,291,59,232,na
123,123,OrAnGe JuIc3,CHALLENGER I,568,13.2,408,54,354,na
124,124,KurumsSoreNut,CHALLENGER I,568,25.5,149,38,111,na
125,125,Doril,CHALLENGER I,567,13.1,1364,179,1185,na
126,126,Lab Member 001,CHALLENGER I,565,15.8,355,56,299,na
127,127,2418,CHALLENGER I,565,14.2,358,51,307,na
128,128,Purify,CHALLENGER I,561,13.4,1091,146,945,na
129,129,TacticalLukarina,CHALLENGER I,561,15.0,844,127,717,na
130,130,lnaban,CHALLENGER I,561,15.5,676,105,571,na
131,131,paulhnlee,CHALLENGER I,560,22.0,232,51,181,na
132,132,Blaim,CHALLENGER I,559,16.2,717,116,601,na
133,133,Tinkady,CHALLENGER I,558,18.4,593,109,484,na
134,134,WúJi,CHALLENGER I,558,17.2,273,47,226,na
135,135,Catybear,CHALLENGER I,557,15.3,491,75,416,na
136,136,Scoped32,CHALLENGER I,557,15.9,415,66,349,na
137,137,zugrug,CHALLENGER I,556,13.3,817,109,708,na
138,138,xin luan le,CHALLENGER I,556,14.9,435,65,370,na
139,139,Muffinn TFT,CHALLENGER I,555,18.7,225,42,183,na
140,140,NED carry,CHALLENGER I,554,17.5,331,58,273,na
141,141,Coleman TFT,CHALLENGER I,554,18.7,225,42,183,na
142,142,DeadlyCO2,CHALLENGER I,552,11.9,545,65,480,na
143,143,tinkady69,CHALLENGER I,552,17.0,253,43,210,na
144,144,chitosechitose,CHALLENGER I,551,14.0,665,93,572,na
145,145,Nhân tâm TFT,CHALLENGER I,549,18.2,285,52,233,na
146,146,blackwhited,CHALLENGER I,548,14.6,446,65,381,na
147,147,Flashbâng,CHALLENGER I,547,9.1,888,81,807,na
148,148,birdy511,CHALLENGER I,547,15.3,373,57,316,na
149,149,anmin9nb,CHALLENGER I,546,14.4,556,80,476,na
150,150,dpei,CHALLENGER I,546,16.6,457,76,381,na
151,151,Bonzolo,CHALLENGER I,545,15.1,830,125,705,na
152,152,FinaldF,CHALLENGER I,544,13.0,1398,182,1216,na
153,153,kpopfan7,CHALLENGER I,544,13.5,170,23,147,na
154,154,Terde,CHALLENGER I,542,17.6,624,110,514,na
155,155,robinsongz,CHALLENGER I,542,15.8,443,70,373,na
156,156,OmniPie,CHALLENGER I,541,13.7,911,125,786,na
157,157,TheHentaiGod,CHALLENGER I,541,15.6,748,117,631,na
158,158,Twitch RayditzFN,CHALLENGER I,540,15.8,1243,196,1047,na
159,159,RIOT thatsPRIMAL,CHALLENGER I,540,11.2,958,107,851,na
160,160,Yiggles,CHALLENGER I,536,15.3,847,130,717,na
161,161,Nhân Tâm,CHALLENGER I,536,17.2,413,71,342,na
162,162,ttvidontdocardio,CHALLENGER I,535,14.2,330,47,283,na
163,163,kavan,CHALLENGER I,534,15.1,450,68,382,na
164,164,Eunwilf,CHALLENGER I,534,18.0,317,57,260,na
165,165,Gurt Games,CHALLENGER I,534,9.2,523,48,475,na
166,166,ˉ dà mó wáng,CHALLENGER I,533,15.3,569,87,482,na
167,167,xplitcit,CHALLENGER I,532,14.6,949,139,810,na
168,168,KomradeKush,CHALLENGER I,532,12.0,819,98,721,na
169,169,iCopyKeane,CHALLENGER I,532,11.9,361,43,318,na
170,170,Wolves Save Me,CHALLENGER I,531,13.1,1041,136,905,na
171,171,Partnerkiller 02,CHALLENGER I,531,16.5,534,88,446,na
172,172,JayGeBee,CHALLENGER I,529,14.3,677,97,580,na
173,173,NicholasLy6,CHALLENGER I,529,19.8,293,58,235,na
174,174,TTVHentaiGodTFT,CHALLENGER I,529,19.3,212,41,171,na
175,175,Meeet,CHALLENGER I,526,16.6,903,150,753,na
176,176,TurboARAM,CHALLENGER I,526,14.6,556,81,475,na
177,177,Pawnup,CHALLENGER I,526,14.0,364,51,313,na
178,178,Lemon IceCream,CHALLENGER I,525,12.7,755,96,659,na
179,179,DannySaysNo,CHALLENGER I,524,14.9,592,88,504,na
180,180,MikeP,CHALLENGER I,524,17.4,155,27,128,na
181,181,Liquid Saint,CHALLENGER I,523,19.3,362,70,292,na
182,182,Jaekun4maX,CHALLENGER I,523,22.7,185,42,143,na
183,183,Wowjee,CHALLENGER I,523,29.3,133,39,94,na
184,184,C9 Khroen,CHALLENGER I,522,19.1,387,74,313,na
185,185,RippleOverdrive2,CHALLENGER I,522,21.3,183,39,144,na
186,186,x BadlandzTV x,CHALLENGER I,520,18.1,215,39,176,na
187,187,AndyofLove,CHALLENGER I,517,17.0,312,53,259,na
188,188,Evo BiBaBo,CHALLENGER I,517,18.9,212,40,172,na
189,189,anewwplayer,CHALLENGER I,514,18.2,291,53,238,na
190,190,Kłaytøn,CHALLENGER I,512,15.0,514,77,437,na
191,191,In Your Eye,CHALLENGER I,511,26.4,220,58,162,na
192,192,Masterman,CHALLENGER I,510,15.4,817,126,691,na
193,193,Jaekun1maX,CHALLENGER I,510,18.2,274,50,224,na
194,194,AndyofSmurf,CHALLENGER I,510,19.1,188,36,152,na
195,195,CounTerWu,CHALLENGER I,506,13.6,674,92,582,na
196,196,BlackBigBig,CHALLENGER I,502,18.1,548,99,449,na
197,197,George Brown TFT,CHALLENGER I,499,14.4,499,72,427,na
198,198,piglet2448,CHALLENGER I,485,20.5,229,47,182,na
199,199,v Köi v,CHALLENGER I,414,21.6,374,81,293,na
200,200,Oonnii,CHALLENGER I,326,20.3,364,74,290,na
201,1,cuckmyblade,CHALLENGER I,1685,24.7,518,128,390,br
202,2,brüninho,CHALLENGER I,1683,21.2,599,127,472,br
203,3,Zadust,CHALLENGER I,1553,33.4,347,116,231,br
204,4,Odyceuz,CHALLENGER I,1413,24.1,507,122,385,br
205,5,tartaruguinhas2,CHALLENGER I,1320,21.7,581,126,455,br
206,6,inc mplete,CHALLENGER I,1304,17.2,777,134,643,br
207,7,Slooper,CHALLENGER I,1302,24.6,374,92,282,br
208,8,techzz,CHALLENGER I,1292,23.4,631,148,483,br
209,9,eusouolucas,CHALLENGER I,1244,18.4,729,134,595,br
210,10,FabledDofus,CHALLENGER I,1231,19.5,513,100,413,br
211,11,Higuree,CHALLENGER I,1160,21.3,550,117,433,br
212,12,Paralelepipo,CHALLENGER I,1153,26.1,257,67,190,br
213,13,ftdrain,CHALLENGER I,1140,30.1,292,88,204,br
214,14,BarksdaIe,CHALLENGER I,1096,28.6,252,72,180,br
215,15,m3rdapequena,CHALLENGER I,993,26.3,262,69,193,br
216,16,Archway,CHALLENGER I,960,17.0,446,76,370,br
217,17,Gúne,CHALLENGER I,955,23.0,430,99,331,br
218,18,Serask,CHALLENGER I,947,21.5,549,118,431,br
219,19,Dairon,CHALLENGER I,945,21.3,324,69,255,br
220,20,Medico do SUS22,CHALLENGER I,929,17.9,621,111,510,br
221,21,Mierdagrande,CHALLENGER I,881,29.2,219,64,155,br
222,22,Past,CHALLENGER I,872,25.1,474,119,355,br
223,23,TG Wed,CHALLENGER I,804,16.9,724,122,602,br
224,24,Miss Queen,CHALLENGER I,791,13.2,395,52,343,br
225,25,the ego illusion,CHALLENGER I,767,25.0,312,78,234,br
226,26,Jael TFT,CHALLENGER I,763,20.4,412,84,328,br
227,27,CD ERICK,CHALLENGER I,761,18.0,267,48,219,br
228,28,Twitch NickTFT,CHALLENGER I,758,21.3,540,115,425,br
229,29,RFK Azura,CHALLENGER I,755,26.4,473,125,348,br
230,30,Billy Bait,CHALLENGER I,739,16.3,761,124,637,br
231,31,Nescau Insolúvel,CHALLENGER I,737,19.6,347,68,279,br
232,32,escolinha do inc,CHALLENGER I,734,21.3,427,91,336,br
233,33,Yvissaur,CHALLENGER I,731,22.2,315,70,245,br
234,34,Lünna,CHALLENGER I,728,20.1,829,167,662,br
235,35,Haxwei,CHALLENGER I,726,19.0,216,41,175,br
236,36,OOO,CHALLENGER I,721,18.4,517,95,422,br
237,37,Royal Kvasterr,CHALLENGER I,717,14.6,445,65,380,br
238,38,mDobZ,CHALLENGER I,714,18.2,264,48,216,br
239,39,BlasHelldder,CHALLENGER I,712,19.1,423,81,342,br
240,40,T F Toddy,CHALLENGER I,707,25.6,160,41,119,br
241,41,Garras of Rivia,CHALLENGER I,698,23.7,300,71,229,br
242,42,LOVER 97,CHALLENGER I,693,14.7,218,32,186,br
243,43,odyceuZEDeletric,CHALLENGER I,692,42.0,100,42,58,br
244,44,Koala Esbelto,CHALLENGER I,691,19.9,729,145,584,br
245,45,MATEUS DO SUS DF,CHALLENGER I,691,16.5,491,81,410,br
246,46,Felipolv000,CHALLENGER I,691,20.7,217,45,172,br
247,47,Vowtz,CHALLENGER I,690,16.6,362,60,302,br
248,48,Irisdescent,CHALLENGER I,681,20.8,260,54,206,br
249,49,Encatroll é trix,CHALLENGER I,681,15.8,304,48,256,br
250,50,DEZZlN,CHALLENGER I,680,16.8,493,83,410,br
251,51,TFT Azura,"GRANDMASTER I
G",733,24.0,242,58,184,br
252,52,TFT Médico,"GRANDMASTER I
G",707,21.3,197,42,155,br
253,53,HawkEyeCs7,"GRANDMASTER I
G",668,17.2,692,119,573,br
254,54,Melança,"GRANDMASTER I
G",661,16.6,694,115,579,br
255,55,O HIPER CRIME,"GRANDMASTER I
G",646,14.8,425,63,362,br
256,56,Tsuuzaki,"GRANDMASTER I
G",632,20.3,478,97,381,br
257,57,AdrianoK,"GRANDMASTER I
G",623,17.6,353,62,291,br
258,58,Neves,"GRANDMASTER I
G",596,17.9,374,67,307,br
259,59,Lula Livrão TFT,"GRANDMASTER I
G",592,15.7,452,71,381,br
260,60,TwitchTV Patr0ci,"GRANDMASTER I
G",566,15.6,770,120,650,br
261,61,SÄNT hyun,"GRANDMASTER I
G",563,13.6,822,112,710,br
262,62,Bioosfera,"GRANDMASTER I
G",557,15.5,483,75,408,br
263,63,Shinobu300,"GRANDMASTER I
G",504,19.1,398,76,322,br
264,64,Nihonjin,"GRANDMASTER I
G",495,18.1,403,73,330,br
265,65,Jvão,"GRANDMASTER I
G",492,19.1,529,101,428,br
266,66,O HIPER CARRY,"GRANDMASTER I
G",492,15.0,572,86,486,br
267,67,Titos,"GRANDMASTER I
G",480,18.0,449,81,368,br
268,68,tft igor18,"GRANDMASTER I
G",477,22.3,197,44,153,br
269,69,CD CFCDuuuuds,"GRANDMASTER I
G",468,13.9,776,108,668,br
270,70,B Lara,"GRANDMASTER I
G",453,21.3,338,72,266,br
271,71,Kirbyzin,"GRANDMASTER I
G",450,16.0,676,108,568,br
272,72,kirinde,"GRANDMASTER I
G",442,14.3,704,101,603,br
273,73,Tallis Sauro,"GRANDMASTER I
G",431,18.3,349,64,285,br
274,74,souumlucas,"GRANDMASTER I
G",429,24.5,139,34,105,br
275,75,Bandu,"GRANDMASTER I
G",425,17.6,527,93,434,br
276,76,Goiano,"GRANDMASTER I
G",407,15.5,388,60,328,br
277,77,Allahu TK,"GRANDMASTER I
G",401,12.7,1023,130,893,br
278,78,Duest,"GRANDMASTER I
G",391,17.9,229,41,188,br
279,79,HeathClyff,"GRANDMASTER I
G",387,19.9,251,50,201,br
280,80,R Angra,"GRANDMASTER I
G",380,17.5,332,58,274,br
281,81,Siilent,"GRANDMASTER I
G",359,14.6,690,101,589,br
282,82,NeeverGiveUp,"GRANDMASTER I
G",345,14.3,488,70,418,br
283,83,itzzLara,"GRANDMASTER I
G",340,16.1,229,37,192,br
284,84,Yuu Better,"GRANDMASTER I
G",337,14.2,1519,215,1304,br
285,85,l Hyper Carry,"GRANDMASTER I
G",333,16.9,1024,173,851,br
286,86,faker indiano,"GRANDMASTER I
G",333,14.7,489,72,417,br
287,87,TWITCHTV Stykr,"GRANDMASTER I
G",328,20.8,342,71,271,br
288,88,Levi,"GRANDMASTER I
G",305,21.2,481,102,379,br
289,89,Batata Rufles,"GRANDMASTER I
G",304,17.8,287,51,236,br
290,90,RafaStark,"GRANDMASTER I
G",301,17.9,285,51,234,br
291,91,Hisekken,"GRANDMASTER I
G",296,16.5,393,65,328,br
292,92,Vampyrus,"GRANDMASTER I
G",290,17.4,878,153,725,br
293,93,Mon Nom,"GRANDMASTER I
G",289,15.0,712,107,605,br
294,94,RAHZAO TFT,"GRANDMASTER I
G",289,9.6,686,66,620,br
295,95,Flangonator,"GRANDMASTER I
G",286,16.2,523,85,438,br
296,96,CD Koiti,"GRANDMASTER I
G",284,17.4,276,48,228,br
297,97,twitch narkesh1,"GRANDMASTER I
G",283,19.7,330,65,265,br
298,98,MonteiroLombrado,"GRANDMASTER I
G",277,14.2,449,64,385,br
299,99,Eu só jogo TFT,"GRANDMASTER I
G",264,17.8,614,109,505,br
300,100,Zamora Lindão,"GRANDMASTER I
G",264,11.3,424,48,376,br
301,101,JhoyLow,"GRANDMASTER I
G",256,21.3,197,42,155,br
302,102,Mino Th,"GRANDMASTER I
G",256,19.9,166,33,133,br
303,103,y Satsue,"GRANDMASTER I
G",255,13.4,142,19,123,br
304,104,Sâm,"GRANDMASTER I
G",254,9.9,932,92,840,br
305,105,Edinaldo Safadão,"GRANDMASTER I
G",254,14.4,299,43,256,br
306,106,LosAngelesLakers,"GRANDMASTER I
G",254,20.4,157,32,125,br
307,107,maçãcomcanela,"GRANDMASTER I
G",253,13.3,474,63,411,br
308,108,divino Jax JG,"GRANDMASTER I
G",252,11.1,1046,116,930,br
309,109,gazzsinhoxD,"GRANDMASTER I
G",251,16.9,254,43,211,br
310,110,SKEPET,"GRANDMASTER I
G",250,12.0,565,68,497,br
311,111,CD Noah Hunter,"GRANDMASTER I
G",248,15.2,355,54,301,br
312,112,twí,"GRANDMASTER I
G",245,15.3,313,48,265,br
313,113,MinoThalysson,"GRANDMASTER I
G",242,22.9,258,59,199,br
314,114,BARbahh,"GRANDMASTER I
G",241,15.1,324,49,275,br
315,115,Beastar,"GRANDMASTER I
G",240,17.4,305,53,252,br
316,116,huggz,"GRANDMASTER I
G",239,17.6,944,166,778,br
317,117,GarrastaClean,"GRANDMASTER I
G",238,20.4,265,54,211,br
318,118,Daníela,"GRANDMASTER I
G",238,17.3,225,39,186,br
319,119,BieuL,"GRANDMASTER I
G",236,17.8,303,54,249,br
320,120,Sènna,"GRANDMASTER I
G",233,10.5,420,44,376,br
321,121,Crackudo Pistola,"GRANDMASTER I
G",232,15.6,308,48,260,br
322,122,Doutor Wily,"GRANDMASTER I
G",231,24.1,303,73,230,br
323,123,Don Batatone,"GRANDMASTER I
G",231,12.3,227,28,199,br
324,124,Ovas de Peixe,"GRANDMASTER I
G",230,14.9,589,88,501,br
325,125,Rubimhood 2,"GRANDMASTER I
G",229,19.0,163,31,132,br
326,126,mitastico,"GRANDMASTER I
G",228,16.1,317,51,266,br
327,127,Mestre Akroma,"GRANDMASTER I
G",226,11.6,1121,130,991,br
328,128,É o tal do Lula,"GRANDMASTER I
G",226,25.9,340,88,252,br
329,129,JahBullOn,"GRANDMASTER I
G",226,12.8,374,48,326,br
330,130,Walladi,"GRANDMASTER I
G",225,15.8,196,31,165,br
331,131,DonCrazy,"GRANDMASTER I
G",224,12.2,825,101,724,br
332,132,Park Ro Jin,"GRANDMASTER I
G",224,14.6,309,45,264,br
333,133,ivelthin2,"GRANDMASTER I
G",224,15.2,224,34,190,br
334,134,Greafen,"GRANDMASTER I
G",223,17.6,573,101,472,br
335,135,MominhoGameplays,"GRANDMASTER I
G",222,17.7,406,72,334,br
336,136,NgMartins,"GRANDMASTER I
G",221,13.6,627,85,542,br
337,137,Royalzito,"GRANDMASTER I
G",218,17.5,452,79,373,br
338,138,AcidoVoador,"GRANDMASTER I
G",217,21.6,444,96,348,br
339,139,killua do rj,"GRANDMASTER I
G",216,12.1,688,83,605,br
340,140,SKT1 RyuZUU,"GRANDMASTER I
G",216,14.5,275,40,235,br
341,141,Djcaveira TFT,"GRANDMASTER I
G",215,17.4,637,111,526,br
342,142,Warrior Lulis,"GRANDMASTER I
G",214,20.5,224,46,178,br
343,143,vcs sao pateta,"GRANDMASTER I
G",208,12.4,671,83,588,br
344,144,Heathcote,"GRANDMASTER I
G",207,15.3,248,38,210,br
345,145,FrostxD1,"GRANDMASTER I
G",204,12.5,1038,130,908,br
346,146,Numb3r2,"GRANDMASTER I
G",203,17.7,367,65,302,br
347,147,Smurf divino Jax,"GRANDMASTER I
G",187,20.3,315,64,251,br
348,148,MarrZ,"GRANDMASTER I
G",172,9.2,434,40,394,br
349,149,Fake Texugo,"GRANDMASTER I
G",171,18.2,269,49,220,br
350,150,Advomago,"GRANDMASTER I
G",149,15.2,151,23,128,br
351,151,HeathClyff TFT,MASTER I,228,18.3,169,31,138,br
352,152,Junho de 1979,MASTER I,227,19.6,290,57,233,br
353,153,Carinha de Raiva,MASTER I,207,18.5,265,49,216,br
354,154,Ruivão,MASTER I,203,21.0,224,47,177,br
355,155,Vermei,MASTER I,203,13.2,334,44,290,br
356,156,RyüZU,MASTER I,200,12.6,507,64,443,br
357,157,TAKOKUCHEIROSO,MASTER I,199,16.5,243,40,203,br
358,158,RESIDENT DA ESCS,MASTER I,196,13.6,874,119,755,br
359,159,Noé Mechanics,MASTER I,187,12.2,369,45,324,br
360,160,LEONERIX,MASTER I,183,13.0,370,48,322,br
361,161,Ezo,MASTER I,181,16.6,578,96,482,br
362,162,jelly roll blues,MASTER I,181,14.9,504,75,429,br
363,163,Lucas reformado,MASTER I,180,17.1,397,68,329,br
364,164,Kawori Miyazono,MASTER I,176,9.6,1097,105,992,br
365,165,Paciente67,MASTER I,163,24.0,129,31,98,br
366,166,Jokerrx,MASTER I,156,15.6,211,33,178,br
367,167,Roubaram o meu,MASTER I,153,15.3,176,27,149,br
368,168,Viking Vaporuub,MASTER I,150,19.4,232,45,187,br
369,169,xXperrsonXx,MASTER I,142,18.9,280,53,227,br
370,170,Guizi16,MASTER I,141,22.8,202,46,156,br
371,171,JUJU DO TFT,MASTER I,138,8.1,1074,87,987,br
372,172,xGottschalk,MASTER I,137,19.5,410,80,330,br
373,173,Inside Digitally,MASTER I,137,21.7,161,35,126,br
374,174,XebeckX3,MASTER I,136,17.2,314,54,260,br
375,175,sir blackpwner,MASTER I,131,10.3,643,66,577,br
376,176,Arckie,MASTER I,130,19.4,365,71,294,br
377,177,HIGOR HIGOR TFT,MASTER I,130,18.8,345,65,280,br
378,178,xShanks,MASTER I,129,13.0,253,33,220,br
379,179,GlaucondE,MASTER I,128,12.7,181,23,158,br
380,180,SannTFT,MASTER I,125,18.5,400,74,326,br
381,181,Cheleia,MASTER I,124,13.5,260,35,225,br
382,182,Cadê a namorada,MASTER I,123,11.5,408,47,361,br
383,183,betorino,MASTER I,116,17.1,1119,191,928,br
384,184,Adboy,MASTER I,116,19.2,276,53,223,br
385,185,LuizeteDELICIA,MASTER I,116,19.0,273,52,221,br
386,186,Le ismym4in,MASTER I,115,13.2,205,27,178,br
387,187,Scaith,MASTER I,111,26.2,80,21,59,br
388,188,BtG Wonderweiss,MASTER I,110,14.3,439,63,376,br
389,189,maça docinha,MASTER I,107,16.2,277,45,232,br
390,190,BixoCarpado,MASTER I,107,15.1,172,26,146,br
391,191,MAMI TIROTEIO,MASTER I,103,18.7,182,34,148,br
392,192,GaB1el,MASTER I,102,17.3,821,142,679,br
393,193,Aphroddi,MASTER I,100,17.3,295,51,244,br
394,194,Batooré,MASTER I,100,19.4,253,49,204,br
395,195,anuib,MASTER I,99,8.9,927,83,844,br
396,196,dedinho do lula,MASTER I,98,12.5,288,36,252,br
397,197,Gonzalez666,MASTER I,94,11.3,479,54,425,br
398,198,Hi Im Kartoffel,MASTER I,91,21.8,197,43,154,br
399,199,PheonixS W,MASTER I,90,18.7,391,73,318,br
400,200,RV Thrash,MASTER I,90,16.8,131,22,109,br
401,1,DaSaEbaVMo6niq,CHALLENGER I,1733,25.7,448,115,333,eune
402,2,TFT Hadaf,CHALLENGER I,1420,26.0,450,117,333,eune
403,3,Deepityy,CHALLENGER I,1171,26.6,282,75,207,eune
404,4,Chinese Superbot,CHALLENGER I,1154,24.7,750,185,565,eune
405,5,Deepityyy,CHALLENGER I,1115,29.4,282,83,199,eune
406,6,Barbalofono,CHALLENGER I,1026,14.1,547,77,470,eune
407,7,wenfan,CHALLENGER I,1025,25.9,228,59,169,eune
408,8,nuenueyouyuegou,CHALLENGER I,1014,30.7,231,71,160,eune
409,9,Hi Im Hadaf,CHALLENGER I,991,21.5,288,62,226,eune
410,10,Sting Youclif,CHALLENGER I,956,21.1,251,53,198,eune
411,11,ShayonZ,CHALLENGER I,943,24.6,406,100,306,eune
412,12,H4rlequinForest,CHALLENGER I,933,12.3,1046,129,917,eune
413,13,Abo Sreee3,CHALLENGER I,883,26.0,389,101,288,eune
414,14,Kier0n,CHALLENGER I,874,24.9,253,63,190,eune
415,15,yingyi,CHALLENGER I,871,24.9,189,47,142,eune
416,16,Quevash,CHALLENGER I,849,20.8,259,54,205,eune
417,17,Nevilter,CHALLENGER I,792,15.2,387,59,328,eune
418,18,Thrae,CHALLENGER I,780,23.2,564,131,433,eune
419,19,Cebo v9,CHALLENGER I,772,23.5,187,44,143,eune
420,20,Ambitious Noob,CHALLENGER I,743,21.9,366,80,286,eune
421,21,BBit,CHALLENGER I,737,25.6,168,43,125,eune
422,22,End of The Line,CHALLENGER I,728,15.4,1090,168,922,eune
423,23,Kumihowo,CHALLENGER I,712,26.6,192,51,141,eune
424,24,pjsaig,CHALLENGER I,675,31.5,130,41,89,eune
425,25,masterboi,CHALLENGER I,666,13.3,480,64,416,eune
426,26,LuQ876,CHALLENGER I,662,14.4,755,109,646,eune
427,27,Maro0N,CHALLENGER I,659,25.8,159,41,118,eune
428,28,Swimmable Toast,CHALLENGER I,652,28.7,143,41,102,eune
429,29,Im Sneaky,CHALLENGER I,649,16.9,603,102,501,eune
430,30,Tokuchi Toua,CHALLENGER I,643,18.7,257,48,209,eune
431,31,shonun,CHALLENGER I,641,27.4,135,37,98,eune
432,32,Sesard,CHALLENGER I,633,16.8,297,50,247,eune
433,33,Fadder,CHALLENGER I,628,18.1,487,88,399,eune
434,34,Brynool,CHALLENGER I,623,22.1,253,56,197,eune
435,35,Tryndabeard TTV,CHALLENGER I,620,22.0,209,46,163,eune
436,36,ŹZ ZZ ZZ ZZ ZZ,CHALLENGER I,611,16.0,1042,167,875,eune
437,37,hemourenya,CHALLENGER I,610,20.8,283,59,224,eune
438,38,Tw1stedFate1,CHALLENGER I,605,26.2,183,48,135,eune
439,39,JaguarKWT,CHALLENGER I,600,15.9,195,31,164,eune
440,40,earlyheart,CHALLENGER I,594,23.7,190,45,145,eune
441,41,Endø,CHALLENGER I,592,16.9,301,51,250,eune
442,42,WP Szati,CHALLENGER I,591,20.0,325,65,260,eune
443,43,Bardton Senna,CHALLENGER I,591,17.5,332,58,274,eune
444,44,DIV Fortanu,CHALLENGER I,590,17.6,352,62,290,eune
445,45,tokkila,CHALLENGER I,586,17.6,364,64,300,eune
446,46,rngshinyruo,CHALLENGER I,585,23.3,206,48,158,eune
447,47,KREATOPITA,CHALLENGER I,569,15.6,295,46,249,eune
448,48,No Ragrets,CHALLENGER I,566,20.3,306,62,244,eune
449,49,BillKong,CHALLENGER I,555,19.8,308,61,247,eune
450,50,tftsoftexe,CHALLENGER I,517,19.6,326,64,262,eune
451,51,citrusZZ,"GRANDMASTER I
G",537,17.8,387,69,318,eune
452,52,Mvp UnFeeLer,"GRANDMASTER I
G",513,21.1,313,66,247,eune
453,53,victor victoris,"GRANDMASTER I
G",503,13.2,545,72,473,eune
454,54,acoj,"GRANDMASTER I
G",495,16.4,299,49,250,eune
455,55,Άνεργος,"GRANDMASTER I
G",487,14.6,390,57,333,eune
456,56,Freak Simba,"GRANDMASTER I
G",485,12.8,447,57,390,eune
457,57,longlive,"GRANDMASTER I
G",479,13.6,352,48,304,eune
458,58,nayemnau,"GRANDMASTER I
G",474,21.2,326,69,257,eune
459,59,4NDI,"GRANDMASTER I
G",454,19.4,740,144,596,eune
460,60,MARStoiAN,"GRANDMASTER I
G",453,11.5,589,68,521,eune
461,61,Redundancia,"GRANDMASTER I
G",439,24.5,335,82,253,eune
462,62,yuquan,"GRANDMASTER I
G",439,21.2,382,81,301,eune
463,63,12abvt3,"GRANDMASTER I
G",434,24.2,211,51,160,eune
464,64,Petrusxa030,"GRANDMASTER I
G",431,16.6,344,57,287,eune
465,65,jakecn,"GRANDMASTER I
G",421,18.2,209,38,171,eune
466,66,DcStarz,"GRANDMASTER I
G",407,19.8,268,53,215,eune
467,67,SaintBlacky,"GRANDMASTER I
G",399,13.1,647,85,562,eune
468,68,Lucifer Junior,"GRANDMASTER I
G",392,18.9,413,78,335,eune
469,69,Electrolyze,"GRANDMASTER I
G",392,20.2,257,52,205,eune
470,70,MLxDDD,"GRANDMASTER I
G",381,18.6,388,72,316,eune
471,71,SnailDaddy,"GRANDMASTER I
G",373,15.2,611,93,518,eune
472,72,theq123,"GRANDMASTER I
G",367,18.1,215,39,176,eune
473,73,laiwanwano,"GRANDMASTER I
G",365,15.6,531,83,448,eune
474,74,SB CCisMyCounter,"GRANDMASTER I
G",357,17.7,310,55,255,eune
475,75,forever52,"GRANDMASTER I
G",356,23.9,167,40,127,eune
476,76,abe the savior,"GRANDMASTER I
G",355,15.9,648,103,545,eune
477,77,For chr1st sake,"GRANDMASTER I
G",350,11.1,728,81,647,eune
478,78,kecsketej5,"GRANDMASTER I
G",349,18.9,423,80,343,eune
479,79,dlskssss,"GRANDMASTER I
G",345,23.5,149,35,114,eune
480,80,qiqi277,"GRANDMASTER I
G",342,26.4,129,34,95,eune
481,81,Chieftan Nessus,"GRANDMASTER I
G",341,13.8,225,31,194,eune
482,82,LyAmAm,"GRANDMASTER I
G",337,22.1,167,37,130,eune
483,83,MaKharg JG,"GRANDMASTER I
G",333,17.7,447,79,368,eune
484,84,drma330,"GRANDMASTER I
G",331,16.1,299,48,251,eune
485,85,JointBongo,"GRANDMASTER I
G",329,24.1,145,35,110,eune
486,86,OFC Cute,"GRANDMASTER I
G",326,14.5,454,66,388,eune
487,87,kEEN v7,"GRANDMASTER I
G",323,18.1,166,30,136,eune
488,88,dendek,"GRANDMASTER I
G",319,20.4,323,66,257,eune
489,89,wangyinghui,"GRANDMASTER I
G",317,21.5,135,29,106,eune
490,90,CHINCZYQ,"GRANDMASTER I
G",317,16.2,142,23,119,eune
491,91,lidayea,"GRANDMASTER I
G",316,14.8,311,46,265,eune
492,92,wangweichuizi,"GRANDMASTER I
G",313,14.3,230,33,197,eune
493,93,huyabinzi,"GRANDMASTER I
G",311,18.4,245,45,200,eune
494,94,Cuudi,"GRANDMASTER I
G",305,17.3,404,70,334,eune
495,95,lolchessxogud,"GRANDMASTER I
G",305,17.1,193,33,160,eune
496,96,deqiang,"GRANDMASTER I
G",304,20.2,282,57,225,eune
497,97,shenchao1,"GRANDMASTER I
G",301,20.8,250,52,198,eune
498,98,Alfa Bard,"GRANDMASTER I
G",298,23.3,176,41,135,eune
499,99,Nickon,"GRANDMASTER I
G",292,16.7,384,64,320,eune
500,100,Wykonc,"GRANDMASTER I
G",288,17.6,245,43,202,eune
501,101,baobazhengqi111,"GRANDMASTER I
G",288,25.9,85,22,63,eune
502,102,Laamakuiskaaja,"GRANDMASTER I
G",287,11.7,634,74,560,eune
503,103,xiangshiyurenhai,"GRANDMASTER I
G",286,15.7,421,66,355,eune
504,104,JJiusan,"GRANDMASTER I
G",285,18.1,288,52,236,eune
505,105,lBigossl,"GRANDMASTER I
G",283,11.9,360,43,317,eune
506,106,Kőrean Jungler,"GRANDMASTER I
G",281,16.1,897,144,753,eune
507,107,Riku Na,"GRANDMASTER I
G",281,30.2,119,36,83,eune
508,108,Cebanthon,"GRANDMASTER I
G",279,25.8,182,47,135,eune
509,109,sfedis,"GRANDMASTER I
G",278,15.2,368,56,312,eune
510,110,l StreamR l,"GRANDMASTER I
G",276,17.2,483,83,400,eune
511,111,kasux,"GRANDMASTER I
G",276,24.7,267,66,201,eune
512,112,tousinimab,"GRANDMASTER I
G",275,17.6,312,55,257,eune
513,113,uzirrr,"GRANDMASTER I
G",274,17.6,318,56,262,eune
514,114,Epitheoritiς,"GRANDMASTER I
G",274,15.6,315,49,266,eune
515,115,qwbctyz,"GRANDMASTER I
G",273,29.2,147,43,104,eune
516,116,harimania,"GRANDMASTER I
G",273,24.4,160,39,121,eune
517,117,lplGOOD,"GRANDMASTER I
G",269,17.3,283,49,234,eune
518,118,Paljo,"GRANDMASTER I
G",268,17.3,173,30,143,eune
519,119,Darosch,"GRANDMASTER I
G",266,13.2,280,37,243,eune
520,120,Efrebee,"GRANDMASTER I
G",265,20.0,160,32,128,eune
521,121,onik1997,"GRANDMASTER I
G",264,39.4,104,41,63,eune
522,122,huawuyan,"GRANDMASTER I
G",264,14.2,233,33,200,eune
523,123,BlackCats,"GRANDMASTER I
G",263,14.3,532,76,456,eune
524,124,SKT Mexes,"GRANDMASTER I
G",262,15.0,233,35,198,eune
525,125,Ćelestial,"GRANDMASTER I
G",261,15.1,416,63,353,eune
526,126,asd110,"GRANDMASTER I
G",259,15.7,607,95,512,eune
527,127,OSG Legend,"GRANDMASTER I
G",258,16.0,237,38,199,eune
528,128,jijn3rj4j,"GRANDMASTER I
G",258,24.0,150,36,114,eune
529,129,Donger Bonger,"GRANDMASTER I
G",257,30.7,114,35,79,eune
530,130,pujsapepa,"GRANDMASTER I
G",256,21.1,412,87,325,eune
531,131,Pana2525,"GRANDMASTER I
G",256,20.6,277,57,220,eune
532,132,Cerebel22,"GRANDMASTER I
G",256,13.8,260,36,224,eune
533,133,shaodong,"GRANDMASTER I
G",255,14.2,351,50,301,eune
534,134,islam alghoul,"GRANDMASTER I
G",255,15.4,272,42,230,eune
535,135,TFT Poulaki,"GRANDMASTER I
G",254,14.3,726,104,622,eune
536,136,yyyyyye,"GRANDMASTER I
G",253,19.7,411,81,330,eune
537,137,Challenger Heart,"GRANDMASTER I
G",253,19.0,189,36,153,eune
538,138,jhghgh,"GRANDMASTER I
G",253,23.0,135,31,104,eune
539,139,lordpepigz,"GRANDMASTER I
G",252,15.3,313,48,265,eune
540,140,IceButcher,"GRANDMASTER I
G",250,14.3,273,39,234,eune
541,141,ZBlang,"GRANDMASTER I
G",250,29.4,102,30,72,eune
542,142,nóChance,"GRANDMASTER I
G",249,14.8,485,72,413,eune
543,143,Hari,"GRANDMASTER I
G",248,16.8,143,24,119,eune
544,144,Neebo,"GRANDMASTER I
G",246,19.0,226,43,183,eune
545,145,VERONICA RUN RUN,"GRANDMASTER I
G",243,24.9,245,61,184,eune
546,146,Ο Β Ε Υ,"GRANDMASTER I
G",241,17.3,307,53,254,eune
547,147,Unlucky Team,"GRANDMASTER I
G",205,15.3,196,30,166,eune
548,148,forever88,"GRANDMASTER I
G",203,24.7,384,95,289,eune
549,149,yql5201314,"GRANDMASTER I
G",187,24.8,149,37,112,eune
550,150,ARNOLD,"GRANDMASTER I
G",181,16.2,839,136,703,eune
551,151,laonazaici,MASTER I,365,15.7,274,43,231,eune
552,152,dadudu66,MASTER I,294,22.9,231,53,178,eune
553,153,haopi99,MASTER I,293,21.0,252,53,199,eune
554,154,qiwangwuxiaodi,MASTER I,287,28.1,185,52,133,eune
555,155,mid łane banter,MASTER I,277,22.3,238,53,185,eune
556,156,MiNo22,MASTER I,248,14.4,257,37,220,eune
557,157,Ykxnbo,MASTER I,239,18.0,266,48,218,eune
558,158,K3NNY1337,MASTER I,231,13.8,355,49,306,eune
559,159,faker1209,MASTER I,230,18.2,472,86,386,eune
560,160,Lethal Presencee,MASTER I,226,15.5,425,66,359,eune
561,161,qiong1v7,MASTER I,226,23.9,218,52,166,eune
562,162,fortepiańino,MASTER I,225,25.9,174,45,129,eune
563,163,zlfzj1314,MASTER I,222,13.7,124,17,107,eune
564,164,jiaozhiaini,MASTER I,221,17.5,257,45,212,eune
565,165,wusuo9,MASTER I,218,17.8,269,48,221,eune
566,166,chaojisaiyaren,MASTER I,217,23.7,173,41,132,eune
567,167,božský tureto,MASTER I,217,13.4,246,33,213,eune
568,168,ALEXPOTTERZ,MASTER I,215,16.0,212,34,178,eune
569,169,Lil Vayne J7,MASTER I,207,19.0,717,136,581,eune
570,170,shalockkrie,MASTER I,205,17.2,198,34,164,eune
571,171,xiaofeng998,MASTER I,205,23.9,138,33,105,eune
572,172,nibuxiang,MASTER I,204,12.4,201,25,176,eune
573,173,sdR,MASTER I,201,18.0,460,83,377,eune
574,174,F1Neee,MASTER I,201,15.3,496,76,420,eune
575,175,mailegebiao,MASTER I,201,26.3,133,35,98,eune
576,176,chinajiangliuer,MASTER I,200,19.0,179,34,145,eune
577,177,Ih8java,MASTER I,197,18.3,574,105,469,eune
578,178,cy9696,MASTER I,196,23.2,155,36,119,eune
579,179,duange666,MASTER I,196,23.9,142,34,108,eune
580,180,nononoling,MASTER I,196,20.6,141,29,112,eune
581,181,qqqwwweeerrrttt,MASTER I,192,27.5,309,85,224,eune
582,182,Mine is Bigger,MASTER I,191,21.9,105,23,82,eune
583,183,PigvCarry,MASTER I,190,13.5,281,38,243,eune
584,184,KarnageTheCrane,MASTER I,190,13.2,288,38,250,eune
585,185,plotak,MASTER I,187,20.6,189,39,150,eune
586,186,NBDandan,MASTER I,187,16.2,197,32,165,eune
587,187,Chinese0008,MASTER I,185,25.2,111,28,83,eune
588,188,klausrofl twitch,MASTER I,180,13.4,358,48,310,eune
589,189,aal233,MASTER I,175,15.4,487,75,412,eune
590,190,zyfather,MASTER I,170,14.5,413,60,353,eune
591,191,Apa,MASTER I,167,13.4,209,28,181,eune
592,192,tinmar,MASTER I,166,16.5,327,54,273,eune
593,193,qaqqqqq,MASTER I,165,17.0,223,38,185,eune
594,194,tianddh,MASTER I,158,17.9,235,42,193,eune
595,195,Razyo,MASTER I,157,16.5,273,45,228,eune
596,196,LTUGAMER,MASTER I,157,16.7,245,41,204,eune
597,197,Stephen Càrry,MASTER I,154,18.4,244,45,199,eune
598,198,wanbaoliu,MASTER I,149,16.3,325,53,272,eune
599,199,Mesh Shayfak,MASTER I,148,14.9,684,102,582,eune
600,200,darksin555,MASTER I,147,14.4,415,60,355,eune
601,1,Deis1k,CHALLENGER I,1710,21.4,639,137,502,euw
602,2,Salvyyy,CHALLENGER I,1675,23.3,288,67,221,euw
603,3,DarkHighroll,CHALLENGER I,1580,22.6,438,99,339,euw
604,4,Salvyyy TFT,CHALLENGER I,1533,24.5,417,102,315,euw
605,5,Gìngg,CHALLENGER I,1355,25.3,328,83,245,euw
606,6,Luque,CHALLENGER I,1332,18.0,879,158,721,euw
607,7,DarkHydra,CHALLENGER I,1329,21.1,588,124,464,euw
608,8,SwellerTiger,CHALLENGER I,1328,19.1,388,74,314,euw
609,9,GingGG,CHALLENGER I,1286,22.1,745,165,580,euw
610,10,Leon Trotskij,CHALLENGER I,1271,23.8,341,81,260,euw
611,11,l2yKo,CHALLENGER I,1266,21.9,1281,280,1001,euw
612,12,Voltariusx,CHALLENGER I,1259,18.5,432,80,352,euw
613,13,Voltariux,CHALLENGER I,1191,17.7,519,92,427,euw
614,14,Lallana,CHALLENGER I,1179,18.7,369,69,300,euw
615,15,fan2Kstagne,CHALLENGER I,1137,22.6,195,44,151,euw
616,16,Hotline ming,CHALLENGER I,1135,15.9,788,125,663,euw
617,17,SwellerTigerTFT,CHALLENGER I,1129,13.3,685,91,594,euw
618,18,Lev D Trotskij,CHALLENGER I,1096,18.5,599,111,488,euw
619,19,Kagerou OwO,CHALLENGER I,1087,20.8,438,91,347,euw
620,20,BALOTELLI777 TFT,CHALLENGER I,1076,16.6,513,85,428,euw
621,21,Wet Jungler,CHALLENGER I,1059,15.1,737,111,626,euw
622,22,Un33d,CHALLENGER I,1030,17.3,675,117,558,euw
623,23,Magarky,CHALLENGER I,1006,16.7,545,91,454,euw
624,24,Pazi4S,CHALLENGER I,1003,12.2,492,60,432,euw
625,25,Qetzer,CHALLENGER I,999,15.5,676,105,571,euw
626,26,Sologesang,CHALLENGER I,973,14.8,587,87,500,euw
627,27,SmileyCereal,CHALLENGER I,965,17.7,1193,211,982,euw
628,28,Phabal,CHALLENGER I,947,14.2,662,94,568,euw
629,29,Liquid Tabzz,CHALLENGER I,940,21.9,565,124,441,euw
630,30,Lorus,CHALLENGER I,931,9.6,768,74,694,euw
631,31,Sbstn TFT,CHALLENGER I,929,14.6,540,79,461,euw
632,32,Lipo Razak,CHALLENGER I,922,16.4,566,93,473,euw
633,33,Sunny Lu,CHALLENGER I,913,17.6,981,173,808,euw
634,34,outplayingmyself,CHALLENGER I,903,18.4,494,91,403,euw
635,35,Phbl,CHALLENGER I,900,14.1,683,96,587,euw
636,36,Deisik,CHALLENGER I,898,18.8,373,70,303,euw
637,37,iHG Tuttek,CHALLENGER I,874,16.3,742,121,621,euw
638,38,Bèst Heca EUW,CHALLENGER I,854,18.2,1457,266,1191,euw
639,39,RyKo v2,CHALLENGER I,852,25.4,327,83,244,euw
640,40,Tatufo,CHALLENGER I,838,14.4,638,92,546,euw
641,41,Monphis,CHALLENGER I,834,16.4,1210,198,1012,euw
642,42,sayvallahbru,CHALLENGER I,819,14.7,389,57,332,euw
643,43,ll TFT KEKW ll,CHALLENGER I,813,14.8,465,69,396,euw
644,44,Just so xi so,CHALLENGER I,810,18.9,317,60,257,euw
645,45,HASHIDA,CHALLENGER I,801,14.0,744,104,640,euw
646,46,Tits,CHALLENGER I,797,24.1,236,57,179,euw
647,47,BozzBrain v2,CHALLENGER I,795,14.5,345,50,295,euw
648,48,lucky smile boy,CHALLENGER I,771,15.7,1192,187,1005,euw
649,49,JdnTagNovoline,CHALLENGER I,762,20.8,202,42,160,euw
650,50,PonRoo,CHALLENGER I,761,12.5,1025,128,897,euw
651,51,Némaïdès,CHALLENGER I,757,14.1,618,87,531,euw
652,52,dirtyspear,CHALLENGER I,756,15.6,508,79,429,euw
653,53,RazakTFT,CHALLENGER I,752,15.1,1069,161,908,euw
654,54,5454XD,CHALLENGER I,752,17.0,558,95,463,euw
655,55,JedenTagNovoline,CHALLENGER I,750,23.1,199,46,153,euw
656,56,Palaloa,CHALLENGER I,747,16.3,246,40,206,euw
657,57,AKA magic,CHALLENGER I,741,12.9,800,103,697,euw
658,58,Kezman,CHALLENGER I,739,19.4,345,67,278,euw
659,59,TarteMan TFT,CHALLENGER I,737,15.1,463,70,393,euw
660,60,kassellen,CHALLENGER I,736,13.2,985,130,855,euw
661,61,BeasTFT2,CHALLENGER I,736,19.6,204,40,164,euw
662,62,Sparakay TFT,CHALLENGER I,735,15.3,267,41,226,euw
663,63,TSM Guillosko,CHALLENGER I,734,15.5,873,135,738,euw
664,64,dknsbs,CHALLENGER I,733,15.9,554,88,466,euw
665,65,lsochan,CHALLENGER I,728,16.6,283,47,236,euw
666,66,BenVK,CHALLENGER I,719,16.2,625,101,524,euw
667,67,MogamboDTB,CHALLENGER I,717,12.6,294,37,257,euw
668,68,Cachual,CHALLENGER I,715,25.6,219,56,163,euw
669,69,IBRAHIMOVIĆ777,CHALLENGER I,713,25.9,220,57,163,euw
670,70,T4nPoP,CHALLENGER I,712,15.4,1468,226,1242,euw
671,71,slime03,CHALLENGER I,712,16.9,549,93,456,euw
672,72,Banisher95,CHALLENGER I,711,13.5,488,66,422,euw
673,73,RICH H0MIE QUAN,CHALLENGER I,710,15.1,291,44,247,euw
674,74,ajoe1231,CHALLENGER I,704,17.6,814,143,671,euw
675,75,Can I trust you,CHALLENGER I,702,20.5,283,58,225,euw
676,76,WINZEEER,CHALLENGER I,701,15.1,755,114,641,euw
677,77,Khristor,CHALLENGER I,699,14.8,399,59,340,euw
678,78,Dedicasse Fahd,CHALLENGER I,698,15.8,658,104,554,euw
679,79,Adonis17,CHALLENGER I,695,16.8,779,131,648,euw
680,80,FluffyHS,CHALLENGER I,690,16.4,445,73,372,euw
681,81,Miiouw,CHALLENGER I,685,14.5,524,76,448,euw
682,82,Palaloa TFT,CHALLENGER I,682,13.1,474,62,412,euw
683,83,Bränk,CHALLENGER I,681,15.6,473,74,399,euw
684,84,Rïft,CHALLENGER I,680,16.0,225,36,189,euw
685,85,PUNISH1nG,CHALLENGER I,675,17.5,291,51,240,euw
686,86,Ev4ngelion,CHALLENGER I,670,16.5,702,116,586,euw
687,87,Un11d,CHALLENGER I,669,17.9,341,61,280,euw
688,88,Sayorï best girl,CHALLENGER I,669,17.3,243,42,201,euw
689,89,Zyriosly,CHALLENGER I,666,16.8,912,153,759,euw
690,90,TehSilli,CHALLENGER I,666,19.6,409,80,329,euw
691,91,BALOTELLI777,CHALLENGER I,659,18.6,533,99,434,euw
692,92,AmuuMuu,CHALLENGER I,656,12.0,1055,127,928,euw
693,93,YPRN Chwbk,CHALLENGER I,651,18.9,322,61,261,euw
694,94,TFT Buttons,CHALLENGER I,647,16.1,629,101,528,euw
695,95,rare not nice,CHALLENGER I,645,15.2,591,90,501,euw
696,96,ahuia,CHALLENGER I,643,18.9,238,45,193,euw
697,97,OnlyBetter,CHALLENGER I,643,9.9,415,41,374,euw
698,98,LeDuck TFT,CHALLENGER I,640,16.9,1138,193,945,euw
699,99,Göl D Roger,CHALLENGER I,640,12.7,812,103,709,euw
700,100,Kÿu,CHALLENGER I,639,17.4,407,71,336,euw
701,101,Can I mock you,CHALLENGER I,638,28.4,141,40,101,euw
702,102,iPoPz v2,CHALLENGER I,637,19.0,210,40,170,euw
703,103,LIPO Absykos,CHALLENGER I,628,14.2,414,59,355,euw
704,104,męntal,CHALLENGER I,617,13.6,545,74,471,euw
705,105,Whiteyeas,CHALLENGER I,616,14.4,346,50,296,euw
706,106,Yanís,CHALLENGER I,614,16.1,415,67,348,euw
707,107,Raizuken,CHALLENGER I,613,18.3,372,68,304,euw
708,108,kacpersky191TFT,CHALLENGER I,611,14.2,857,122,735,euw
709,109,YowiTFT,CHALLENGER I,611,20.6,247,51,196,euw
710,110,Gôn Freeçss,CHALLENGER I,610,20.9,278,58,220,euw
711,111,Xeno TFTx,CHALLENGER I,609,10.2,782,80,702,euw
712,112,IceLoom,CHALLENGER I,607,17.7,243,43,200,euw
713,113,Nyan Zebra,CHALLENGER I,607,16.2,253,41,212,euw
714,114,Jedi Master AK,CHALLENGER I,606,16.4,939,154,785,euw
715,115,o0OLyReO0o,CHALLENGER I,605,19.7,294,58,236,euw
716,116,Kjekken123,CHALLENGER I,602,20.1,518,104,414,euw
717,117,Xerxan,CHALLENGER I,601,15.2,682,104,578,euw
718,118,Kenopsia,CHALLENGER I,598,10.1,890,90,800,euw
719,119,VicerTFT,CHALLENGER I,596,15.5,445,69,376,euw
720,120,FengXiaoQiLing,CHALLENGER I,596,22.8,267,61,206,euw
721,121,TFT ArKoK,CHALLENGER I,593,15.7,898,141,757,euw
722,122,Nutscrackeros,CHALLENGER I,593,15.2,231,35,196,euw
723,123,always be hape,CHALLENGER I,592,17.7,385,68,317,euw
724,124,Drunkiris,CHALLENGER I,592,20.0,305,61,244,euw
725,125,MCMCinITALY,CHALLENGER I,589,18.5,497,92,405,euw
726,126,Freezzette,CHALLENGER I,589,12.0,640,77,563,euw
727,127,Suisaiga 2,CHALLENGER I,589,17.2,423,73,350,euw
728,128,LeDuck v2,CHALLENGER I,589,15.3,437,67,370,euw
729,129,zomgowy,CHALLENGER I,584,17.4,235,41,194,euw
730,130,Liber8 Hong Kong,CHALLENGER I,583,17.4,489,85,404,euw
731,131,Warmeur le vrai,CHALLENGER I,582,22.9,223,51,172,euw
732,132,The Gay Minion,CHALLENGER I,581,13.5,637,86,551,euw
733,133,TFT Emperador,CHALLENGER I,580,13.1,951,125,826,euw
734,134,TFTACKK,CHALLENGER I,580,25.5,200,51,149,euw
735,135,Vicer v2,CHALLENGER I,578,15.0,307,46,261,euw
736,136,Sirfetchd,CHALLENGER I,578,10.4,299,31,268,euw
737,137,Subahibi,CHALLENGER I,577,14.7,434,64,370,euw
738,138,GRIEFER XDDD,CHALLENGER I,566,18.9,254,48,206,euw
739,139,KAD Mason,CHALLENGER I,563,16.5,284,47,237,euw
740,140,hongmorongguang,CHALLENGER I,561,17.9,362,65,297,euw
741,141,birdyrrr,CHALLENGER I,561,18.3,251,46,205,euw
742,142,5454,CHALLENGER I,560,14.6,520,76,444,euw
743,143,stayl23,CHALLENGER I,560,13.7,481,66,415,euw
744,144,Sir Bobz,CHALLENGER I,559,10.9,450,49,401,euw
745,145,JollyFaker777,CHALLENGER I,557,16.0,362,58,304,euw
746,146,Futaken,CHALLENGER I,557,16.3,263,43,220,euw
747,147,Wholean,CHALLENGER I,556,12.1,527,64,463,euw
748,148,Sløt,CHALLENGER I,556,17.4,316,55,261,euw
749,149,Döbereiner,CHALLENGER I,555,16.0,613,98,515,euw
750,150,Summuner Name,CHALLENGER I,554,18.9,297,56,241,euw
751,151,Banisher95 TFT,CHALLENGER I,551,12.1,445,54,391,euw
752,152,Bersalis,CHALLENGER I,548,15.9,334,53,281,euw
753,153,R1CH HOM1E QUAN,CHALLENGER I,548,17.2,238,41,197,euw
754,154,TheUnbornYordle,CHALLENGER I,546,13.4,350,47,303,euw
755,155,Kirbes,CHALLENGER I,545,14.9,435,65,370,euw
756,156,Lelouuch,CHALLENGER I,545,16.2,321,52,269,euw
757,157,EnlèveTesMoufles,CHALLENGER I,543,17.6,295,52,243,euw
758,158,hi im hochin,CHALLENGER I,542,17.1,322,55,267,euw
759,159,Rehnz,CHALLENGER I,539,14.6,734,107,627,euw
760,160,Lonnen,CHALLENGER I,536,14.2,537,76,461,euw
761,161,WawaTatata,CHALLENGER I,536,13.6,557,76,481,euw
762,162,spongebob smiley,CHALLENGER I,536,16.9,414,70,344,euw
763,163,Bersa TFT,CHALLENGER I,530,15.9,517,82,435,euw
764,164,idlemonk TFT,CHALLENGER I,530,10.8,622,67,555,euw
765,165,Douyu4228274,CHALLENGER I,530,16.8,369,62,307,euw
766,166,MarooNTFT,CHALLENGER I,530,17.1,210,36,174,euw
767,167,Ranceta,CHALLENGER I,529,11.4,562,64,498,euw
768,168,I R INVINC1BLE,CHALLENGER I,527,15.1,737,111,626,euw
769,169,UnbornYordle,CHALLENGER I,527,18.2,506,92,414,euw
770,170,MapleKK,CHALLENGER I,526,19.6,194,38,156,euw
771,171,Itario,CHALLENGER I,525,12.6,451,57,394,euw
772,172,dameoiseau,CHALLENGER I,525,12.3,269,33,236,euw
773,173,Billgax,CHALLENGER I,524,13.8,570,79,491,euw
774,174,Funkfreed,CHALLENGER I,524,16.1,341,55,286,euw
775,175,Korra HD,CHALLENGER I,524,26.9,134,36,98,euw
776,176,Pray to RNG god,CHALLENGER I,523,12.8,297,38,259,euw
777,177,Tschabading,CHALLENGER I,519,13.5,865,117,748,euw
778,178,YowiTFT2,CHALLENGER I,516,20.7,222,46,176,euw
779,179,TeemoDaSlayer420,CHALLENGER I,515,20.7,179,37,142,euw
780,180,Gilozinho,CHALLENGER I,514,13.4,910,122,788,euw
781,181,G2 ReventXz,CHALLENGER I,514,20.6,305,63,242,euw
782,182,Genotik,CHALLENGER I,514,13.4,469,63,406,euw
783,183,Racklure,CHALLENGER I,513,14.4,914,132,782,euw
784,184,iPoPz,CHALLENGER I,513,16.4,549,90,459,euw
785,185,sun666shine,CHALLENGER I,512,19.3,342,66,276,euw
786,186,Esel51,CHALLENGER I,512,11.5,392,45,347,euw
787,187,MaCkTFT,CHALLENGER I,511,12.8,1653,212,1441,euw
788,188,joel19,CHALLENGER I,510,11.4,1028,117,911,euw
789,189,TFT Enzosexe,CHALLENGER I,510,12.1,925,112,813,euw
790,190,gluteus maxímus,CHALLENGER I,509,16.2,394,64,330,euw
791,191,Le Shot,CHALLENGER I,508,14.0,1304,183,1121,euw
792,192,Kalflo,CHALLENGER I,508,12.5,1280,160,1120,euw
793,193,BenVK TFT,CHALLENGER I,508,16.6,343,57,286,euw
794,194,Shσtgun,CHALLENGER I,507,15.5,779,121,658,euw
795,195,TNG Lucy Chan,CHALLENGER I,506,11.0,992,109,883,euw
796,196,Cute Crab,CHALLENGER I,506,15.8,228,36,192,euw
797,197,iamTLT,CHALLENGER I,505,12.3,334,41,293,euw
798,198,zoomgowy,CHALLENGER I,504,19.2,224,43,181,euw
799,199,WalktheGangplank,CHALLENGER I,503,12.5,304,38,266,euw
800,200,justinng,CHALLENGER I,502,17.5,389,68,321,euw
801,1,Hiraino,CHALLENGER I,711,22.0,441,97,344,jp
802,2,思い出の昼下がり,CHALLENGER I,544,26.3,209,55,154,jp
803,3,chocotto,CHALLENGER I,529,21.7,484,105,379,jp
804,4,dayona,CHALLENGER I,525,17.6,1115,196,919,jp
805,5,pureheart player,CHALLENGER I,508,18.6,425,79,346,jp
806,6,hakutou,CHALLENGER I,498,24.2,691,167,524,jp
807,7,KKQ,CHALLENGER I,481,21.3,352,75,277,jp
808,8,むむっ,CHALLENGER I,477,22.1,317,70,247,jp
809,9,じーく,CHALLENGER I,476,19.1,335,64,271,jp
810,10,Shroud Fanboy,CHALLENGER I,452,15.7,1091,171,920,jp
811,11,Best 佐藤 JP,CHALLENGER I,433,23.9,251,60,191,jp
812,12,Age 21,CHALLENGER I,414,22.3,202,45,157,jp
813,13,シャドウバース,CHALLENGER I,391,19.0,630,120,510,jp
814,14,ajun,CHALLENGER I,373,17.9,739,132,607,jp
815,15,etsuya0505,CHALLENGER I,367,16.6,566,94,472,jp
816,16,害獣あらいぐま,CHALLENGER I,365,13.3,413,55,358,jp
817,17,ひまわり準決勝,CHALLENGER I,360,25.0,196,49,147,jp
818,18,Best太郎JP,CHALLENGER I,344,21.7,355,77,278,jp
819,19,God Fukuoka,CHALLENGER I,337,19.4,365,71,294,jp
820,20,young4u,CHALLENGER I,317,17.6,376,66,310,jp
821,21,kes,CHALLENGER I,314,19.2,369,71,298,jp
822,22,喚くマン,CHALLENGER I,296,18.4,446,82,364,jp
823,23,だよな,CHALLENGER I,293,21.8,216,47,169,jp
824,24,煩いマン,CHALLENGER I,287,17.1,280,48,232,jp
825,25,りーり,CHALLENGER I,276,13.0,1015,132,883,jp
826,26,HiROKKtft,CHALLENGER I,276,19.4,341,66,275,jp
827,27,Adrenaline,CHALLENGER I,274,18.7,502,94,408,jp
828,28,えっっ,CHALLENGER I,272,17.6,222,39,183,jp
829,29,Hechima777,CHALLENGER I,260,14.9,691,103,588,jp
830,30,trotv,CHALLENGER I,241,15.7,522,82,440,jp
831,31,大門未知子,CHALLENGER I,234,18.9,196,37,159,jp
832,32,dozepk,CHALLENGER I,228,15.2,441,67,374,jp
833,33,vvvvvvvvvipp,CHALLENGER I,227,18.6,543,101,442,jp
834,34,Twisted Fate Bot,CHALLENGER I,224,16.7,353,59,294,jp
835,35,dozeqk,CHALLENGER I,222,19.6,214,42,172,jp
836,36,Jackn,CHALLENGER I,216,22.7,255,58,197,jp
837,37,沼の大破神,CHALLENGER I,210,19.7,299,59,240,jp
838,38,macro11,CHALLENGER I,207,17.4,311,54,257,jp
839,39,sueno09,CHALLENGER I,198,14.3,286,41,245,jp
840,40,deárest,CHALLENGER I,198,26.5,102,27,75,jp
841,41,山田周人,CHALLENGER I,184,16.6,500,83,417,jp
842,42,FoT DazzingDog,CHALLENGER I,176,21.7,277,60,217,jp
843,43,pveman,CHALLENGER I,174,18.7,358,67,291,jp
844,44,Waterfox,CHALLENGER I,171,12.8,305,39,266,jp
845,45,Ponty,CHALLENGER I,163,15.6,787,123,664,jp
846,46,賃砲丸出侍,CHALLENGER I,157,23.6,212,50,162,jp
847,47,karakuti,CHALLENGER I,155,19.2,234,45,189,jp
848,48,elfiny,CHALLENGER I,155,18.7,171,32,139,jp
849,49,秋水宴,CHALLENGER I,154,16.4,269,44,225,jp
850,50,しかめまどか,CHALLENGER I,94,14.3,1351,194,1157,jp
851,51,rionest,"GRANDMASTER I
G",165,17.2,1101,190,911,jp
852,52,ますにゃ,"GRANDMASTER I
G",153,13.7,788,108,680,jp
853,53,いけなる,"GRANDMASTER I
G",118,16.9,811,137,674,jp
854,54,にぶさき,"GRANDMASTER I
G",105,15.6,1030,161,869,jp
855,55,理解のある彼くん,"GRANDMASTER I
G",101,16.4,439,72,367,jp
856,56,bonchobi,"GRANDMASTER I
G",81,15.4,480,74,406,jp
857,57,URUUUU,"GRANDMASTER I
G",80,19.5,467,91,376,jp
858,58,loraplayer,"GRANDMASTER I
G",79,17.3,834,144,690,jp
859,59,ばーじん,"GRANDMASTER I
G",78,15.2,927,141,786,jp
860,60,Tぽいんと,"GRANDMASTER I
G",70,19.9,316,63,253,jp
861,61,醤ØuØ油,"GRANDMASTER I
G",67,13.7,903,124,779,jp
862,62,center8128,"GRANDMASTER I
G",65,15.3,196,30,166,jp
863,63,nagatoevol,"GRANDMASTER I
G",64,17.5,411,72,339,jp
864,64,しかめまどか2,"GRANDMASTER I
G",64,23.2,224,52,172,jp
865,65,dngr,"GRANDMASTER I
G",63,17.3,283,49,234,jp
866,66,まくらi,"GRANDMASTER I
G",59,21.0,181,38,143,jp
867,67,contrail,"GRANDMASTER I
G",57,18.1,155,28,127,jp
868,68,Count Mak,"GRANDMASTER I
G",52,19.6,448,88,360,jp
869,69,pccc,"GRANDMASTER I
G",50,31.9,91,29,62,jp
870,70,bappy,"GRANDMASTER I
G",41,17.8,805,143,662,jp
871,71,Yaruo,"GRANDMASTER I
G",36,16.8,285,48,237,jp
872,72,ぼんちょび,"GRANDMASTER I
G",36,25.0,180,45,135,jp
873,73,濃厚鶏白湯拉麺,"GRANDMASTER I
G",28,16.3,215,35,180,jp
874,74,millepiedi,"GRANDMASTER I
G",23,13.9,273,38,235,jp
875,75,にじむら,"GRANDMASTER I
G",21,12.2,737,90,647,jp
876,76,ZmLFs2z,"GRANDMASTER I
G",21,21.8,156,34,122,jp
877,77,ekollon,"GRANDMASTER I
G",19,17.9,424,76,348,jp
878,78,モルディ貝,"GRANDMASTER I
G",17,16.2,321,52,269,jp
879,79,enamel,"GRANDMASTER I
G",16,9.2,368,34,334,jp
880,80,Caplico,"GRANDMASTER I
G",15,18.1,254,46,208,jp
881,81,Remixi,"GRANDMASTER I
G",14,12.9,202,26,176,jp
882,82,丸の内LOLレイナ,"GRANDMASTER I
G",13,16.1,429,69,360,jp
883,83,新ふうちゃん,"GRANDMASTER I
G",13,13.3,256,34,222,jp
884,84,夜空丶,"GRANDMASTER I
G",12,19.8,192,38,154,jp
885,85,nijimuraact2,"GRANDMASTER I
G",11,15.4,447,69,378,jp
886,86,ゲッティスパ美,"GRANDMASTER I
G",10,18.8,165,31,134,jp
887,87,Kuririman,"GRANDMASTER I
G",8,14.9,268,40,228,jp
888,88,xtc,"GRANDMASTER I
G",6,17.8,443,79,364,jp
889,89,Rhino Cider,"GRANDMASTER I
G",5,12.7,205,26,179,jp
890,90,admin testuser01,"GRANDMASTER I
G",3,14.8,849,126,723,jp
891,91,shuraha3,"GRANDMASTER I
G",3,16.3,381,62,319,jp
892,92,MrJefferz,"GRANDMASTER I
G",2,16.1,533,86,447,jp
893,93,平丼堅,"GRANDMASTER I
G",1,14.7,730,107,623,jp
894,94,misomega,"GRANDMASTER I
G",1,16.0,406,65,341,jp
895,95,7zigeN,"GRANDMASTER I
G",0,17.7,1001,177,824,jp
896,96,かふす,"GRANDMASTER I
G",0,18.5,844,156,688,jp
897,97,Hermes0,"GRANDMASTER I
G",0,16.3,771,126,645,jp
898,98,Gafu,"GRANDMASTER I
G",0,13.8,881,122,759,jp
899,99,SMA,"GRANDMASTER I
G",0,13.0,713,93,620,jp
900,100,じょん炊いたー,"GRANDMASTER I
G",0,20.8,351,73,278,jp
901,101,たなってぃ,"GRANDMASTER I
G",0,16.7,437,73,364,jp
902,102,Shield Samba,"GRANDMASTER I
G",0,13.9,497,69,428,jp
903,103,エミュー,"GRANDMASTER I
G",0,14.5,469,68,401,jp
904,104,GoodMannerU5,"GRANDMASTER I
G",0,14.1,439,62,377,jp
905,105,Worst Takashi JP,"GRANDMASTER I
G",0,12.7,464,59,405,jp
906,106,CosplayGirl,"GRANDMASTER I
G",0,22.5,258,58,200,jp
907,107,tomonar1,"GRANDMASTER I
G",0,14.1,410,58,352,jp
908,108,えんどほーぷ,"GRANDMASTER I
G",0,8.8,633,56,577,jp
909,109,此方より彼方まで,"GRANDMASTER I
G",0,16.9,307,52,255,jp
910,110,さとるくん,"GRANDMASTER I
G",0,11.3,460,52,408,jp
911,111,KR blonde lov,"GRANDMASTER I
G",0,20.8,221,46,175,jp
912,112,Piyochan76,"GRANDMASTER I
G",0,15.5,291,45,246,jp
913,113,Nochita,"GRANDMASTER I
G",0,12.3,357,44,313,jp
914,114,ciple753,"GRANDMASTER I
G",0,12.9,317,41,276,jp
915,115,ポッチャマ,"GRANDMASTER I
G",0,11.9,319,38,281,jp
916,116,ぜろななにーいち,"GRANDMASTER I
G",0,21.5,172,37,135,jp
917,117,kotogane411,"GRANDMASTER I
G",0,17.6,210,37,173,jp
918,118,Ugokeru Debu Bot,"GRANDMASTER I
G",0,16.0,225,36,189,jp
919,119,はんえつか,"GRANDMASTER I
G",0,16.1,218,35,183,jp
920,120,曖昧心,"GRANDMASTER I
G",0,14.6,239,35,204,jp
921,121,tola,"GRANDMASTER I
G",0,14.2,232,33,199,jp
922,122,ロルから逃げるな,"GRANDMASTER I
G",0,19.4,165,32,133,jp
923,123,ぽこくま,"GRANDMASTER I
G",0,17.9,162,29,133,jp
924,124,涼風あおば,"GRANDMASTER I
G",0,17.3,127,22,105,jp
925,125,pano,MASTER I,22,17.4,505,88,417,jp
926,126,AikaS,MASTER I,15,16.6,737,122,615,jp
927,127,犬走椛,MASTER I,6,19.0,147,28,119,jp
928,128,マグロマート,MASTER I,0,18.8,154,29,125,jp
929,129,いまのん,DIAMOND I,92,17.8,353,63,290,jp
930,130,Eidechse,DIAMOND I,91,16.4,220,36,184,jp
931,131,askrp,DIAMOND I,75,17.0,569,97,472,jp
932,132,Raias,DIAMOND I,75,16.3,522,85,437,jp
933,133,Sukizofureni,DIAMOND I,75,13.3,548,73,475,jp
934,134,lalabybyby,DIAMOND I,75,15.6,461,72,389,jp
935,135,MichaelChan,DIAMOND I,75,17.7,317,56,261,jp
936,136,名取ざや,DIAMOND I,75,23.6,229,54,175,jp
937,137,ap top mom die,DIAMOND I,75,23.3,232,54,178,jp
938,138,ききちま,DIAMOND I,75,18.2,285,52,233,jp
939,139,福山はさまるJP,DIAMOND I,75,16.3,307,50,257,jp
940,140,夏目純夏,DIAMOND I,75,25.1,167,42,125,jp
941,141,ABEKANZOU,DIAMOND I,75,19.5,210,41,169,jp
942,142,スルギすき,DIAMOND I,75,16.7,204,34,170,jp
943,143,オーシャン増永,DIAMOND I,75,18.8,176,33,143,jp
944,144,クックパッド歩美,DIAMOND I,75,21.1,147,31,116,jp
945,145,IKUTOMIE,DIAMOND I,75,11.4,228,26,202,jp
946,146,日高愛,DIAMOND I,70,15.4,422,65,357,jp
947,147,くりちゃん大好き,DIAMOND I,69,21.4,159,34,125,jp
948,148,1515225,DIAMOND I,59,14.9,376,56,320,jp
949,149,I DO RAMMUS JUNG,DIAMOND I,59,16.5,333,55,278,jp
950,150,汝何着品如衣,DIAMOND I,59,15.9,232,37,195,jp
951,151,koogie,DIAMOND I,39,14.3,343,49,294,jp
952,152,チャイコフスキー,DIAMOND I,35,14.0,1071,150,921,jp
953,153,srinm,DIAMOND I,35,15.3,536,82,454,jp
954,154,おやすみの翁,DIAMOND I,35,19.0,168,32,136,jp
955,155,foxbaby123b,DIAMOND I,34,13.7,541,74,467,jp
956,156,forever18,DIAMOND I,32,16.3,361,59,302,jp
957,157,ゆっちー,DIAMOND I,32,12.2,377,46,331,jp
958,158,Jethro Cyrus,DIAMOND I,31,13.7,643,88,555,jp
959,159,MABARIKO,DIAMOND I,31,15.4,564,87,477,jp
960,160,てっくてっく,DIAMOND I,27,17.8,304,54,250,jp
961,161,ButaDaJoe,DIAMOND I,25,19.5,190,37,153,jp
962,162,世界詞のキア,DIAMOND I,24,16.7,126,21,105,jp
963,163,InventusGaming,DIAMOND I,23,10.5,351,37,314,jp
964,164,うるるる,DIAMOND I,21,21.2,137,29,108,jp
965,165,hohe,DIAMOND I,20,16.4,627,103,524,jp
966,166,ーAkiraー,DIAMOND I,17,14.5,420,61,359,jp
967,167,neetneo,DIAMOND I,16,20.9,210,44,166,jp
968,168,HitujiDaJoe,DIAMOND I,13,16.4,195,32,163,jp
969,169,お前のレベル笑,DIAMOND I,11,20.5,409,84,325,jp
970,170,ダンボ君,DIAMOND I,11,17.4,161,28,133,jp
971,171,laser501,DIAMOND I,9,16.0,244,39,205,jp
972,172,VTAKU77,DIAMOND I,8,11.3,185,21,164,jp
973,173,shabtyu,DIAMOND I,7,17.4,299,52,247,jp
974,174,福山はさまるNA,DIAMOND I,5,19.7,147,29,118,jp
975,175,Bad Takahashi,DIAMOND I,4,17.5,217,38,179,jp
976,176,XionNoi,DIAMOND I,2,18.0,399,72,327,jp
977,177,るきにゃん,DIAMOND I,0,17.8,540,96,444,jp
978,178,gacchapin20,DIAMOND I,0,13.4,649,87,562,jp
979,179,アイルー卿,DIAMOND I,0,15.0,366,55,311,jp
980,180,Why So Serious,DIAMOND I,0,14.2,332,47,285,jp
981,181,Satolis,DIAMOND I,0,9.8,439,43,396,jp
982,182,Endcyclone,DIAMOND I,0,27.0,148,40,108,jp
983,183,このばかちんがぁ,DIAMOND I,0,15.0,254,38,216,jp
984,184,IlllIlllIlllI,DIAMOND I,0,20.2,178,36,142,jp
985,185,siva fes,DIAMOND I,0,12.5,279,35,244,jp
986,186,キャンディ  猫,DIAMOND I,0,19.6,173,34,139,jp
987,187,yatsuhashi567,DIAMOND I,0,13.5,251,34,217,jp
988,188,下了88,DIAMOND I,0,27.6,116,32,84,jp
989,189,low roller,DIAMOND I,0,17.3,185,32,153,jp
990,190,toudoriDX2,DIAMOND I,0,9.9,302,30,272,jp
991,191,watchhhhhh,DIAMOND I,0,18.5,151,28,123,jp
992,192,εOnOз,DIAMOND I,0,18.7,139,26,113,jp
993,193,shinano,DIAMOND I,0,15.2,171,26,145,jp
994,194,nasyoter,DIAMOND I,0,15.1,139,21,118,jp
995,195,所念皆星河,DIAMOND II,96,18.7,316,59,257,jp
996,196,shuraha4,DIAMOND II,96,12.9,318,41,277,jp
997,197,newie,DIAMOND II,94,15.5,328,51,277,jp
998,198,AHIKJDK,DIAMOND II,92,27.2,103,28,75,jp
999,199,キイロイトリ3,DIAMOND II,80,13.3,255,34,221,jp
1000,200,korekoreTFT,DIAMOND II,75,14.0,712,100,612,jp
1001,1,AFTV 꼴픽이,CHALLENGER I,1687,19.2,1024,197,827,kr
1002,2,곰과제리2,CHALLENGER I,1634,20.4,318,65,253,kr
1003,3,정동글,CHALLENGER I,1465,18.0,601,108,493,kr
1004,4,김린Or남친,CHALLENGER I,1456,18.9,966,183,783,kr
1005,5,퐈피는잘못없어,CHALLENGER I,1441,17.8,1199,214,985,kr
1006,6,shungjinsoo,CHALLENGER I,1333,18.0,924,166,758,kr
1007,7,곰과제리,CHALLENGER I,1332,18.5,858,159,699,kr
1008,8,스트롱뽀송뽀송,CHALLENGER I,1329,14.9,1011,151,860,kr
1009,9,Alle Deli,CHALLENGER I,1318,14.7,511,75,436,kr
1010,10,정동글2,CHALLENGER I,1256,18.1,343,62,281,kr
1011,11,알맹승지2,CHALLENGER I,1249,11.4,533,61,472,kr
1012,12,난몰라,CHALLENGER I,1239,17.2,431,74,357,kr
1013,13,Cherryon,CHALLENGER I,1229,15.5,980,152,828,kr
1014,14,바삭한빵,CHALLENGER I,1219,18.6,478,89,389,kr
1015,15,알레 델리,CHALLENGER I,1219,22.0,300,66,234,kr
1016,16,펠새로이,CHALLENGER I,1201,18.1,733,133,600,kr
1017,17,SanChess,CHALLENGER I,1196,17.5,664,116,548,kr
1018,18,종자잇,CHALLENGER I,1195,16.6,427,71,356,kr
1019,19,체주미,CHALLENGER I,1195,17.7,311,55,256,kr
1020,20,아기용1,CHALLENGER I,1125,19.8,1618,321,1297,kr
1021,21,AFTV 웃바,CHALLENGER I,1099,18.2,619,113,506,kr
1022,22,난몰라2,CHALLENGER I,1078,12.9,536,69,467,kr
1023,23,두니주니,CHALLENGER I,1068,18.4,1341,247,1094,kr
1024,24,깽 만,CHALLENGER I,1067,13.3,829,110,719,kr
1025,25,축 꾸,CHALLENGER I,1056,18.1,963,174,789,kr
1026,26,피노키훈,CHALLENGER I,1050,18.4,818,151,667,kr
1027,27,TZ 제리,CHALLENGER I,1045,14.6,608,89,519,kr
1028,28,lxry,CHALLENGER I,1033,14.5,318,46,272,kr
1029,29,Park Eunbin,CHALLENGER I,1032,17.2,464,80,384,kr
1030,30,왜 나만 운없냐,CHALLENGER I,1030,17.7,362,64,298,kr
1031,31,귀여운쫑이자나,CHALLENGER I,1026,17.1,913,156,757,kr
1032,32,럭키체스777,CHALLENGER I,1019,13.4,736,99,637,kr
1033,33,마스터 3,CHALLENGER I,1018,10.5,850,89,761,kr
1034,34,알맹승지,CHALLENGER I,1018,12.0,626,75,551,kr
1035,35,My Paradise,CHALLENGER I,1017,23.1,763,176,587,kr
1036,36,이Or름,CHALLENGER I,1016,11.5,1094,126,968,kr
1037,37,기도메타777,CHALLENGER I,1015,13.9,338,47,291,kr
1038,38,화살 세례,CHALLENGER I,1008,17.4,706,123,583,kr
1039,39,현이야아아,CHALLENGER I,1008,13.2,859,113,746,kr
1040,40,엠브로돈까스,CHALLENGER I,1007,18.3,1577,288,1289,kr
1041,41,BAAMM,CHALLENGER I,1001,18.8,1401,264,1137,kr
1042,42,김유Or,CHALLENGER I,970,16.7,551,92,459,kr
1043,43,shungjinsoo2,CHALLENGER I,959,16.3,497,81,416,kr
1044,44,끓인사발면,CHALLENGER I,933,19.7,380,75,305,kr
1045,45,Fiora TOP,CHALLENGER I,929,12.3,667,82,585,kr
1046,46,패트롤원툴,CHALLENGER I,922,17.1,642,110,532,kr
1047,47,카시장인 삿카시,CHALLENGER I,908,14.7,428,63,365,kr
1048,48,호랑이찌찌젖짜기,CHALLENGER I,906,15.6,569,89,480,kr
1049,49,홀애비2,CHALLENGER I,903,18.0,1129,203,926,kr
1050,50,펠 다,CHALLENGER I,902,23.7,401,95,306,kr
1051,51,노마딕,CHALLENGER I,893,17.4,702,122,580,kr
1052,52,Gritor,CHALLENGER I,889,16.0,1383,221,1162,kr
1053,53,삐진범,CHALLENGER I,886,15.2,308,47,261,kr
1054,54,천 득,CHALLENGER I,884,14.4,445,64,381,kr
1055,55,보이지않는기물,CHALLENGER I,881,18.2,500,91,409,kr
1056,56,안산시청,CHALLENGER I,877,17.2,536,92,444,kr
1057,57,곰과제리3,CHALLENGER I,877,15.7,426,67,359,kr
1058,58,버그활용법,CHALLENGER I,870,25.8,287,74,213,kr
1059,59,사랑해꿀아,CHALLENGER I,868,15.0,580,87,493,kr
1060,60,바위게줍기장인,CHALLENGER I,846,15.1,878,133,745,kr
1061,61,롤접으면여친생김,CHALLENGER I,845,16.2,402,65,337,kr
1062,62,꽃피그,CHALLENGER I,845,18.2,285,52,233,kr
1063,63,woiwoer12,CHALLENGER I,841,15.9,1033,164,869,kr
1064,64,안지영,CHALLENGER I,840,18.1,343,62,281,kr
1065,65,내가더사기얍,CHALLENGER I,838,15.8,518,82,436,kr
1066,66,로자이어,CHALLENGER I,832,12.7,684,87,597,kr
1067,67,킨드레드블루그린,CHALLENGER I,802,17.0,792,135,657,kr
1068,68,쪼해피롱,CHALLENGER I,800,18.8,1052,198,854,kr
1069,69,나혼산,CHALLENGER I,799,16.1,347,56,291,kr
1070,70,청정민,CHALLENGER I,798,14.0,1374,192,1182,kr
1071,71,고유나,CHALLENGER I,798,16.3,424,69,355,kr
1072,72,44990189del,CHALLENGER I,795,19.2,621,119,502,kr
1073,73,천득 Youtube,CHALLENGER I,792,16.1,436,70,366,kr
1074,74,Eunso,CHALLENGER I,790,14.8,1056,156,900,kr
1075,75,머리한입꼬리한입,CHALLENGER I,784,16.1,1076,173,903,kr
1076,76,개 북,CHALLENGER I,780,18.0,423,76,347,kr
1077,77,옴팡이,CHALLENGER I,776,19.7,1487,293,1194,kr
1078,78,Ignited,CHALLENGER I,776,12.4,570,71,499,kr
1079,79,AFTV 구루루,CHALLENGER I,773,14.9,1411,210,1201,kr
1080,80,정동기리,CHALLENGER I,773,17.1,339,58,281,kr
1081,81,끓인사발면2,CHALLENGER I,773,23.8,214,51,163,kr
1082,82,롤체고오수,CHALLENGER I,773,16.6,241,40,201,kr
1083,83,쓰레쉬핵초고수,CHALLENGER I,772,14.5,829,120,709,kr
1084,84,초보끼리합시다,CHALLENGER I,771,14.1,813,115,698,kr
1085,85,최killing,CHALLENGER I,771,12.4,776,96,680,kr
1086,86,k1moddi,CHALLENGER I,768,19.1,220,42,178,kr
1087,87,이딴겜해주지마,CHALLENGER I,762,36.8,144,53,91,kr
1088,88,천득 fan,CHALLENGER I,760,12.3,1125,138,987,kr
1089,89,종범1,CHALLENGER I,758,17.9,251,45,206,kr
1090,90,Dosu0,CHALLENGER I,757,18.4,245,45,200,kr
1091,91,AFTV 제로겟,CHALLENGER I,752,9.5,1862,177,1685,kr
1092,92,연변 소연수,CHALLENGER I,749,15.2,1625,247,1378,kr
1093,93,빅머니장사장,CHALLENGER I,747,17.9,448,80,368,kr
1094,94,Younna,CHALLENGER I,738,21.0,186,39,147,kr
1095,95,어런이222,CHALLENGER I,737,13.9,734,102,632,kr
1096,96,유후a,CHALLENGER I,735,17.2,641,110,531,kr
1097,97,AF HappyVirus,CHALLENGER I,733,18.5,292,54,238,kr
1098,98,그레이스바라기,CHALLENGER I,733,14.2,310,44,266,kr
1099,99,궁뎅크니,CHALLENGER I,731,14.9,797,119,678,kr
1100,100,Everton FAN,CHALLENGER I,731,11.2,394,44,350,kr
1101,101,조치타치,CHALLENGER I,726,10.6,812,86,726,kr
1102,102,줘 너,CHALLENGER I,724,13.4,1046,140,906,kr
1103,103,hiimg4nmi,CHALLENGER I,723,15.1,835,126,709,kr
1104,104,사회관,CHALLENGER I,723,12.4,998,124,874,kr
1105,105,조치타칫쿵칫타,CHALLENGER I,722,9.3,461,43,418,kr
1106,106,15조현지,CHALLENGER I,717,22.0,314,69,245,kr
1107,107,혹시그거아냐,CHALLENGER I,716,14.2,393,56,337,kr
1108,108,정밍호짱짱걸,CHALLENGER I,713,14.0,991,139,852,kr
1109,109,랑조췻,CHALLENGER I,712,11.8,1529,181,1348,kr
1110,110,오면 딴다,CHALLENGER I,712,13.4,792,106,686,kr
1111,111,노래하는 쭌,CHALLENGER I,711,10.8,941,102,839,kr
1112,112,전설의소라고동,CHALLENGER I,710,15.5,748,116,632,kr
1113,113,TFT 너밤,CHALLENGER I,709,18.3,492,90,402,kr
1114,114,TZ 제리쌤,CHALLENGER I,705,15.4,317,49,268,kr
1115,115,Dosu,CHALLENGER I,704,14.1,284,40,244,kr
1116,116,왕 자,CHALLENGER I,703,12.9,613,79,534,kr
1117,117,푸딩턱털낼름낼름,CHALLENGER I,702,19.6,336,66,270,kr
1118,118,체스보이민다빈,CHALLENGER I,696,17.6,1404,247,1157,kr
1119,119,곽예림,CHALLENGER I,680,12.4,951,118,833,kr
1120,120,먹 적,CHALLENGER I,679,12.4,372,46,326,kr
1121,121,봄날이갓두,CHALLENGER I,675,11.7,710,83,627,kr
1122,122,미어캣군,CHALLENGER I,675,13.4,434,58,376,kr
1123,123,YunHyeonSik,CHALLENGER I,675,13.1,390,51,339,kr
1124,124,코스모TV,CHALLENGER I,673,15.7,817,128,689,kr
1125,125,똥꼬에펜타킬,CHALLENGER I,671,11.7,409,48,361,kr
1126,126,게므론,CHALLENGER I,670,9.8,927,91,836,kr
1127,127,대위 리정혁,CHALLENGER I,669,14.5,627,91,536,kr
1128,128,노랑닉,CHALLENGER I,669,17.3,295,51,244,kr
1129,129,쿨한토니,CHALLENGER I,668,15.7,332,52,280,kr
1130,130,Blanker,CHALLENGER I,667,17.5,770,135,635,kr
1131,131,Pnaz,CHALLENGER I,660,28.9,228,66,162,kr
1132,132,아갈머리를콰악,CHALLENGER I,654,22.4,214,48,166,kr
1133,133,Roik,CHALLENGER I,652,28.0,132,37,95,kr
1134,134,물소타,CHALLENGER I,647,15.0,1030,155,875,kr
1135,135,챌린저라닉변함,CHALLENGER I,641,11.6,874,101,773,kr
1136,136,정 장,CHALLENGER I,641,14.6,499,73,426,kr
1137,137,초콜렛공장,CHALLENGER I,641,12.9,356,46,310,kr
1138,138,지니쁘미,CHALLENGER I,639,15.5,284,44,240,kr
1139,139,멍청아린,CHALLENGER I,637,14.1,581,82,499,kr
1140,140,주나식,CHALLENGER I,636,17.6,244,43,201,kr
1141,141,WE CAN WlN,CHALLENGER I,635,17.3,538,93,445,kr
1142,142,탑하겠습니다,CHALLENGER I,635,17.8,366,65,301,kr
1143,143,오지마요제발,CHALLENGER I,633,11.5,992,114,878,kr
1144,144,카리조마,CHALLENGER I,633,17.5,531,93,438,kr
1145,145,우디르디르,CHALLENGER I,632,15.0,654,98,556,kr
1146,146,TZ 코그멍,CHALLENGER I,632,16.7,430,72,358,kr
1147,147,Schakal,CHALLENGER I,630,13.5,711,96,615,kr
1148,148,last40ne,CHALLENGER I,630,18.7,150,28,122,kr
1149,149,땅콩달콤,CHALLENGER I,628,15.2,505,77,428,kr
1150,150,Viento 9,CHALLENGER I,628,13.9,496,69,427,kr
1151,151,달삼이빡빡라이즈,CHALLENGER I,627,13.8,681,94,587,kr
1152,152,proooa,CHALLENGER I,625,16.3,514,84,430,kr
1153,153,콘쓰탄쯔,CHALLENGER I,624,13.0,476,62,414,kr
1154,154,시즌2대한민국1등,CHALLENGER I,623,15.2,626,95,531,kr
1155,155,세번째차인달삼,CHALLENGER I,620,17.6,948,167,781,kr
1156,156,앗 추워,CHALLENGER I,619,15.1,737,111,626,kr
1157,157,FateGrand5rder,CHALLENGER I,617,9.1,1165,106,1059,kr
1158,158,뱅 탁,CHALLENGER I,616,12.4,501,62,439,kr
1159,159,2000 11 12,CHALLENGER I,616,17.7,282,50,232,kr
1160,160,참새년,CHALLENGER I,615,13.9,548,76,472,kr
1161,161,초식판다,CHALLENGER I,614,13.0,882,115,767,kr
1162,162,남자는코멧,CHALLENGER I,614,13.1,390,51,339,kr
1163,163,illilililli1,CHALLENGER I,614,16.3,252,41,211,kr
1164,164,정 찰 돼,CHALLENGER I,613,12.1,438,53,385,kr
1165,165,possible,CHALLENGER I,611,15.7,534,84,450,kr
1166,166,heals,CHALLENGER I,611,17.0,458,78,380,kr
1167,167,제황산,CHALLENGER I,610,14.8,991,147,844,kr
1168,168,EMP 모구,CHALLENGER I,609,15.8,438,69,369,kr
1169,169,진이애완동물,CHALLENGER I,607,15.1,490,74,416,kr
1170,170,신낫상우,CHALLENGER I,606,16.7,508,85,423,kr
1171,171,놀릴준비 끝,CHALLENGER I,605,17.2,250,43,207,kr
1172,172,X Videos 방금봄,CHALLENGER I,604,14.5,1025,149,876,kr
1173,173,빼꼼배꼽,CHALLENGER I,604,17.0,454,77,377,kr
1174,174,불꽃자잇 사생팬,CHALLENGER I,604,14.4,422,61,361,kr
1175,175,Trust me only,CHALLENGER I,604,11.0,471,52,419,kr
1176,176,TFT Xion,CHALLENGER I,603,13.8,1164,161,1003,kr
1177,177,안하기로했자나,CHALLENGER I,603,16.1,390,63,327,kr
1178,178,백석대학교,CHALLENGER I,603,16.8,340,57,283,kr
1179,179,Daeju imp,CHALLENGER I,603,10.0,441,44,397,kr
1180,180,s3unguk,CHALLENGER I,602,14.6,547,80,467,kr
1181,181,귀여운피즈자나,CHALLENGER I,601,13.4,723,97,626,kr
1182,182,토토로11,CHALLENGER I,601,11.5,806,93,713,kr
1183,183,모리가와,CHALLENGER I,601,11.5,564,65,499,kr
1184,184,대깨포식자,CHALLENGER I,601,13.6,447,61,386,kr
1185,185,V 6 6 V,CHALLENGER I,600,12.3,672,83,589,kr
1186,186,AFTV 깔창부린,CHALLENGER I,598,15.8,1874,296,1578,kr
1187,187,베가알쓰리짱,CHALLENGER I,596,13.8,675,93,582,kr
1188,188,오우거 돌주먹,CHALLENGER I,596,15.8,565,89,476,kr
1189,189,눈부신 날,CHALLENGER I,596,15.8,347,55,292,kr
1190,190,족발당수,CHALLENGER I,594,20.0,185,37,148,kr
1191,191,TFT 1436,CHALLENGER I,592,15.6,289,45,244,kr
1192,192,12321231,CHALLENGER I,592,29.6,145,43,102,kr
1193,193,꽝 백,CHALLENGER I,591,15.6,508,79,429,kr
1194,194,나랑랑이,CHALLENGER I,591,13.4,433,58,375,kr
1195,195,미래지향사나이,CHALLENGER I,590,15.8,637,101,536,kr
1196,196,멀보노자슥아,CHALLENGER I,590,13.4,745,100,645,kr
1197,197,미소왕,CHALLENGER I,590,13.8,630,87,543,kr
1198,198,I Go Challenger,CHALLENGER I,590,14.9,369,55,314,kr
1199,199,팬더랑놀자,CHALLENGER I,589,13.9,625,87,538,kr
1200,200,비비고김치,CHALLENGER I,589,8.9,469,42,427,kr
1201,1,Líon,CHALLENGER I,1498,21.5,604,130,474,lan
1202,2,Tewesineitor,CHALLENGER I,1473,28.8,312,90,222,lan
1203,3,Rayio,CHALLENGER I,1447,23.3,939,219,720,lan
1204,4,akalyzer,CHALLENGER I,1340,27.2,695,189,506,lan
1205,5,Quantum8,CHALLENGER I,1231,25.5,314,80,234,lan
1206,6,CarryMe Akashi,CHALLENGER I,917,20.3,493,100,393,lan
1207,7,GhoStorm,CHALLENGER I,905,21.0,410,86,324,lan
1208,8,Cerealito,CHALLENGER I,869,18.3,415,76,339,lan
1209,9,Yami Laicus,CHALLENGER I,851,27.3,308,84,224,lan
1210,10,Crycer,CHALLENGER I,848,29.7,310,92,218,lan
1211,11,SákuraHana,CHALLENGER I,831,31.7,230,73,157,lan
1212,12,bite of destiny,CHALLENGER I,763,21.6,569,123,446,lan
1213,13,KilljoyMex,CHALLENGER I,670,22.7,251,57,194,lan
1214,14,lmlWarCrY,CHALLENGER I,615,21.8,307,67,240,lan
1215,15,MyzteryAlex,CHALLENGER I,603,12.5,952,119,833,lan
1216,16,2D Jaro,CHALLENGER I,559,23.8,764,182,582,lan
1217,17,xBjaker,CHALLENGER I,552,21.3,315,67,248,lan
1218,18,MaRiO bRoS,CHALLENGER I,539,17.8,769,137,632,lan
1219,19,Dlanor,CHALLENGER I,525,21.2,448,95,353,lan
1220,20,Ch1wy,CHALLENGER I,503,13.8,748,103,645,lan
1221,21,Slix,CHALLENGER I,493,25.8,190,49,141,lan
1222,22,Garto Ward,CHALLENGER I,475,17.6,319,56,263,lan
1223,23,PipoMaster,CHALLENGER I,471,21.9,310,68,242,lan
1224,24,Exus,CHALLENGER I,464,20.7,324,67,257,lan
1225,25,Redmoonwolf,CHALLENGER I,460,11.8,356,42,314,lan
1226,26,QuiMi,CHALLENGER I,449,20.2,366,74,292,lan
1227,27,andmont,CHALLENGER I,447,19.5,266,52,214,lan
1228,28,TftAcademy,CHALLENGER I,446,12.9,550,71,479,lan
1229,29,Frondavil,CHALLENGER I,440,16.1,436,70,366,lan
1230,30,Quántum,CHALLENGER I,436,23.8,181,43,138,lan
1231,31,Soul 1,CHALLENGER I,435,23.6,259,61,198,lan
1232,32,TheBadMF,CHALLENGER I,430,16.6,355,59,296,lan
1233,33,RiftHerald,CHALLENGER I,429,17.4,212,37,175,lan
1234,34,CrisT1an,CHALLENGER I,427,23.7,219,52,167,lan
1235,35,Siempremuerto,CHALLENGER I,426,15.6,346,54,292,lan
1236,36,AztecMx,CHALLENGER I,424,13.4,246,33,213,lan
1237,37,JOnnyLR,CHALLENGER I,423,17.2,360,62,298,lan
1238,38,oliver10,CHALLENGER I,422,20.1,278,56,222,lan
1239,39,AntonyGamingTFT,CHALLENGER I,419,15.5,510,79,431,lan
1240,40,Vork,CHALLENGER I,419,15.5,471,73,398,lan
1241,41,Garchomp,CHALLENGER I,419,27.6,188,52,136,lan
1242,42,Lysıthea,CHALLENGER I,418,23.4,376,88,288,lan
1243,43,Mr Mugui,CHALLENGER I,417,17.1,1029,176,853,lan
1244,44,Im not villo,CHALLENGER I,408,21.0,367,77,290,lan
1245,45,Ardén,CHALLENGER I,406,12.8,539,69,470,lan
1246,46,Sealcune Mbappé,CHALLENGER I,402,18.9,586,111,475,lan
1247,47,melizaX,CHALLENGER I,390,17.4,338,59,279,lan
1248,48,KiraDessu,CHALLENGER I,389,22.4,411,92,319,lan
1249,49,ransabia,CHALLENGER I,388,14.4,651,94,557,lan
1250,50,Hi im Clark,CHALLENGER I,380,22.3,291,65,226,lan
1251,51,Maguita,"GRANDMASTER I
G",383,18.7,369,69,300,lan
1252,52,diandi,"GRANDMASTER I
G",374,22.8,312,71,241,lan
1253,53,ChinoRobin,"GRANDMASTER I
G",374,24.5,278,68,210,lan
1254,54,Dal,"GRANDMASTER I
G",358,19.6,373,73,300,lan
1255,55,Ucr,"GRANDMASTER I
G",340,16.6,441,73,368,lan
1256,56,javia316,"GRANDMASTER I
G",322,15.7,511,80,431,lan
1257,57,lyonew,"GRANDMASTER I
G",320,14.6,541,79,462,lan
1258,58,Beyond Reality,"GRANDMASTER I
G",306,17.7,356,63,293,lan
1259,59,Marcela Valencia,"GRANDMASTER I
G",295,24.4,221,54,167,lan
1260,60,Gio9811,"GRANDMASTER I
G",290,16.5,255,42,213,lan
1261,61,Aletsis,"GRANDMASTER I
G",289,23.5,166,39,127,lan
1262,62,Kurokoba,"GRANDMASTER I
G",288,18.7,187,35,152,lan
1263,63,DL DIAMOND DL,"GRANDMASTER I
G",282,14.1,304,43,261,lan
1264,64,warlocksky,"GRANDMASTER I
G",281,14.4,277,40,237,lan
1265,65,Twistä,"GRANDMASTER I
G",277,11.2,365,41,324,lan
1266,66,shiry,"GRANDMASTER I
G",266,19.1,288,55,233,lan
1267,67,itken,"GRANDMASTER I
G",256,16.4,1034,170,864,lan
1268,68,BarbeQ,"GRANDMASTER I
G",256,15.8,593,94,499,lan
1269,69,Dondenuncias,"GRANDMASTER I
G",245,28.2,170,48,122,lan
1270,70,Xkorzo YT,"GRANDMASTER I
G",242,28.8,104,30,74,lan
1271,71,No soy exoor,"GRANDMASTER I
G",241,24.9,185,46,139,lan
1272,72,Too Sweet,"GRANDMASTER I
G",237,25.3,146,37,109,lan
1273,73,McGregorr,"GRANDMASTER I
G",227,18.9,429,81,348,lan
1274,74,Rodo TFT,"GRANDMASTER I
G",221,15.9,245,39,206,lan
1275,75,Rcadillo,"GRANDMASTER I
G",213,15.7,873,137,736,lan
1276,76,25356,"GRANDMASTER I
G",212,16.8,310,52,258,lan
1277,77,AbrahamBM,"GRANDMASTER I
G",204,16.8,197,33,164,lan
1278,78,KllK EditZ,"GRANDMASTER I
G",203,17.7,311,55,256,lan
1279,79,Psend,"GRANDMASTER I
G",203,19.1,204,39,165,lan
1280,80,TeversomuchT,"GRANDMASTER I
G",202,13.6,464,63,401,lan
1281,81,Pompo,"GRANDMASTER I
G",196,18.2,351,64,287,lan
1282,82,Khorge PN,"GRANDMASTER I
G",194,19.2,219,42,177,lan
1283,83,Cjddd,"GRANDMASTER I
G",194,15.8,221,35,186,lan
1284,84,Vampiro Playero,"GRANDMASTER I
G",192,19.0,327,62,265,lan
1285,85,ChupemElPrime,"GRANDMASTER I
G",191,20.2,311,63,248,lan
1286,86,G2 Josar,"GRANDMASTER I
G",184,19.1,355,68,287,lan
1287,87,ExtraWuiller,"GRANDMASTER I
G",183,13.8,254,35,219,lan
1288,88,Revengp,"GRANDMASTER I
G",181,20.7,232,48,184,lan
1289,89,Chesspants,"GRANDMASTER I
G",177,19.2,203,39,164,lan
1290,90,Gargota,"GRANDMASTER I
G",173,21.0,319,67,252,lan
1291,91,XiaoPo06,"GRANDMASTER I
G",168,13.4,648,87,561,lan
1292,92,ICostDRE,"GRANDMASTER I
G",158,16.0,593,95,498,lan
1293,93,Cloud strife,"GRANDMASTER I
G",158,16.9,160,27,133,lan
1294,94,Need more skins,"GRANDMASTER I
G",157,15.3,386,59,327,lan
1295,95,Ovejomaru,"GRANDMASTER I
G",156,20.1,319,64,255,lan
1296,96,scarmg,"GRANDMASTER I
G",154,20.2,362,73,289,lan
1297,97,Main Q,"GRANDMASTER I
G",154,19.7,294,58,236,lan
1298,98,lkokito,"GRANDMASTER I
G",153,18.1,425,77,348,lan
1299,99,thewghost,"GRANDMASTER I
G",153,23.8,202,48,154,lan
1300,100,AlXDXD,"GRANDMASTER I
G",153,18.4,234,43,191,lan
1301,101,TFT Lelouch,"GRANDMASTER I
G",146,13.9,266,37,229,lan
1302,102,KOR Doyong,"GRANDMASTER I
G",140,21.6,157,34,123,lan
1303,103,TFTJefe,"GRANDMASTER I
G",137,15.0,286,43,243,lan
1304,104,panchoAngüis,"GRANDMASTER I
G",135,23.4,307,72,235,lan
1305,105,FordHealer,"GRANDMASTER I
G",135,27.0,74,20,54,lan
1306,106,Enr1que,"GRANDMASTER I
G",131,11.4,665,76,589,lan
1307,107,PoronghaNegra,"GRANDMASTER I
G",130,17.1,415,71,344,lan
1308,108,Don Stban,"GRANDMASTER I
G",130,21.0,138,29,109,lan
1309,109,Apödaca,"GRANDMASTER I
G",128,25.4,280,71,209,lan
1310,110,Jir0,"GRANDMASTER I
G",127,15.6,508,79,429,lan
1311,111,OTP Rumble,"GRANDMASTER I
G",126,14.5,172,25,147,lan
1312,112,4manu4,"GRANDMASTER I
G",123,15.4,298,46,252,lan
1313,113,Nebura,"GRANDMASTER I
G",122,19.6,209,41,168,lan
1314,114,God JdGa,"GRANDMASTER I
G",118,23.2,362,84,278,lan
1315,115,TrafalgarL4w,"GRANDMASTER I
G",117,20.6,422,87,335,lan
1316,116,TFT Ares,"GRANDMASTER I
G",114,10.9,548,60,488,lan
1317,117,papusmaximus,"GRANDMASTER I
G",110,6.4,328,21,307,lan
1318,118,juandotft,"GRANDMASTER I
G",109,16.5,182,30,152,lan
1319,119,llRyougiShiki,"GRANDMASTER I
G",108,15.7,216,34,182,lan
1320,120,Pauleandro,"GRANDMASTER I
G",107,8.3,577,48,529,lan
1321,121,llArthzll,"GRANDMASTER I
G",105,23.6,339,80,259,lan
1322,122,Archi,"GRANDMASTER I
G",105,12.9,240,31,209,lan
1323,123,BarbieQ,"GRANDMASTER I
G",105,27.3,110,30,80,lan
1324,124,ILY Elena Rubí,"GRANDMASTER I
G",105,23.5,119,28,91,lan
1325,125,Tactics,"GRANDMASTER I
G",104,7.2,923,66,857,lan
1326,126,Lą Mąscotą,"GRANDMASTER I
G",102,16.2,160,26,134,lan
1327,127,Fherpaz,"GRANDMASTER I
G",101,13.5,465,63,402,lan
1328,128,Stuff,"GRANDMASTER I
G",101,14.2,429,61,368,lan
1329,129,DragoFenix2,"GRANDMASTER I
G",101,15.9,296,47,249,lan
1330,130,FjBlanco,"GRANDMASTER I
G",100,17.8,365,65,300,lan
1331,131,Wamuu,"GRANDMASTER I
G",97,17.2,400,69,331,lan
1332,132,Skaaarl,"GRANDMASTER I
G",96,16.2,259,42,217,lan
1333,133,ianakin7,"GRANDMASTER I
G",95,17.9,793,142,651,lan
1334,134,TOMATOFARMER535,"GRANDMASTER I
G",95,9.6,645,62,583,lan
1335,135,TheFenixx,"GRANDMASTER I
G",94,29.4,221,65,156,lan
1336,136,Marenn,"GRANDMASTER I
G",94,13.3,294,39,255,lan
1337,137,GREIVIN,"GRANDMASTER I
G",94,10.2,294,30,264,lan
1338,138,LFT Zero,"GRANDMASTER I
G",93,16.4,152,25,127,lan
1339,139,LaGoorda,"GRANDMASTER I
G",91,17.7,164,29,135,lan
1340,140,DLT Macloud,"GRANDMASTER I
G",90,17.0,501,85,416,lan
1341,141,7DS HyperSpace,"GRANDMASTER I
G",89,21.6,1053,227,826,lan
1342,142,No Mercy,"GRANDMASTER I
G",88,16.9,587,99,488,lan
1343,143,Pedro Bae,"GRANDMASTER I
G",88,24.8,355,88,267,lan
1344,144,Enryu The Red,"GRANDMASTER I
G",86,18.6,311,58,253,lan
1345,145,Khorge,"GRANDMASTER I
G",86,19.0,137,26,111,lan
1346,146,Gatito Cósmıco,"GRANDMASTER I
G",85,17.8,242,43,199,lan
1347,147,Sigma the black,"GRANDMASTER I
G",85,10.9,303,33,270,lan
1348,148,Souł,"GRANDMASTER I
G",65,15.4,325,50,275,lan
1349,149,Awela Requiem,"GRANDMASTER I
G",38,22.3,274,61,213,lan
1350,150,rambo12345678,"GRANDMASTER I
G",0,14.6,553,81,472,lan
1351,151,YaphetS Karma,MASTER I,99,22.4,174,39,135,lan
1352,152,Mahito,MASTER I,87,20.1,204,41,163,lan
1353,153,DenisLuluch,MASTER I,84,15.2,400,61,339,lan
1354,154,Stupefy,MASTER I,84,13.0,446,58,388,lan
1355,155,JhonWonka,MASTER I,83,19.5,251,49,202,lan
1356,156,Miguel Aleman,MASTER I,79,17.2,209,36,173,lan
1357,157,Danté,MASTER I,77,19.0,347,66,281,lan
1358,158,Putint,MASTER I,74,18.9,275,52,223,lan
1359,159,GS Lancelot,MASTER I,70,17.3,301,52,249,lan
1360,160,crazy999666,MASTER I,70,16.4,237,39,198,lan
1361,161,BlitzDance,MASTER I,70,18.2,154,28,126,lan
1362,162,BoscoBramblefoot,MASTER I,67,19.1,241,46,195,lan
1363,163,Surprise lm Back,MASTER I,64,17.1,299,51,248,lan
1364,164,Marvelous,MASTER I,57,17.5,263,46,217,lan
1365,165,marduko,MASTER I,57,11.2,269,30,239,lan
1366,166,Moncho,MASTER I,56,12.7,158,20,138,lan
1367,167,HoIIow Knight,MASTER I,50,14.9,356,53,303,lan
1368,168,Fufumin,MASTER I,50,25.2,99,25,74,lan
1369,169,TheGearZ,MASTER I,50,12.1,182,22,160,lan
1370,170,Skan011,MASTER I,48,13.7,241,33,208,lan
1371,171,Orange,MASTER I,46,11.9,489,58,431,lan
1372,172,xHeroskillx,MASTER I,46,15.4,246,38,208,lan
1373,173,Ęnder,MASTER I,46,16.0,181,29,152,lan
1374,174,KidHellion,MASTER I,46,13.1,221,29,192,lan
1375,175,Gallher,MASTER I,43,18.7,497,93,404,lan
1376,176,tommyfosfor1llo,MASTER I,42,20.1,427,86,341,lan
1377,177,GøldLyon,MASTER I,41,16.4,311,51,260,lan
1378,178,TheOnlyTeddy,MASTER I,41,16.5,267,44,223,lan
1379,179,Sonagi,MASTER I,39,19.0,158,30,128,lan
1380,180,EN1GMA,MASTER I,38,18.4,814,150,664,lan
1381,181,Porygon,MASTER I,37,23.9,113,27,86,lan
1382,182,caifas1995,MASTER I,36,18.2,681,124,557,lan
1383,183,El HuachicoIero,MASTER I,36,15.8,95,15,80,lan
1384,184,Aguri Onishi,MASTER I,35,19.2,177,34,143,lan
1385,185,JONN93,MASTER I,33,12.9,618,80,538,lan
1386,186,Wínter,MASTER I,33,17.6,210,37,173,lan
1387,187,wolfteamx5,MASTER I,32,15.3,652,100,552,lan
1388,188,zeiik,MASTER I,32,16.4,275,45,230,lan
1389,189,Neär,MASTER I,31,14.2,380,54,326,lan
1390,190,jjvanegask77,MASTER I,31,18.9,169,32,137,lan
1391,191,socio2k,MASTER I,29,17.2,325,56,269,lan
1392,192,matazorros,MASTER I,29,19.4,211,41,170,lan
1393,193,Vey,MASTER I,29,16.5,224,37,187,lan
1394,194,HiGip,MASTER I,28,25.7,101,26,75,lan
1395,195,HECT55,MASTER I,27,16.2,272,44,228,lan
1396,196,Rambotehamatado,MASTER I,25,15.7,502,79,423,lan
1397,197,SAV Nooba,MASTER I,25,18.4,163,30,133,lan
1398,198,0 Horus,MASTER I,24,15.8,322,51,271,lan
1399,199,Šęcręt Aurôrą,MASTER I,24,14.1,290,41,249,lan
1400,200,Anivio,MASTER I,23,16.4,292,48,244,lan
1401,1,FaryaAndWoIyo,CHALLENGER I,1808,29.4,354,104,250,las
1402,2,Kłaytøn,CHALLENGER I,1725,25.8,427,110,317,las
1403,3,Shireen4,CHALLENGER I,1523,26.3,525,138,387,las
1404,4,Tolengo73,CHALLENGER I,1362,27.4,530,145,385,las
1405,5,S de Sencillo,CHALLENGER I,1257,18.8,1440,270,1170,las
1406,6,DarksBit,CHALLENGER I,1140,24.6,268,66,202,las
1407,7,Fourloko RX,CHALLENGER I,1067,21.5,311,67,244,las
1408,8,UCH TheLiNe,CHALLENGER I,965,30.1,272,82,190,las
1409,9,No Quarter,CHALLENGER I,926,21.6,393,85,308,las
1410,10,JustDream,CHALLENGER I,924,17.7,925,164,761,las
1411,11,Samenix,CHALLENGER I,868,27.1,292,79,213,las
1412,12,Altenahue,CHALLENGER I,857,22.9,490,112,378,las
1413,13,FuryTank,CHALLENGER I,789,20.7,352,73,279,las
1414,14,Priend,CHALLENGER I,769,17.8,628,112,516,las
1415,15,Highroll,CHALLENGER I,766,19.9,714,142,572,las
1416,16,CooLDownJJ,CHALLENGER I,758,25.2,301,76,225,las
1417,17,Fan de la Linea,CHALLENGER I,712,25.4,197,50,147,las
1418,18,UCH Morfer,CHALLENGER I,640,18.2,297,54,243,las
1419,19,shuuumpy,CHALLENGER I,637,20.5,430,88,342,las
1420,20,RoSweL TacTicS,CHALLENGER I,630,15.4,976,150,826,las
1421,21,404NameeNotFound,CHALLENGER I,623,16.9,538,91,447,las
1422,22,LifesBadTFT,CHALLENGER I,555,21.1,285,60,225,las
1423,23,Christus,CHALLENGER I,536,28.7,157,45,112,las
1424,24,Dukie,CHALLENGER I,526,20.3,187,38,149,las
1425,25,New Stage,CHALLENGER I,524,19.1,330,63,267,las
1426,26,Girlfromnoxuss,CHALLENGER I,504,19.7,665,131,534,las
1427,27,Gara Arg,CHALLENGER I,503,18.7,449,84,365,las
1428,28,InvadersMD,CHALLENGER I,482,15.9,817,130,687,las
1429,29,Bugame,CHALLENGER I,459,22.5,222,50,172,las
1430,30,Chino Weng TFT,CHALLENGER I,448,22.2,495,110,385,las
1431,31,Åzok,CHALLENGER I,438,15.9,433,69,364,las
1432,32,sendohrai,CHALLENGER I,435,17.9,324,58,266,las
1433,33,Rubik,CHALLENGER I,428,17.3,272,47,225,las
1434,34,AUGUSTOMARCO,CHALLENGER I,419,15.0,373,56,317,las
1435,35,Hellfire,CHALLENGER I,408,20.8,336,70,266,las
1436,36,TFT MMR Perfect,CHALLENGER I,401,16.9,567,96,471,las
1437,37,Cupiditas,CHALLENGER I,401,20.1,308,62,246,las
1438,38,Don Galli,CHALLENGER I,395,20.5,166,34,132,las
1439,39,Greyd0n,CHALLENGER I,387,13.5,416,56,360,las
1440,40,Changuito 10,CHALLENGER I,386,19.1,215,41,174,las
1441,41,Jesus,CHALLENGER I,380,22.5,151,34,117,las
1442,42,Cvictoria Bryant,CHALLENGER I,379,15.9,495,79,416,las
1443,43,Raruto,CHALLENGER I,379,14.0,272,38,234,las
1444,44,ANIMEWEEBLORD420,CHALLENGER I,377,26.9,134,36,98,las
1445,45,iudex Jevic,CHALLENGER I,368,17.3,762,132,630,las
1446,46,hartung,CHALLENGER I,368,16.2,383,62,321,las
1447,47,Emad Joestar,CHALLENGER I,367,17.9,212,38,174,las
1448,48,ACÁ MANDO YO,CHALLENGER I,359,20.4,441,90,351,las
1449,49,xiomax,CHALLENGER I,354,16.4,336,55,281,las
1450,50,ROH inSec t0,CHALLENGER I,324,14.0,444,62,382,las
1451,51,elPepi,"GRANDMASTER I
G",387,16.8,244,41,203,las
1452,52,Lyked,"GRANDMASTER I
G",365,25.5,263,67,196,las
1453,53,Tr1ckster,"GRANDMASTER I
G",355,29.4,119,35,84,las
1454,54,Wazapper,"GRANDMASTER I
G",343,16.3,325,53,272,las
1455,55,Desgr4cia,"GRANDMASTER I
G",328,10.2,1073,110,963,las
1456,56,ElbalmoR,"GRANDMASTER I
G",320,16.7,300,50,250,las
1457,57,Fradox22,"GRANDMASTER I
G",309,21.2,193,41,152,las
1458,58,BC Thoryn,"GRANDMASTER I
G",298,21.4,252,54,198,las
1459,59,MättZ,"GRANDMASTER I
G",271,11.0,520,57,463,las
1460,60,Xork,"GRANDMASTER I
G",260,19.7,466,92,374,las
1461,61,Nico Del Baño,"GRANDMASTER I
G",257,25.0,160,40,120,las
1462,62,ChakoPopoco,"GRANDMASTER I
G",253,15.5,498,77,421,las
1463,63,Tob9,"GRANDMASTER I
G",239,22.5,315,71,244,las
1464,64,xaimmer,"GRANDMASTER I
G",237,17.0,518,88,430,las
1465,65,MorteMTW,"GRANDMASTER I
G",209,16.8,630,106,524,las
1466,66,HeRz BenT,"GRANDMASTER I
G",206,19.3,336,65,271,las
1467,67,RNGPDD,"GRANDMASTER I
G",205,22.9,140,32,108,las
1468,68,KTP Yoshi,"GRANDMASTER I
G",199,13.7,452,62,390,las
1469,69,Ryuuk Kyuu,"GRANDMASTER I
G",196,14.4,180,26,154,las
1470,70,Zionooooo,"GRANDMASTER I
G",193,16.1,249,40,209,las
1471,71,SirBłack,"GRANDMASTER I
G",186,16.5,357,59,298,las
1472,72,geoffroy123,"GRANDMASTER I
G",186,14.5,145,21,124,las
1473,73,LuckyDuit,"GRANDMASTER I
G",177,16.8,286,48,238,las
1474,74,JueguenNormal,"GRANDMASTER I
G",176,14.9,504,75,429,las
1475,75,100cityfico,"GRANDMASTER I
G",173,10.9,494,54,440,las
1476,76,Karnal,"GRANDMASTER I
G",170,14.7,550,81,469,las
1477,77,Viangrele,"GRANDMASTER I
G",162,24.7,324,80,244,las
1478,78,Dogor,"GRANDMASTER I
G",158,16.1,285,46,239,las
1479,79,NachoG95,"GRANDMASTER I
G",153,16.9,496,84,412,las
1480,80,ElnicoMata,"GRANDMASTER I
G",150,11.9,698,83,615,las
1481,81,Bandalians,"GRANDMASTER I
G",145,14.9,1063,158,905,las
1482,82,Peronism,"GRANDMASTER I
G",141,15.1,292,44,248,las
1483,83,Rekatria,"GRANDMASTER I
G",137,17.6,221,39,182,las
1484,84,Error 402,"GRANDMASTER I
G",122,15.9,245,39,206,las
1485,85,Super Carlitos,"GRANDMASTER I
G",119,12.2,563,69,494,las
1486,86,Arizona Zervas,"GRANDMASTER I
G",117,16.1,427,69,358,las
1487,87,Gaattsu,"GRANDMASTER I
G",116,12.9,535,69,466,las
1488,88,Cupidotas,"GRANDMASTER I
G",116,33.3,84,28,56,las
1489,89,spiirati,"GRANDMASTER I
G",115,15.6,462,72,390,las
1490,90,Necroshine77,"GRANDMASTER I
G",114,19.5,375,73,302,las
1491,91,Danielove,"GRANDMASTER I
G",112,14.1,375,53,322,las
1492,92,xZaMaSx,"GRANDMASTER I
G",110,16.3,398,65,333,las
1493,93,pancitodemoldee,"GRANDMASTER I
G",110,13.9,453,63,390,las
1494,94,BolaDeLomo,"GRANDMASTER I
G",109,15.4,299,46,253,las
1495,95,Sirzechsl,"GRANDMASTER I
G",106,12.9,425,55,370,las
1496,96,iPurge1,"GRANDMASTER I
G",106,13.9,387,54,333,las
1497,97,Kimarus,"GRANDMASTER I
G",105,20.9,326,68,258,las
1498,98,TWOEASY,"GRANDMASTER I
G",104,13.3,270,36,234,las
1499,99,tips best lol,"GRANDMASTER I
G",103,15.7,631,99,532,las
1500,100,dimeloneri,"GRANDMASTER I
G",100,12.9,355,46,309,las
1501,101,TwitchTVLifesBad,"GRANDMASTER I
G",98,25.9,158,41,117,las
1502,102,xXhermaniguiXx,"GRANDMASTER I
G",97,19.7,305,60,245,las
1503,103,ViruZTS,"GRANDMASTER I
G",97,19.2,313,60,253,las
1504,104,CodMeiro,"GRANDMASTER I
G",93,15.0,313,47,266,las
1505,105,Caver,"GRANDMASTER I
G",92,16.0,269,43,226,las
1506,106,TheDanieTFT,"GRANDMASTER I
G",92,13.5,185,25,160,las
1507,107,Ola soi Smurf,"GRANDMASTER I
G",90,32.5,86,28,58,las
1508,108,Dtoke Freestyler,"GRANDMASTER I
G",89,13.9,460,64,396,las
1509,109,LOLEROPERONOPACO,"GRANDMASTER I
G",89,19.0,305,58,247,las
1510,110,manuaj97,"GRANDMASTER I
G",89,17.3,196,34,162,las
1511,111,CuriousChameIeon,"GRANDMASTER I
G",88,20.5,415,85,330,las
1512,112,Wolf Bak,"GRANDMASTER I
G",88,15.7,471,74,397,las
1513,113,64 Bits,"GRANDMASTER I
G",88,14.3,238,34,204,las
1514,114,IICelesteII,"GRANDMASTER I
G",86,15.7,617,97,520,las
1515,115,Sáyron,"GRANDMASTER I
G",86,13.2,438,58,380,las
1516,116,Hukka,"GRANDMASTER I
G",84,16.8,262,44,218,las
1517,117,Stoned Bulbasaur,"GRANDMASTER I
G",84,14.0,222,31,191,las
1518,118,QT FD,"GRANDMASTER I
G",83,17.7,583,103,480,las
1519,119,Mid Ghost,"GRANDMASTER I
G",81,13.9,1024,142,882,las
1520,120,p Ø L i,"GRANDMASTER I
G",81,13.8,513,71,442,las
1521,121,HuNnnTeR,"GRANDMASTER I
G",80,16.2,812,132,680,las
1522,122,Xerwell,"GRANDMASTER I
G",80,14.9,415,62,353,las
1523,123,Orco13,"GRANDMASTER I
G",80,17.6,290,51,239,las
1524,124,Daian21,"GRANDMASTER I
G",79,8.7,427,37,390,las
1525,125,UCH Koro,"GRANDMASTER I
G",78,17.5,359,63,296,las
1526,126,Crux,"GRANDMASTER I
G",78,15.4,351,54,297,las
1527,127,alehhhh,"GRANDMASTER I
G",76,17.2,691,119,572,las
1528,128,Hardcorito Facho,"GRANDMASTER I
G",76,17.4,230,40,190,las
1529,129,TOXIAS,"GRANDMASTER I
G",76,16.6,193,32,161,las
1530,130,CatLourd,"GRANDMASTER I
G",75,14.3,237,34,203,las
1531,131,Krovsavetik,"GRANDMASTER I
G",74,13.3,301,40,261,las
1532,132,TU WAIFU ME AMA,"GRANDMASTER I
G",73,17.7,181,32,149,las
1533,133,iForeverBronze,"GRANDMASTER I
G",72,16.3,841,137,704,las
1534,134,Dungeon,"GRANDMASTER I
G",72,16.3,392,64,328,las
1535,135,Lean Live,"GRANDMASTER I
G",71,14.2,332,47,285,las
1536,136,Fuji,"GRANDMASTER I
G",71,14.2,247,35,212,las
1537,137,MaurooCARP,"GRANDMASTER I
G",70,17.7,237,42,195,las
1538,138,SlashFullMuteAll,"GRANDMASTER I
G",69,15.3,352,54,298,las
1539,139,KeRikoWisKi,"GRANDMASTER I
G",68,15.4,273,42,231,las
1540,140,Lonkiwi,"GRANDMASTER I
G",66,16.2,438,71,367,las
1541,141,TheClasman,"GRANDMASTER I
G",66,14.6,412,60,352,las
1542,142,WaIter White Jr,"GRANDMASTER I
G",64,13.3,422,56,366,las
1543,143,ChitoPampi,"GRANDMASTER I
G",64,13.7,365,50,315,las
1544,144,animesenpai2,"GRANDMASTER I
G",64,14.2,275,39,236,las
1545,145,Brooklyn Baby,"GRANDMASTER I
G",60,24.7,162,40,122,las
1546,146,Dim4s,"GRANDMASTER I
G",60,22.4,143,32,111,las
1547,147,Chino Rios,"GRANDMASTER I
G",57,18.1,458,83,375,las
1548,148,skitifornia,"GRANDMASTER I
G",55,13.8,679,94,585,las
1549,149,Dycoop,"GRANDMASTER I
G",12,19.4,196,38,158,las
1550,150,ElDryzler,"GRANDMASTER I
G",0,11.6,421,49,372,las
1551,151,Sikolio,MASTER I,122,18.4,429,79,350,las
1552,152,Pastero en Bici,MASTER I,111,17.0,405,69,336,las
1553,153,NaynitoKebab,MASTER I,110,16.0,425,68,357,las
1554,154,Twitch Jaypi9,MASTER I,93,15.6,762,119,643,las
1555,155,Tirale la Ulti,MASTER I,83,11.1,414,46,368,las
1556,156,Berzedker,MASTER I,67,17.4,316,55,261,las
1557,157,Seminare,MASTER I,65,16.9,326,55,271,las
1558,158,ikarosdesu,MASTER I,64,18.6,145,27,118,las
1559,159,toy chikita,MASTER I,55,20.9,211,44,167,las
1560,160,Haise,MASTER I,52,15.8,209,33,176,las
1561,161,Spaark  TFT,MASTER I,49,16.5,194,32,162,las
1562,162,Drakinir,MASTER I,45,15.4,201,31,170,las
1563,163,Daelon TFT,MASTER I,44,13.1,413,54,359,las
1564,164,kraxs,MASTER I,41,14.6,501,73,428,las
1565,165,Un Desconocido,MASTER I,40,12.9,310,40,270,las
1566,166,Mapachee,MASTER I,39,21.1,380,80,300,las
1567,167,UCH Dario,MASTER I,39,12.0,432,52,380,las
1568,168,Trimsk,MASTER I,39,14.7,252,37,215,las
1569,169,Gasté 13900 IP,MASTER I,36,17.1,369,63,306,las
1570,170,Leyton0,MASTER I,36,20.7,270,56,214,las
1571,171,LIEUTENANT DAN,MASTER I,36,17.6,273,48,225,las
1572,172,Tortuga Inmortal,MASTER I,35,14.0,494,69,425,las
1573,173,Kenshi0,MASTER I,34,15.6,269,42,227,las
1574,174,goldcs,MASTER I,33,12.1,546,66,480,las
1575,175,xTato,MASTER I,33,13.7,197,27,170,las
1576,176,Flaco Friky,MASTER I,33,15.5,168,26,142,las
1577,177,ZucaLIVE,MASTER I,30,13.8,391,54,337,las
1578,178,juanferquinterop,MASTER I,30,14.7,251,37,214,las
1579,179,elchicolinux,MASTER I,26,16.7,347,58,289,las
1580,180,Perekkles,MASTER I,26,17.7,311,55,256,las
1581,181,Tactics iBaggy,MASTER I,26,14.1,241,34,207,las
1582,182,ManuelAIcayaga,MASTER I,24,16.7,216,36,180,las
1583,183,Cifumeta,MASTER I,24,16.4,220,36,184,las
1584,184,DONBOMBASTIC,MASTER I,23,16.0,294,47,247,las
1585,185,Kozukî Oden,MASTER I,22,12.7,260,33,227,las
1586,186,SocomReturnx,MASTER I,21,21.6,282,61,221,las
1587,187,VortexN,MASTER I,21,14.6,411,60,351,las
1588,188,Sadness Xiu,MASTER I,21,12.4,289,36,253,las
1589,189,LL Jhin,MASTER I,21,16.7,192,32,160,las
1590,190,KRagnarLodbrok,MASTER I,20,23.0,248,57,191,las
1591,191,n50,MASTER I,19,18.1,558,101,457,las
1592,192,AlonsOcean,MASTER I,19,11.5,375,43,332,las
1593,193,MateDeCoco,MASTER I,19,16.8,208,35,173,las
1594,194,Preshelec,MASTER I,18,15.1,185,28,157,las
1595,195,UruSativaCarryJr,MASTER I,17,20.5,215,44,171,las
1596,196,Cv 366,MASTER I,17,17.9,207,37,170,las
1597,197,ssbita,MASTER I,16,18.8,309,58,251,las
1598,198,iEgoist,MASTER I,15,14.1,213,30,183,las
1599,199,Friend Request,MASTER I,15,16.8,137,23,114,las
1600,200,Warra,MASTER I,14,16.5,309,51,258,las
1601,1,Steve Lau,CHALLENGER I,1086,23.2,949,220,729,oce
1602,2,Angora,CHALLENGER I,1081,26.4,356,94,262,oce
1603,3,vx s5683169,CHALLENGER I,1077,24.3,411,100,311,oce
1604,4,CombatEZ,CHALLENGER I,1049,25.9,197,51,146,oce
1605,5,1ydia233,CHALLENGER I,715,25.4,201,51,150,oce
1606,6,KirinSupreme,CHALLENGER I,655,19.0,525,100,425,oce
1607,7,yuzhibo777,CHALLENGER I,610,19.8,379,75,304,oce
1608,8,JimJaam,CHALLENGER I,609,18.9,507,96,411,oce
1609,9,ilikeud,CHALLENGER I,545,22.3,247,55,192,oce
1610,10,HatsuneMik,CHALLENGER I,524,24.4,209,51,158,oce
1611,11,Age of Empires 3,CHALLENGER I,521,14.3,489,70,419,oce
1612,12,Blender Main,CHALLENGER I,492,21.2,184,39,145,oce
1613,13,dz2,CHALLENGER I,484,13.8,463,64,399,oce
1614,14,ˇPhoenix,CHALLENGER I,471,23.8,324,77,247,oce
1615,15,jiaonizuodog,CHALLENGER I,442,18.7,664,124,540,oce
1616,16,thedashuaibi,CHALLENGER I,435,19.9,421,84,337,oce
1617,17,stealmybuild TTV,CHALLENGER I,433,16.8,440,74,366,oce
1618,18,Bruceissss,CHALLENGER I,425,18.0,538,97,441,oce
1619,19,plplplpp,CHALLENGER I,417,22.1,344,76,268,oce
1620,20,Rng28002200,CHALLENGER I,414,20.7,222,46,176,oce
1621,21,MYdi,CHALLENGER I,409,17.6,358,63,295,oce
1622,22,dodododododododo,CHALLENGER I,406,20.5,1273,261,1012,oce
1623,23,Law of the few,CHALLENGER I,405,14.1,693,98,595,oce
1624,24,Seeyaa,CHALLENGER I,401,12.2,271,33,238,oce
1625,25,Kïng Tryndamere,CHALLENGER I,399,17.9,442,79,363,oce
1626,26,qp9,CHALLENGER I,398,15.0,366,55,311,oce
1627,27,jffhjjir,CHALLENGER I,396,21.8,216,47,169,oce
1628,28,smsqs,CHALLENGER I,395,22.9,323,74,249,oce
1629,29,Son Chae Young,CHALLENGER I,393,19.2,234,45,189,oce
1630,30,fengyingzhong,CHALLENGER I,389,24.8,125,31,94,oce
1631,31,oubo,CHALLENGER I,388,19.8,338,67,271,oce
1632,32,Chatskiiees,CHALLENGER I,386,17.8,534,95,439,oce
1633,33,MakinSomeBacon,CHALLENGER I,384,14.5,385,56,329,oce
1634,34,Dunk xiaolu,CHALLENGER I,383,16.6,470,78,392,oce
1635,35,Maxilees,CHALLENGER I,383,16.2,222,36,186,oce
1636,36,Fischball,CHALLENGER I,380,19.1,256,49,207,oce
1637,37,Escha,CHALLENGER I,369,13.8,624,86,538,oce
1638,38,m2att,CHALLENGER I,366,14.9,1032,154,878,oce
1639,39,zofou,CHALLENGER I,366,17.7,424,75,349,oce
1640,40,lloydeee,CHALLENGER I,365,20.8,366,76,290,oce
1641,41,sorryimlikethis,CHALLENGER I,359,23.6,288,68,220,oce
1642,42,WIld Sins Main,CHALLENGER I,357,15.4,331,51,280,oce
1643,43,Zacccccyou,CHALLENGER I,356,21.6,157,34,123,oce
1644,44,Heart1ess,CHALLENGER I,354,20.1,283,57,226,oce
1645,45,Jacky Xie,CHALLENGER I,353,22.5,404,91,313,oce
1646,46,heishelifu,CHALLENGER I,352,24.8,222,55,167,oce
1647,47,bingmoyan,CHALLENGER I,347,16.8,495,83,412,oce
1648,48,I Want You,CHALLENGER I,343,19.1,613,117,496,oce
1649,49,chinaLZH,CHALLENGER I,324,22.1,262,58,204,oce
1650,50,aksidhhdid,CHALLENGER I,231,16.1,570,92,478,oce
1651,51,samesame,"GRANDMASTER I
G",362,13.6,470,64,406,oce
1652,52,Last Wh1sper,"GRANDMASTER I
G",360,22.7,172,39,133,oce
1653,53,ccxxcc,"GRANDMASTER I
G",354,20.2,272,55,217,oce
1654,54,okhaige,"GRANDMASTER I
G",349,14.4,376,54,322,oce
1655,55,QWERXF,"GRANDMASTER I
G",347,20.5,381,78,303,oce
1656,56,vx1123913246,"GRANDMASTER I
G",339,15.9,565,90,475,oce
1657,57,3uphonium,"GRANDMASTER I
G",328,20.1,313,63,250,oce
1658,58,NayiGOJi,"GRANDMASTER I
G",316,19.0,290,55,235,oce
1659,59,BeaBear,"GRANDMASTER I
G",313,16.8,339,57,282,oce
1660,60,LongYu66,"GRANDMASTER I
G",308,17.9,362,65,297,oce
1661,61,Slayer Bo,"GRANDMASTER I
G",307,17.5,309,54,255,oce
1662,62,TonystarkIRON,"GRANDMASTER I
G",302,26.1,138,36,102,oce
1663,63,Jack Griffin,"GRANDMASTER I
G",301,14.0,308,43,265,oce
1664,64,aicmg11111,"GRANDMASTER I
G",298,26.0,127,33,94,oce
1665,65,Damon989,"GRANDMASTER I
G",290,19.1,199,38,161,oce
1666,66,HaSak1Wang,"GRANDMASTER I
G",286,17.9,168,30,138,oce
1667,67,Cyphos,"GRANDMASTER I
G",281,17.9,435,78,357,oce
1668,68,Moon1,"GRANDMASTER I
G",281,16.1,186,30,156,oce
1669,69,zhanglan1234,"GRANDMASTER I
G",278,13.4,328,44,284,oce
1670,70,zhangtao666,"GRANDMASTER I
G",276,22.6,168,38,130,oce
1671,71,ggds4y,"GRANDMASTER I
G",274,16.4,469,77,392,oce
1672,72,ItchyPenitis,"GRANDMASTER I
G",267,13.5,593,80,513,oce
1673,73,ihjkljg,"GRANDMASTER I
G",264,16.1,248,40,208,oce
1674,74,heizi22,"GRANDMASTER I
G",262,33.3,81,27,54,oce
1675,75,Cwute Panda,"GRANDMASTER I
G",260,16.2,499,81,418,oce
1676,76,ceeryees,"GRANDMASTER I
G",260,21.2,132,28,104,oce
1677,77,Just Mango,"GRANDMASTER I
G",252,20.9,339,71,268,oce
1678,78,WU YAN ZZU,"GRANDMASTER I
G",248,14.4,326,47,279,oce
1679,79,hemoumouya,"GRANDMASTER I
G",235,27.9,197,55,142,oce
1680,80,jieshao211,"GRANDMASTER I
G",234,17.7,209,37,172,oce
1681,81,PPAP,"GRANDMASTER I
G",233,13.9,367,51,316,oce
1682,82,chengzai,"GRANDMASTER I
G",229,13.9,294,41,253,oce
1683,83,TheExpIosiveTaco,"GRANDMASTER I
G",222,15.2,230,35,195,oce
1684,84,fanfanbaby,"GRANDMASTER I
G",217,25.2,139,35,104,oce
1685,85,Thi3ugia98,"GRANDMASTER I
G",214,15.3,359,55,304,oce
1686,86,CampBishop,"GRANDMASTER I
G",209,21.3,277,59,218,oce
1687,87,ssjfirzen,"GRANDMASTER I
G",208,12.0,1622,195,1427,oce
1688,88,overwater,"GRANDMASTER I
G",208,21.6,217,47,170,oce
1689,89,xiaocaibiiiii,"GRANDMASTER I
G",195,16.7,288,48,240,oce
1690,90,lovestarrysky,"GRANDMASTER I
G",193,16.7,545,91,454,oce
1691,91,Whìte,"GRANDMASTER I
G",190,16.4,736,121,615,oce
1692,92,GiveMeGunS,"GRANDMASTER I
G",189,14.9,281,42,239,oce
1693,93,Reborn Myth,"GRANDMASTER I
G",187,12.3,455,56,399,oce
1694,94,knlght999,"GRANDMASTER I
G",187,19.7,208,41,167,oce
1695,95,Rainbow Baby huh,"GRANDMASTER I
G",186,13.9,251,35,216,oce
1696,96,VNLunar,"GRANDMASTER I
G",184,14.2,386,55,331,oce
1697,97,CLMEpapa,"GRANDMASTER I
G",183,17.5,326,57,269,oce
1698,98,igjackluv,"GRANDMASTER I
G",181,29.9,134,40,94,oce
1699,99,Mo poisoness,"GRANDMASTER I
G",177,18.2,445,81,364,oce
1700,100,Yuki0720,"GRANDMASTER I
G",172,12.3,413,51,362,oce
1701,101,dxapple,"GRANDMASTER I
G",170,15.6,237,37,200,oce
1702,102,sanxingcaixukun,"GRANDMASTER I
G",169,13.2,807,107,700,oce
1703,103,free57,"GRANDMASTER I
G",169,31.5,111,35,76,oce
1704,104,Donaldin0,"GRANDMASTER I
G",165,14.7,484,71,413,oce
1705,105,hjhukbt,"GRANDMASTER I
G",163,17.5,411,72,339,oce
1706,106,Fallangle,"GRANDMASTER I
G",163,18.4,234,43,191,oce
1707,107,TooBreezy,"GRANDMASTER I
G",161,13.5,222,30,192,oce
1708,108,orymdzz,"GRANDMASTER I
G",160,17.3,306,53,253,oce
1709,109,TheRealDirtyDan,"GRANDMASTER I
G",160,10.3,493,51,442,oce
1710,110,yundingle,"GRANDMASTER I
G",159,21.6,194,42,152,oce
1711,111,Bma,"GRANDMASTER I
G",159,16.0,231,37,194,oce
1712,112,Maraudaur,"GRANDMASTER I
G",151,15.9,564,90,474,oce
1713,113,abcd123456789,"GRANDMASTER I
G",151,19.6,189,37,152,oce
1714,114,xinya45,"GRANDMASTER I
G",148,18.7,459,86,373,oce
1715,115,Mounty,"GRANDMASTER I
G",148,12.3,586,72,514,oce
1716,116,weigaosheng,"GRANDMASTER I
G",146,13.2,469,62,407,oce
1717,117,Member,"GRANDMASTER I
G",145,15.3,262,40,222,oce
1718,118,Lethal Zedstarr,"GRANDMASTER I
G",144,11.4,501,57,444,oce
1719,119,firstmen,"GRANDMASTER I
G",140,16.1,335,54,281,oce
1720,120,why zyh and pipi,"GRANDMASTER I
G",140,14.2,295,42,253,oce
1721,121,jiushishen,"GRANDMASTER I
G",140,19.8,182,36,146,oce
1722,122,DegenRolling,"GRANDMASTER I
G",139,32.5,77,25,52,oce
1723,123,Haober,"GRANDMASTER I
G",135,24.7,174,43,131,oce
1724,124,Umi,"GRANDMASTER I
G",135,15.4,182,28,154,oce
1725,125,xiaozhiZP,"GRANDMASTER I
G",132,17.1,504,86,418,oce
1726,126,YILINHHH,"GRANDMASTER I
G",132,15.5,446,69,377,oce
1727,127,CLUBCANTHANDLEME,"GRANDMASTER I
G",132,16.4,335,55,280,oce
1728,128,RedHawk101,"GRANDMASTER I
G",129,21.5,381,82,299,oce
1729,129,Petra,"GRANDMASTER I
G",126,23.9,159,38,121,oce
1730,130,xg1998,"GRANDMASTER I
G",126,16.5,224,37,187,oce
1731,131,DonAlternate,"GRANDMASTER I
G",125,20.1,348,70,278,oce
1732,132,roflwhatever,"GRANDMASTER I
G",124,20.1,219,44,175,oce
1733,133,qkkaannuu,"GRANDMASTER I
G",120,13.7,430,59,371,oce
1734,134,Dankk,"GRANDMASTER I
G",119,16.5,243,40,203,oce
1735,135,YUKINO013,"GRANDMASTER I
G",118,14.1,348,49,299,oce
1736,136,Another3,"GRANDMASTER I
G",117,14.4,416,60,356,oce
1737,137,SeaBoss,"GRANDMASTER I
G",117,14.0,399,56,343,oce
1738,138,dilisiad,"GRANDMASTER I
G",117,23.3,176,41,135,oce
1739,139,amazingccc,"GRANDMASTER I
G",116,19.5,159,31,128,oce
1740,140,SilencedbymySins,"GRANDMASTER I
G",115,17.7,147,26,121,oce
1741,141,821,"GRANDMASTER I
G",114,14.8,358,53,305,oce
1742,142,wggrggt,"GRANDMASTER I
G",114,21.9,137,30,107,oce
1743,143,Fwuffy Panda,"GRANDMASTER I
G",113,23.4,201,47,154,oce
1744,144,WayneToDieeeeeee,"GRANDMASTER I
G",111,27.2,162,44,118,oce
1745,145,01 04 1999,"GRANDMASTER I
G",111,20.3,202,41,161,oce
1746,146,Heart Doinb,"GRANDMASTER I
G",108,26.8,190,51,139,oce
1747,147,dnn,"GRANDMASTER I
G",107,17.4,593,103,490,oce
1748,148,3sansansan,"GRANDMASTER I
G",96,18.9,488,92,396,oce
1749,149,Kris Wu,"GRANDMASTER I
G",95,16.2,339,55,284,oce
1750,150,HanDaY,MASTER I,139,18.0,344,62,282,oce
1751,151,fyiiiiii,MASTER I,137,15.3,477,73,404,oce
1752,152,DrEzreal,MASTER I,130,17.8,321,57,264,oce
1753,153,Focus More,MASTER I,111,35.7,84,30,54,oce
1754,154,ROKA1713,MASTER I,108,15.8,729,115,614,oce
1755,155,summon3r003,MASTER I,108,16.1,273,44,229,oce
1756,156,hourunm,MASTER I,104,23.4,205,48,157,oce
1757,157,huozhigaoxin,MASTER I,102,16.8,238,40,198,oce
1758,158,ding1978,MASTER I,101,16.5,243,40,203,oce
1759,159,doindog1,MASTER I,98,20.5,293,60,233,oce
1760,160,Dwyan3 Wade,MASTER I,97,14.8,431,64,367,oce
1761,161,zhuweiran,MASTER I,96,15.9,453,72,381,oce
1762,162,100DJ CaiXuKun,MASTER I,96,19.4,129,25,104,oce
1763,163,Jenni A,MASTER I,95,10.8,510,55,455,oce
1764,164,PVC Cai,MASTER I,95,11.7,420,49,371,oce
1765,165,emmmmmmmm,MASTER I,94,17.3,150,26,124,oce
1766,166,kuaileyouxi,MASTER I,92,23.4,167,39,128,oce
1767,167,Whisper9897,MASTER I,92,16.1,143,23,120,oce
1768,168,2CBeast,MASTER I,91,11.5,295,34,261,oce
1769,169,manpede,MASTER I,91,16.9,118,20,98,oce
1770,170,Letme11,MASTER I,89,14.6,329,48,281,oce
1771,171,kaiwen521,MASTER I,88,21.1,109,23,86,oce
1772,172,111iidj,MASTER I,87,21.3,108,23,85,oce
1773,173,peanut1999,MASTER I,87,16.5,139,23,116,oce
1774,174,KeyaTFT,MASTER I,86,25.2,139,35,104,oce
1775,175,sorrybro,MASTER I,81,21.2,113,24,89,oce
1776,176,guguguy,MASTER I,75,22.6,106,24,82,oce
1777,177,CaptainMara,MASTER I,74,13.4,261,35,226,oce
1778,178,lizhengxiong,MASTER I,73,22.0,100,22,78,oce
1779,179,Laotie Letsgo,MASTER I,72,23.7,156,37,119,oce
1780,180,Jukelord,MASTER I,70,14.1,327,46,281,oce
1781,181,LiSTang,MASTER I,69,15.2,448,68,380,oce
1782,182,xianqishenjiangl,MASTER I,69,17.2,366,63,303,oce
1783,183,Zhiend,MASTER I,68,25.1,215,54,161,oce
1784,184,IGIGIGIGIGIGIGIG,MASTER I,67,17.4,298,52,246,oce
1785,185,rlekfufk,MASTER I,65,12.6,478,60,418,oce
1786,186,TFTMobile Player,MASTER I,65,22.2,126,28,98,oce
1787,187,kickhansass,MASTER I,64,12.3,236,29,207,oce
1788,188,Jenry,MASTER I,64,13.2,190,25,165,oce
1789,189,JH99,MASTER I,62,22.6,186,42,144,oce
1790,190,aa1816,MASTER I,61,16.4,323,53,270,oce
1791,191,AWAYmili,MASTER I,61,17.7,277,49,228,oce
1792,192,tangyuan233,MASTER I,61,16.1,174,28,146,oce
1793,193,biegandongwo,MASTER I,58,15.9,339,54,285,oce
1794,194,xiaobai12131,MASTER I,58,20.0,140,28,112,oce
1795,195,VainF,MASTER I,57,14.4,319,46,273,oce
1796,196,zhuodaye,MASTER I,56,16.6,404,67,337,oce
1797,197,IllIIIll,MASTER I,55,15.9,151,24,127,oce
1798,198,edgnb2020,MASTER I,54,14.0,428,60,368,oce
1799,199,ale190190,MASTER I,54,21.8,170,37,133,oce
1800,200,dashufangkaiwo,MASTER I,54,10.0,209,21,188,oce
1801,1,Rubic,CHALLENGER I,1622,26.6,673,179,494,tr
1802,2,kinqmusti43,CHALLENGER I,1326,25.2,582,147,435,tr
1803,3,speedruzlol,CHALLENGER I,1120,24.6,448,110,338,tr
1804,4,MAD JOSEPH 2,CHALLENGER I,966,23.5,327,77,250,tr
1805,5,Benedetto,CHALLENGER I,947,22.1,349,77,272,tr
1806,6,Ayenbe,CHALLENGER I,904,26.8,269,72,197,tr
1807,7,MAD JOSEPH,CHALLENGER I,765,19.4,717,139,578,tr
1808,8,Stay ruthless,CHALLENGER I,688,27.7,788,218,570,tr
1809,9,Jok3r xx,CHALLENGER I,590,22.1,308,68,240,tr
1810,10,Perceid TFT,CHALLENGER I,561,26.5,162,43,119,tr
1811,11,keLch,CHALLENGER I,556,22.2,365,81,284,tr
1812,12,Jenerik,CHALLENGER I,541,22.7,260,59,201,tr
1813,13,GreatEagle,CHALLENGER I,515,19.0,395,75,320,tr
1814,14,bestâ,CHALLENGER I,507,21.2,381,81,300,tr
1815,15,Liquidzer,CHALLENGER I,486,18.2,455,83,372,tr
1816,16,Skinner27,CHALLENGER I,476,23.0,152,35,117,tr
1817,17,Nîtratex,CHALLENGER I,463,10.9,413,45,368,tr
1818,18,Waiden,CHALLENGER I,450,18.3,834,153,681,tr
1819,19,Jonas Salk,CHALLENGER I,446,11.8,603,71,532,tr
1820,20,ŁuciâN,CHALLENGER I,439,14.2,353,50,303,tr
1821,21,NİZİPLİİİ,CHALLENGER I,436,21.6,910,197,713,tr
1822,22,Morte D Amour,CHALLENGER I,436,16.5,653,108,545,tr
1823,23,TFT Colorâblê,CHALLENGER I,428,17.1,216,37,179,tr
1824,24,StahpItRito v2,CHALLENGER I,427,22.6,181,41,140,tr
1825,25,TFT Colorâblê v2,CHALLENGER I,422,15.2,236,36,200,tr
1826,26,lAdastra,CHALLENGER I,419,19.8,550,109,441,tr
1827,27,jan uma,CHALLENGER I,414,21.9,256,56,200,tr
1828,28,MAC MASCARA,CHALLENGER I,412,14.8,602,89,513,tr
1829,29,11 04 2004,CHALLENGER I,412,14.8,520,77,443,tr
1830,30,Shinzu,CHALLENGER I,407,10.5,513,54,459,tr
1831,31,NEXTENAAA,CHALLENGER I,407,18.7,262,49,213,tr
1832,32,SunChos,CHALLENGER I,394,14.9,988,147,841,tr
1833,33,FeelingTheBlanks,CHALLENGER I,393,11.9,480,57,423,tr
1834,34,Troll Bir Nick,CHALLENGER I,385,19.1,878,168,710,tr
1835,35,MUHENDİSBEY TFT,CHALLENGER I,385,17.1,414,71,343,tr
1836,36,Daldım Kazdım,CHALLENGER I,385,22.5,293,66,227,tr
1837,37,Slay,CHALLENGER I,385,21.1,251,53,198,tr
1838,38,Tasty,CHALLENGER I,381,19.0,189,36,153,tr
1839,39,valiumx,CHALLENGER I,374,12.3,978,120,858,tr
1840,40,ForyuS,CHALLENGER I,372,11.0,978,108,870,tr
1841,41,Discronatia,CHALLENGER I,372,16.8,328,55,273,tr
1842,42,THE BOSS PALA,CHALLENGER I,372,13.7,364,50,314,tr
1843,43,Furriya,CHALLENGER I,365,18.1,265,48,217,tr
1844,44,Seyfi Baba QQ,CHALLENGER I,363,18.1,663,120,543,tr
1845,45,zikerr,CHALLENGER I,361,14.8,526,78,448,tr
1846,46,Hyperr roll babe,CHALLENGER I,360,21.2,132,28,104,tr
1847,47,mettuzwee,CHALLENGER I,359,25.4,185,47,138,tr
1848,48,ƒallenGod,CHALLENGER I,346,20.5,317,65,252,tr
1849,49,SİVASLI PONÇİK,CHALLENGER I,343,15.9,340,54,286,tr
1850,50,sefaFluxx,CHALLENGER I,250,19.0,1006,191,815,tr
1851,51,KR Challenger1,"GRANDMASTER I
G",369,30.6,121,37,84,tr
1852,52,TFT Ołrïc,"GRANDMASTER I
G",346,14.2,247,35,212,tr
1853,53,JuJuFiFi,"GRANDMASTER I
G",307,13.9,404,56,348,tr
1854,54,StahpItRito,"GRANDMASTER I
G",293,25.1,195,49,146,tr
1855,55,Top 8,"GRANDMASTER I
G",286,24.6,268,66,202,tr
1856,56,BrushLeee,"GRANDMASTER I
G",283,15.5,219,34,185,tr
1857,57,ÇopurBey,"GRANDMASTER I
G",277,12.1,919,111,808,tr
1858,58,9x37,"GRANDMASTER I
G",275,14.7,620,91,529,tr
1859,59,Darksword02,"GRANDMASTER I
G",270,16.1,805,130,675,tr
1860,60,canadianturkey,"GRANDMASTER I
G",269,25.6,180,46,134,tr
1861,61,ÇokTaRinTinTinV2,"GRANDMASTER I
G",256,18.6,429,80,349,tr
1862,62,WhackyLuck,"GRANDMASTER I
G",242,16.4,511,84,427,tr
1863,63,asvpxtitan,"GRANDMASTER I
G",238,13.9,721,100,621,tr
1864,64,w0lverinee,"GRANDMASTER I
G",235,15.8,1119,177,942,tr
1865,65,No Life Ceset,"GRANDMASTER I
G",221,17.7,729,129,600,tr
1866,66,TEOİSTİK,"GRANDMASTER I
G",212,13.3,338,45,293,tr
1867,67,Phoebe,"GRANDMASTER I
G",204,18.8,416,78,338,tr
1868,68,caglar128,"GRANDMASTER I
G",195,13.0,238,31,207,tr
1869,69,play for a fun,"GRANDMASTER I
G",193,18.6,252,47,205,tr
1870,70,bunupthedance,"GRANDMASTER I
G",191,33.3,102,34,68,tr
1871,71,Mavix,"GRANDMASTER I
G",190,19.6,179,35,144,tr
1872,72,Spanker HS,"GRANDMASTER I
G",188,20.1,567,114,453,tr
1873,73,Luca Toni,"GRANDMASTER I
G",188,16.7,246,41,205,tr
1874,74,Kral Leonidass,"GRANDMASTER I
G",187,14.2,846,120,726,tr
1875,75,Motosho,"GRANDMASTER I
G",181,20.6,253,52,201,tr
1876,76,The lazy Phil,"GRANDMASTER I
G",177,17.7,198,35,163,tr
1877,77,Kara Sevdalım,"GRANDMASTER I
G",171,19.1,712,136,576,tr
1878,78,OgUzhan22,"GRANDMASTER I
G",166,14.2,710,101,609,tr
1879,79,Meglendiel,"GRANDMASTER I
G",164,17.0,716,122,594,tr
1880,80,TheBigWal,"GRANDMASTER I
G",153,12.6,230,29,201,tr
1881,81,ŹéÐáñìêłš,"GRANDMASTER I
G",152,13.4,687,92,595,tr
1882,82,Xaviertz,"GRANDMASTER I
G",151,17.4,408,71,337,tr
1883,83,Sinjeog Jonjae,"GRANDMASTER I
G",147,21.5,237,51,186,tr
1884,84,Berke İnan,"GRANDMASTER I
G",142,16.4,274,45,229,tr
1885,85,Bir Spartalı,"GRANDMASTER I
G",138,17.3,272,47,225,tr
1886,86,My0neSS,"GRANDMASTER I
G",137,17.5,867,152,715,tr
1887,87,clssJaGG,"GRANDMASTER I
G",131,15.2,738,112,626,tr
1888,88,ATC Bulbasaur,"GRANDMASTER I
G",131,16.9,266,45,221,tr
1889,89,ll Mr Yılmâz TFT,"GRANDMASTER I
G",129,15.8,429,68,361,tr
1890,90,BeeepbeepimaJeep,"GRANDMASTER I
G",127,15.6,218,34,184,tr
1891,91,Sayonara Baby,"GRANDMASTER I
G",125,11.8,908,107,801,tr
1892,92,Akaki Akakiyeviç,"GRANDMASTER I
G",123,13.1,406,53,353,tr
1893,93,DT Escanor,"GRANDMASTER I
G",122,15.3,261,40,221,tr
1894,94,Jâsper,"GRANDMASTER I
G",118,18.0,183,33,150,tr
1895,95,ReachijaX,"GRANDMASTER I
G",115,13.2,833,110,723,tr
1896,96,Riven İs Mine,"GRANDMASTER I
G",109,18.1,276,50,226,tr
1897,97,Boxerli Arap,"GRANDMASTER I
G",108,23.2,284,66,218,tr
1898,98,Rapscallion FK,"GRANDMASTER I
G",105,21.5,554,119,435,tr
1899,99,Ragyo,"GRANDMASTER I
G",104,17.2,835,144,691,tr
1900,100,Plug,"GRANDMASTER I
G",102,16.6,386,64,322,tr
1901,101,qR Kai Hiwatari,"GRANDMASTER I
G",101,11.0,346,38,308,tr
1902,102,Sağtık CEBO,"GRANDMASTER I
G",100,11.3,461,52,409,tr
1903,103,SUQ MADİK,"GRANDMASTER I
G",94,18.5,249,46,203,tr
1904,104,THEPRAT,"GRANDMASTER I
G",87,11.9,404,48,356,tr
1905,105,MrDdad,"GRANDMASTER I
G",86,20.1,377,76,301,tr
1906,106,EazyPz,"GRANDMASTER I
G",84,22.3,309,69,240,tr
1907,107,ImCurly,"GRANDMASTER I
G",77,16.5,643,106,537,tr
1908,108,Prenses Irelia,"GRANDMASTER I
G",75,13.8,570,79,491,tr
1909,109,Itachi Uchiha,"GRANDMASTER I
G",69,12.1,720,87,633,tr
1910,110,mFatality,"GRANDMASTER I
G",69,12.7,545,69,476,tr
1911,111,turkuazv2,"GRANDMASTER I
G",65,18.6,291,54,237,tr
1912,112,Dr Manhattan,"GRANDMASTER I
G",65,21.0,248,52,196,tr
1913,113,SuBA x,"GRANDMASTER I
G",64,5.4,736,40,696,tr
1914,114,Durp,"GRANDMASTER I
G",62,18.8,165,31,134,tr
1915,115,TFT CEBO,"GRANDMASTER I
G",61,14.2,162,23,139,tr
1916,116,AshleyG,"GRANDMASTER I
G",60,12.5,576,72,504,tr
1917,117,Apo sen misin la,"GRANDMASTER I
G",58,17.2,332,57,275,tr
1918,118,ExeSus v1,"GRANDMASTER I
G",56,14.3,727,104,623,tr
1919,119,Ruheass,"GRANDMASTER I
G",56,17.9,448,80,368,tr
1920,120,ÃŁÞhÃ,"GRANDMASTER I
G",53,20.7,208,43,165,tr
1921,121,Qyrieq,"GRANDMASTER I
G",52,8.9,246,22,224,tr
1922,122,slowly sari,"GRANDMASTER I
G",50,17.6,301,53,248,tr
1923,123,Coria,"GRANDMASTER I
G",49,14.9,375,56,319,tr
1924,124,KimbuLeyla,"GRANDMASTER I
G",49,16.8,149,25,124,tr
1925,125,Nerva,"GRANDMASTER I
G",48,13.9,216,30,186,tr
1926,126,Reis Back,"GRANDMASTER I
G",47,12.3,341,42,299,tr
1927,127,SSW,"GRANDMASTER I
G",45,13.6,1192,162,1030,tr
1928,128,Rykes,"GRANDMASTER I
G",45,17.0,265,45,220,tr
1929,129,BEN THRESH NABER,"GRANDMASTER I
G",45,13.4,224,30,194,tr
1930,130,itsAƒucknComedy,"GRANDMASTER I
G",44,15.3,267,41,226,tr
1931,131,Boşver,"GRANDMASTER I
G",42,17.6,487,86,401,tr
1932,132,diwine fish,"GRANDMASTER I
G",40,20.6,165,34,131,tr
1933,133,xlProDRoMaLlx,"GRANDMASTER I
G",39,15.8,228,36,192,tr
1934,134,Plug v2,"GRANDMASTER I
G",37,20.8,159,33,126,tr
1935,135,Terryfold,"GRANDMASTER I
G",36,24.6,118,29,89,tr
1936,136,MhRayleiphosor,"GRANDMASTER I
G",34,20.8,298,62,236,tr
1937,137,ÜSTADIM,"GRANDMASTER I
G",34,12.0,284,34,250,tr
1938,138,CacaReyiz1907,"GRANDMASTER I
G",32,13.1,726,95,631,tr
1939,139,Pepee16,"GRANDMASTER I
G",30,13.8,866,120,746,tr
1940,140,TR Ryzê,"GRANDMASTER I
G",30,15.5,381,59,322,tr
1941,141,IamSonGoku,"GRANDMASTER I
G",27,13.8,486,67,419,tr
1942,142,bigballsman,"GRANDMASTER I
G",27,32.5,86,28,58,tr
1943,143,PrequaL,"GRANDMASTER I
G",25,16.0,642,103,539,tr
1944,144,LA ShootingGuard,"GRANDMASTER I
G",13,16.4,280,46,234,tr
1945,145,N0NNstar,"GRANDMASTER I
G",5,16.7,444,74,370,tr
1946,146,Mutsuz,"GRANDMASTER I
G",1,14.2,204,29,175,tr
1947,147,Şürkü,"GRANDMASTER I
G",0,14.6,639,93,546,tr
1948,148,Usta Splinterr,"GRANDMASTER I
G",0,13.5,229,31,198,tr
1949,149,Punaise,MASTER I,225,12.3,1210,149,1061,tr
1950,150,SauirasSalviaa,MASTER I,76,13.1,1010,132,878,tr
1951,151,Gj MRX,MASTER I,72,10.2,225,23,202,tr
1952,152,MertColak,MASTER I,55,26.9,238,64,174,tr
1953,153,Speraktif v2,MASTER I,54,20.2,168,34,134,tr
1954,154,Marijuaña,MASTER I,53,11.8,883,104,779,tr
1955,155,mustafa1t,MASTER I,51,9.9,658,65,593,tr
1956,156,AcviLion,MASTER I,48,16.5,454,75,379,tr
1957,157,TEKSİN,MASTER I,48,15.8,454,72,382,tr
1958,158,Party,MASTER I,46,12.9,348,45,303,tr
1959,159,HAMDIDMRTS TFT,MASTER I,41,16.7,527,88,439,tr
1960,160,ChosenKilMe,MASTER I,40,23.3,90,21,69,tr
1961,161,PARA,MASTER I,38,17.2,232,40,192,tr
1962,162,Seyfi Baba QQ v2,MASTER I,38,33.3,78,26,52,tr
1963,163,ISGT PeaceI,MASTER I,35,14.5,152,22,130,tr
1964,164,aslndagg,MASTER I,33,14.5,228,33,195,tr
1965,165,Perceid,MASTER I,32,18.3,498,91,407,tr
1966,166,Electus1,MASTER I,31,20.5,512,105,407,tr
1967,167,Basden,MASTER I,31,18.2,455,83,372,tr
1968,168,Ağlak Kebir,MASTER I,26,14.6,226,33,193,tr
1969,169,İqos,MASTER I,25,21.4,322,69,253,tr
1970,170,sabonohiken,MASTER I,25,16.7,126,21,105,tr
1971,171,Gannicius,MASTER I,24,19.8,323,64,259,tr
1972,172,Mriays,MASTER I,22,17.3,214,37,177,tr
1973,173,Maegi,MASTER I,20,17.1,351,60,291,tr
1974,174,Useless Shaco,MASTER I,19,15.3,567,87,480,tr
1975,175,UnknownZ7,MASTER I,17,16.7,203,34,169,tr
1976,176,p a c i ennN,MASTER I,17,13.1,245,32,213,tr
1977,177,ArcHaic,MASTER I,16,18.6,231,43,188,tr
1978,178,artyomdh,MASTER I,16,19.9,136,27,109,tr
1979,179,Beramusluu TFT,MASTER I,15,15.2,475,72,403,tr
1980,180,KÓÐ ÃÐI ŻÉÐ,MASTER I,15,16.5,339,56,283,tr
1981,181,Night Train,MASTER I,14,14.7,544,80,464,tr
1982,182,BABALARIN AHMET,MASTER I,14,13.8,470,65,405,tr
1983,183,RÂKI FİZZ,MASTER I,11,10.9,995,109,886,tr
1984,184,WL Poew,MASTER I,11,18.6,199,37,162,tr
1985,185,Necessarium,MASTER I,11,13.9,237,33,204,tr
1986,186,Rayzet,MASTER I,11,18.4,174,32,142,tr
1987,187,The Ârt of Zed,MASTER I,11,18.8,165,31,134,tr
1988,188,SirSirius,MASTER I,9,25.8,97,25,72,tr
1989,189,Srcnym,MASTER I,8,18.2,285,52,233,tr
1990,190,LeqacyOfKaiN,MASTER I,8,14.5,331,48,283,tr
1991,191,Swarles Barkley,MASTER I,7,27.7,101,28,73,tr
1992,192,UMP,MASTER I,6,23.5,204,48,156,tr
1993,193,Alanyalı Efe,MASTER I,6,25.5,157,40,117,tr
1994,194,SCARFÆCE,MASTER I,6,16.1,205,33,172,tr
1995,195,elyêl,MASTER I,5,22.0,499,110,389,tr
1996,196,TFT Hasslet,MASTER I,5,15.0,334,50,284,tr
1997,197,Simurg TFT,MASTER I,5,21.6,162,35,127,tr
1998,198,Oscar Bey,MASTER I,5,10.0,310,31,279,tr
1999,199,JB Cloudy,MASTER I,4,13.7,701,96,605,tr
2000,200,YılanYapKendini,MASTER I,4,10.3,670,69,601,tr
2001,1,KroniiinepTFT,CHALLENGER I,1011,27.9,365,102,263,ru
2002,2,Nycteus,CHALLENGER I,827,23.8,227,54,173,ru
2003,3,HORNIE MY BABY,CHALLENGER I,824,33.3,267,89,178,ru
2004,4,superworldRU,CHALLENGER I,804,20.1,417,84,333,ru
2005,5,chmochma,CHALLENGER I,770,23.4,364,85,279,ru
2006,6,kobeyang,CHALLENGER I,740,29.3,607,178,429,ru
2007,7,aLeProfane,CHALLENGER I,736,25.9,440,114,326,ru
2008,8,Dyachello,CHALLENGER I,660,20.4,402,82,320,ru
2009,9,LMS trojancbkui,CHALLENGER I,538,14.7,593,87,506,ru
2010,10,WuHan jiayou,CHALLENGER I,523,27.5,229,63,166,ru
2011,11,Theblueboy,CHALLENGER I,424,29.7,219,65,154,ru
2012,12,МRAZIverniteNICK,CHALLENGER I,396,26.2,358,94,264,ru
2013,13,Bingo123456,CHALLENGER I,396,17.6,433,76,357,ru
2014,14,kiiller,CHALLENGER I,395,18.6,215,40,175,ru
2015,15,Yablo4niy,CHALLENGER I,377,24.6,191,47,144,ru
2016,16,KENGBI,CHALLENGER I,324,20.6,515,106,409,ru
2017,17,L9 Rengy,CHALLENGER I,324,17.5,543,95,448,ru
2018,18,CNGOOD,CHALLENGER I,317,24.9,261,65,196,ru
2019,19,DrKaktys,CHALLENGER I,317,17.8,202,36,166,ru
2020,20,Hardrinnz,CHALLENGER I,315,30.1,153,46,107,ru
2021,21,Zauberbiest,CHALLENGER I,289,18.1,271,49,222,ru
2022,22,NMЯ NO ИМЯ,CHALLENGER I,240,20.1,319,64,255,ru
2023,23,Тяньци,CHALLENGER I,239,21.5,191,41,150,ru
2024,24,JoSmog,CHALLENGER I,229,16.0,620,99,521,ru
2025,25,e 1,CHALLENGER I,224,17.8,360,64,296,ru
2026,26,NeverTrustSoloQ,CHALLENGER I,216,24.4,213,52,161,ru
2027,27,Авиатор Платонов,CHALLENGER I,214,24.9,341,85,256,ru
2028,28,Không Có Link,CHALLENGER I,206,17.5,600,105,495,ru
2029,29,DespicabIe,CHALLENGER I,198,25.1,334,84,250,ru
2030,30,Arclight Panda,CHALLENGER I,196,18.8,398,75,323,ru
2031,31,Светофорчик,CHALLENGER I,196,26.4,250,66,184,ru
2032,32,HMTuanRu,CHALLENGER I,192,20.8,394,82,312,ru
2033,33,Mark of uroboros,CHALLENGER I,189,21.9,970,212,758,ru
2034,34,Sacred Nоrris,CHALLENGER I,186,14.1,1371,193,1178,ru
2035,35,Iggi 1TrickPferd,CHALLENGER I,169,27.4,175,48,127,ru
2036,36,NikeIII,CHALLENGER I,162,29.2,188,55,133,ru
2037,37,FIMA,CHALLENGER I,162,21.5,251,54,197,ru
2038,38,Arcade bÔÔbs,CHALLENGER I,159,20.2,554,112,442,ru
2039,39,ENDEAVOUR,CHALLENGER I,156,18.6,307,57,250,ru
2040,40,Юрa,CHALLENGER I,148,15.0,227,34,193,ru
2041,41,Legenda of LOL,CHALLENGER I,145,13.2,340,45,295,ru
2042,42,Кисюня,CHALLENGER I,143,26.4,125,33,92,ru
2043,43,LРL,CHALLENGER I,142,14.7,1174,172,1002,ru
2044,44,ruComix,CHALLENGER I,140,23.6,220,52,168,ru
2045,45,bingo666fly,CHALLENGER I,134,22.4,214,48,166,ru
2046,46,Kapibaro,CHALLENGER I,125,23.5,345,81,264,ru
2047,47,hornie,CHALLENGER I,125,27.0,148,40,108,ru
2048,48,Anurion89,CHALLENGER I,121,19.2,334,64,270,ru
2049,49,Paprika,CHALLENGER I,61,20.1,179,36,143,ru
2050,50,Youbanyouto,CHALLENGER I,52,18.2,247,45,202,ru
2051,51,Cоming Down,"GRANDMASTER I
G",183,17.7,232,41,191,ru
2052,52,Sapfer,"GRANDMASTER I
G",174,16.7,545,91,454,ru
2053,53,Жабка Лиска,"GRANDMASTER I
G",136,24.2,306,74,232,ru
2054,54,Long live China,"GRANDMASTER I
G",120,18.1,276,50,226,ru
2055,55,Rukashi,"GRANDMASTER I
G",110,31.6,114,36,78,ru
2056,56,fantik999,"GRANDMASTER I
G",98,15.8,183,29,154,ru
2057,57,VN Troll,"GRANDMASTER I
G",96,9.4,753,71,682,ru
2058,58,Kalabaka,"GRANDMASTER I
G",90,27.7,909,252,657,ru
2059,59,Shinkulirion,"GRANDMASTER I
G",87,22.1,385,85,300,ru
2060,60,NikolayDjan,"GRANDMASTER I
G",58,18.5,464,86,378,ru
2061,61,BEASTMXDE,"GRANDMASTER I
G",53,17.9,391,70,321,ru
2062,62,The Inspired One,"GRANDMASTER I
G",47,19.9,151,30,121,ru
2063,63,PeiPei,"GRANDMASTER I
G",43,12.9,481,62,419,ru
2064,64,lza,"GRANDMASTER I
G",42,20.7,208,43,165,ru
2065,65,lywh,"GRANDMASTER I
G",40,13.2,129,17,112,ru
2066,66,Tâm Luct,"GRANDMASTER I
G",36,17.0,247,42,205,ru
2067,67,CapsuleZZZ,"GRANDMASTER I
G",35,16.7,233,39,194,ru
2068,68,LegendsNeverDIE0,"GRANDMASTER I
G",33,23.3,279,65,214,ru
2069,69,TG Rot Stillness,"GRANDMASTER I
G",32,11.4,430,49,381,ru
2070,70,ZiGZaG08,"GRANDMASTER I
G",32,16.4,262,43,219,ru
2071,71,BomBibomXD,"GRANDMASTER I
G",28,12.7,536,68,468,ru
2072,72,Ignotas,"GRANDMASTER I
G",25,21.2,151,32,119,ru
2073,73,Ksorn,"GRANDMASTER I
G",23,12.7,213,27,186,ru
2074,74,Th3Gambl3r,"GRANDMASTER I
G",22,19.1,617,118,499,ru
2075,75,NickDeko,"GRANDMASTER I
G",21,18.9,424,80,344,ru
2076,76,K R I P S I,"GRANDMASTER I
G",21,23.9,272,65,207,ru
2077,77,СерёгаСПб,"GRANDMASTER I
G",16,18.8,463,87,376,ru
2078,78,Sebastian7,"GRANDMASTER I
G",16,21.7,253,55,198,ru
2079,79,Morozilkin,"GRANDMASTER I
G",16,22.2,225,50,175,ru
2080,80,Леди Меламори,"GRANDMASTER I
G",16,14.7,211,31,180,ru
2081,81,Silent Sona,"GRANDMASTER I
G",15,19.8,409,81,328,ru
2082,82,ASREN,"GRANDMASTER I
G",14,18.7,155,29,126,ru
2083,83,Kahzoo is KING,"GRANDMASTER I
G",12,32.4,105,34,71,ru
2084,84,royál beggar,"GRANDMASTER I
G",11,20.1,159,32,127,ru
2085,85,BrotherFrank,"GRANDMASTER I
G",10,27.1,129,35,94,ru
2086,86,Hen predator,"GRANDMASTER I
G",5,19.7,340,67,273,ru
2087,87,Remilia Scarlet,"GRANDMASTER I
G",5,22.0,214,47,167,ru
2088,88,AlloC,"GRANDMASTER I
G",3,21.1,199,42,157,ru
2089,89,ropo4ka,"GRANDMASTER I
G",0,17.6,449,79,370,ru
2090,90,Hand off 3,"GRANDMASTER I
G",0,20.5,336,69,267,ru
2091,91,ПаГа,"GRANDMASTER I
G",0,13.6,462,63,399,ru
2092,92,Ветра Севера,"GRANDMASTER I
G",0,9.0,566,51,515,ru
2093,93,zhangqiling,"GRANDMASTER I
G",0,16.9,289,49,240,ru
2094,94,Генерал Docta,"GRANDMASTER I
G",0,29.3,157,46,111,ru
2095,95,CK Guard,"GRANDMASTER I
G",0,24.6,187,46,141,ru
2096,96,CuPofCrAcK,"GRANDMASTER I
G",0,11.0,401,44,357,ru
2097,97,Hail of Blades,"GRANDMASTER I
G",0,24.1,170,41,129,ru
2098,98,Programmer,"GRANDMASTER I
G",0,16.1,224,36,188,ru
2099,99,Jaguar,"GRANDMASTER I
G",0,12.6,277,35,242,ru
2100,100,Killl Lov3,"GRANDMASTER I
G",0,23.8,122,29,93,ru
2101,101,Torianos,MASTER I,125,12.2,633,77,556,ru
2102,102,AeCorah,MASTER I,109,25.1,672,169,503,ru
2103,103,ЗабулдыгаНовичёк,MASTER I,80,10.9,1325,145,1180,ru
2104,104,CNGOOD1,MASTER I,53,20.1,278,56,222,ru
2105,105,Napyyyy,MASTER I,25,14.6,384,56,328,ru
2106,106,mTxFaT,MASTER I,14,18.4,910,167,743,ru
2107,107,Sоul Reaver,MASTER I,14,21.1,185,39,146,ru
2108,108,nlinhsv21,MASTER I,14,19.4,196,38,158,ru
2109,109,Крушитель001,MASTER I,6,19.5,374,73,301,ru
2110,110,Малолетка,MASTER I,4,32.9,79,26,53,ru
2111,111,Disnaix Kh,DIAMOND I,97,20.2,337,68,269,ru
2112,112,Воруй94,DIAMOND I,86,26.2,141,37,104,ru
2113,113,thanh169,DIAMOND I,75,22.8,552,126,426,ru
2114,114,TOMSK7777,DIAMOND I,75,23.1,399,92,307,ru
2115,115,ChinaNirvana,DIAMOND I,75,22.3,399,89,310,ru
2116,116,Крада,DIAMOND I,75,12.8,602,77,525,ru
2117,117,TFT tsm,DIAMOND I,75,16.2,431,70,361,ru
2118,118,EmperorCHN,DIAMOND I,75,25.4,264,67,197,ru
2119,119,SUSUWE,DIAMOND I,75,17.0,383,65,318,ru
2120,120,inspekt0r,DIAMOND I,75,18.3,350,64,286,ru
2121,121,ìnsane,DIAMOND I,75,20.3,300,61,239,ru
2122,122,Eldrax,DIAMOND I,75,13.4,441,59,382,ru
2123,123,1348319349,DIAMOND I,75,21.1,270,57,213,ru
2124,124,Джим Рейнор,DIAMOND I,75,17.6,312,55,257,ru
2125,125,Marijuanamama,DIAMOND I,75,15.6,352,55,297,ru
2126,126,blvckboy,DIAMOND I,75,15.3,320,49,271,ru
2127,127,CR0WNZ,DIAMOND I,75,16.0,269,43,226,ru
2128,128,Hoang,DIAMOND I,75,20.9,201,42,159,ru
2129,129,Spring North,DIAMOND I,75,18.0,233,42,191,ru
2130,130,Make me Purr,DIAMOND I,75,20.0,200,40,160,ru
2131,131,im famous,DIAMOND I,75,15.7,230,36,194,ru
2132,132,dontlookatmepls,DIAMOND I,75,32.2,90,29,61,ru
2133,133,iQuestions,DIAMOND I,75,18.9,132,25,107,ru
2134,134,Arclight JinBey,DIAMOND I,73,18.7,332,62,270,ru
2135,135,Just Cancer,DIAMOND I,68,18.3,213,39,174,ru
2136,136,vulcaner,DIAMOND I,66,21.1,185,39,146,ru
2137,137,CN liang,DIAMOND I,63,16.6,440,73,367,ru
2138,138,beznika2,DIAMOND I,61,14.4,215,31,184,ru
2139,139,DuongLan,DIAMOND I,59,16.0,368,59,309,ru
2140,140,РОЗБИЙНЫК,DIAMOND I,56,13.7,548,75,473,ru
2141,141,PistolMaravich,DIAMOND I,48,36.0,264,95,169,ru
2142,142,Дрeeейвен,DIAMOND I,48,11.0,662,73,589,ru
2143,143,УРОД,DIAMOND I,48,40.1,177,71,106,ru
2144,144,NorMe,DIAMOND I,46,18.4,152,28,124,ru
2145,145,KissTheStar,DIAMOND I,44,9.2,413,38,375,ru
2146,146,junestone,DIAMOND I,41,30.4,214,65,149,ru
2148,148,ReMiXoN007,DIAMOND I,33,22.7,141,32,109,ru
2149,149,Lorraine,DIAMOND I,32,26.9,234,63,171,ru
2150,150,8xm12a,DIAMOND I,32,11.6,276,32,244,ru
2151,151,ПоНосик в Одеяле,DIAMOND I,31,27.9,204,57,147,ru
2152,152,Rocket MaRin,DIAMOND I,31,23.5,234,55,179,ru
2153,153,Kiss my fizz,DIAMOND I,29,20.5,327,67,260,ru
2154,154,lºˆºl,DIAMOND I,25,23.0,248,57,191,ru
2155,155,Saitaf,DIAMOND I,25,23.0,226,52,174,ru
2156,156,Dunngarm,DIAMOND I,25,26.3,171,45,126,ru
2157,157,лесk urself jgl,DIAMOND I,20,19.6,209,41,168,ru
2158,158,dyboщит,DIAMOND I,18,18.4,277,51,226,ru
2159,159,Черника,DIAMOND I,17,20.1,329,66,263,ru
2160,160,Kimchi wang,DIAMOND I,17,34.6,127,44,83,ru
2161,161,VN Error RoLL,DIAMOND I,14,13.6,691,94,597,ru
2162,162,kecodon9x,DIAMOND I,12,18.0,205,37,168,ru
2163,163,Ji Yong,DIAMOND I,11,13.3,279,37,242,ru
2164,164,SorrNyak,DIAMOND I,9,18.3,197,36,161,ru
2165,165,Таксидермист1980,DIAMOND I,4,11.5,512,59,453,ru
2166,166,qsoso,DIAMOND I,4,17.2,303,52,251,ru
2167,167,ktotamnukogonet,DIAMOND I,3,25.8,128,33,95,ru
2168,168,JusticeNari,DIAMOND I,3,14.7,217,32,185,ru
2169,169,angelys,DIAMOND I,3,10.4,288,30,258,ru
2170,170,Futaba Sakura,DIAMOND I,1,24.4,131,32,99,ru
2171,171,KURISU ТИНА,DIAMOND I,0,19.4,1048,203,845,ru
2172,172,VN iRabity,DIAMOND I,0,19.1,685,131,554,ru
2173,173,КОРОЛЬ БОГ КОСМО,DIAMOND I,0,17.6,683,120,563,ru
2174,174,RNGM1xg,DIAMOND I,0,20.9,468,98,370,ru
2175,175,Trang4438,DIAMOND I,0,20.1,402,81,321,ru
2176,176,Лёшкина игра,DIAMOND I,0,24.2,231,56,175,ru
2177,177,GGJIANG,DIAMOND I,0,19.0,284,54,230,ru
2178,178,STRMASTER,DIAMOND I,0,24.3,218,53,165,ru
2179,179,AKJSDs,DIAMOND I,0,24.9,209,52,157,ru
2180,180,sketcheer,DIAMOND I,0,16.9,308,52,256,ru
2181,181,LPL dynasty,DIAMOND I,0,21.7,212,46,166,ru
2182,182,SM2LR,DIAMOND I,0,20.0,230,46,184,ru
2183,183,taibox,DIAMOND I,0,12.1,339,41,298,ru
2184,184,Мёртвый принц,DIAMOND I,0,18.1,221,40,181,ru
2185,185,RaNdoOoMuK,DIAMOND I,0,20.4,191,39,152,ru
2186,186,EleemY,DIAMOND I,0,33.0,112,37,75,ru
2187,187,PINCER,DIAMOND I,0,25.6,125,32,93,ru
2188,188,Callsign Kindred,DIAMOND I,0,32.2,90,29,61,ru
2189,189,Дым из трубы,DIAMOND I,0,27.2,103,28,75,ru
2190,190,Tot,DIAMOND I,0,18.6,145,27,118,ru
2191,191,Vladimir Syusin,DIAMOND I,0,11.0,246,27,219,ru
2192,192,Donelly,DIAMOND II,99,14.1,177,25,152,ru
2193,193,ChinhChinh,DIAMOND II,97,17.4,259,45,214,ru
2194,194,SadSlipperS,DIAMOND II,93,12.6,597,75,522,ru
2195,195,More Dark,DIAMOND II,90,14.7,668,98,570,ru
2196,196,Wuaneon,DIAMOND II,88,19.0,179,34,145,ru
2197,197,StaverOk,DIAMOND II,85,20.7,242,50,192,ru
2198,198,Лапки Юми,DIAMOND II,82,15.6,340,53,287,ru
2199,199,GunnerMSK,DIAMOND II,81,20.5,259,53,206,ru
2200,200,Desperateing,DIAMOND II,76,30.8,78,24,54,ru
