rank,name,tier,lp,win rate,played,wins,losses,region
1,Mismatched Socks,CHALLENGER I,1580,21.6,496,107,389,na
2,Ms MatchedSocks,CHALLENGER I,1457,21.6,463,100,363,na
3,Salvyyy,CHALLENGER I,1435,26.5,283,75,208,na
4,gv8,CHALLENGER I,1385,21.1,554,117,437,na
5,FluffyHS,CHALLENGER I,1354,18.3,453,83,370,na
6,Kurumx,CHALLENGER I,1270,20.4,608,124,484,na
7,GrandVice8,CHALLENGER I,1247,19.6,750,147,603,na
8,bertasaurus,CHALLENGER I,1241,17.7,943,167,776,na
9,ajmonsta,CHALLENGER I,1105,16.5,533,88,445,na
10,Naturesbf,CHALLENGER I,1086,15.4,946,146,800,na
11,JIGEJIUWO,CHALLENGER I,1076,16.8,524,88,436,na
12,Krmx,CHALLENGER I,1066,20.4,636,130,506,na
13,Hiraino,CHALLENGER I,1040,15.9,912,145,767,na
14,Cottontail,CHALLENGER I,1026,15.4,689,106,583,na
15,Silliest,CHALLENGER I,1021,25.6,360,92,268,na
16,Gunmay,CHALLENGER I,980,11.1,506,56,450,na
17,lLykus,CHALLENGER I,962,16.3,881,144,737,na
18,Old Lodo,CHALLENGER I,949,16.5,407,67,340,na
19,111094 R,CHALLENGER I,942,13.7,1697,233,1464,na
20,HiROKKKKJP,CHALLENGER I,916,16.4,602,99,503,na
21,M35S,CHALLENGER I,915,15.4,941,145,796,na
22,Kiyoon,CHALLENGER I,876,18.6,1004,187,817,na
23,The Cxk,CHALLENGER I,868,16.3,442,72,370,na
24,EAOST,CHALLENGER I,858,14.9,564,84,480,na
25,Inphinit3,CHALLENGER I,853,16.2,494,80,414,na
26,ttv KitingisHard,CHALLENGER I,843,17.2,956,165,791,na
27,Grillsyy,CHALLENGER I,838,15.7,737,116,621,na
28,Agon,CHALLENGER I,829,18.0,812,146,666,na
29,GoyoTV,CHALLENGER I,820,15.6,855,133,722,na
30,v Köi v,CHALLENGER I,817,21.9,366,80,286,na
31,dowfu ph,CHALLENGER I,817,20.6,267,55,212,na
32,ItzYaBoyBeasty,CHALLENGER I,813,17.1,1014,173,841,na
33,Ripple Overdrive,CHALLENGER I,806,15.3,307,47,260,na
34,enchabi,CHALLENGER I,799,16.1,299,48,251,na
35,BIuePrincess,CHALLENGER I,799,18.6,247,46,201,na
36,TempestLife,CHALLENGER I,793,20.1,283,57,226,na
37,Kled Bundy,CHALLENGER I,782,13.7,1367,187,1180,na
38,Flandre Bot,CHALLENGER I,764,16.9,243,41,202,na
39,Turn1Delver,CHALLENGER I,763,14.6,1632,238,1394,na
40,Live for the Day,CHALLENGER I,760,19.4,846,164,682,na
41,C9 k3soju,CHALLENGER I,754,20.6,1035,213,822,na
42,WhySofaKing,CHALLENGER I,747,14.7,511,75,436,na
43,Ol Lodo,CHALLENGER I,744,15.8,469,74,395,na
44,TwitchTV Odyceuz,CHALLENGER I,739,17.9,485,87,398,na
45,themackerel,CHALLENGER I,732,13.3,751,100,651,na
46,Nice Mister Kien,CHALLENGER I,722,16.7,491,82,409,na
47,NO MORE WINTRADE,CHALLENGER I,722,16.4,299,49,250,na
48,inay,CHALLENGER I,720,15.9,984,157,827,na
49,Ex Railgun,CHALLENGER I,720,16.8,788,132,656,na
50,Xerluk,CHALLENGER I,713,13.8,673,93,580,na
51,Fxxx Yaaa,CHALLENGER I,710,18.1,414,75,339,na
52,Wrackle,CHALLENGER I,710,14.0,393,55,338,na
53,theMaskedPatel,CHALLENGER I,704,16.6,326,54,272,na
54,wx qq258790278,CHALLENGER I,692,19.3,430,83,347,na
55,pastafartianist,CHALLENGER I,687,22.4,236,53,183,na
56,NA SMURF KEKW,CHALLENGER I,684,17.0,224,38,186,na
57,qieqie,CHALLENGER I,679,19.0,542,103,439,na
58,TheMagykal,CHALLENGER I,678,16.5,932,154,778,na
59,McDull,CHALLENGER I,676,14.6,830,121,709,na
60,Zadust TFT,CHALLENGER I,670,15.7,586,92,494,na
61,wo chi bu pang,CHALLENGER I,670,17.9,296,53,243,na
62,Broccóli,CHALLENGER I,669,14.7,518,76,442,na
63,Stompalittle,CHALLENGER I,657,14.6,1277,187,1090,na
64,Eason with U,CHALLENGER I,655,20.6,301,62,239,na
65,WANG SHUO ZHE,CHALLENGER I,654,18.3,289,53,236,na
66,MaskedPatel,CHALLENGER I,653,15.3,242,37,205,na
67,slippinbug,CHALLENGER I,647,17.4,305,53,252,na
68,paulhnlee,CHALLENGER I,645,22.7,216,49,167,na
69,ChrisKillsX,CHALLENGER I,644,19.5,164,32,132,na
70,Xeno,CHALLENGER I,643,19.9,301,60,241,na
71,influrrier,CHALLENGER I,642,16.1,953,153,800,na
72,Sphinx,CHALLENGER I,642,9.8,755,74,681,na
73,brofael,CHALLENGER I,640,12.9,1208,156,1052,na
74,Akurai,CHALLENGER I,640,18.1,349,63,286,na
75,Sun Astronaut,CHALLENGER I,640,13.9,331,46,285,na
76,BeIiever,CHALLENGER I,635,21.0,629,132,497,na
77,JayGeBee,CHALLENGER I,634,14.5,656,95,561,na
78,PureAlohaa,CHALLENGER I,634,16.7,383,64,319,na
79,FroSteeMate,CHALLENGER I,633,15.0,1192,179,1013,na
80,ogapmaler cuck,CHALLENGER I,633,24.2,149,36,113,na
81,Jangsterang,CHALLENGER I,632,15.4,397,61,336,na
82,TFTbigJB,CHALLENGER I,624,17.2,460,79,381,na
83,PockyGom,CHALLENGER I,619,15.6,733,114,619,na
84,morellos,CHALLENGER I,618,17.9,268,48,220,na
85,Simple Plan,CHALLENGER I,617,14.3,630,90,540,na
86,tran98huy,CHALLENGER I,615,18.7,455,85,370,na
87,TFT Parval,CHALLENGER I,612,14.0,536,75,461,na
88,Cris,CHALLENGER I,609,14.2,1502,213,1289,na
89,FinaldF,CHALLENGER I,609,13.0,1393,181,1212,na
90,Mango TheHun,CHALLENGER I,608,17.2,250,43,207,na
91,ME EIGHTH,CHALLENGER I,605,16.5,242,40,202,na
92,H2211,CHALLENGER I,604,19.8,1202,238,964,na
93,firest0ne,CHALLENGER I,604,7.5,1637,123,1514,na
94,Doublezzzz,CHALLENGER I,604,13.5,695,94,601,na
95,Me Predator,CHALLENGER I,604,18.1,321,58,263,na
96,Ashe The Frost,CHALLENGER I,602,11.3,689,78,611,na
97,DoraAmon,CHALLENGER I,600,27.4,124,34,90,na
98,Elvisbeback,CHALLENGER I,599,11.1,325,36,289,na
99,DeadlyCO2,CHALLENGER I,598,11.9,537,64,473,na
100,Coleman TFT,CHALLENGER I,596,19.1,220,42,178,na
101,TTV Kenya1,CHALLENGER I,595,15.3,705,108,597,na
102,birdwings,CHALLENGER I,594,13.3,352,47,305,na
103,P1KACHuuuuuuu,CHALLENGER I,593,31.1,103,32,71,na
104,Aesah,CHALLENGER I,591,19.1,632,121,511,na
105,Humilis,CHALLENGER I,585,13.1,291,38,253,na
106,Souless,CHALLENGER I,584,23.1,190,44,146,na
107,Twitch RayditzFN,CHALLENGER I,583,15.8,1236,195,1041,na
108,Moggy Mako,CHALLENGER I,583,9.0,666,60,606,na
109,Eunwilf,CHALLENGER I,579,18.0,316,57,259,na
110,Agaze,CHALLENGER I,576,17.2,232,40,192,na
111,TTV OmniPieTV,CHALLENGER I,571,16.2,974,158,816,na
112,Sojin,CHALLENGER I,570,15.6,853,133,720,na
113,OrAnGe JuIc3,CHALLENGER I,568,13.2,408,54,354,na
114,Nhân tâm TFT,CHALLENGER I,565,18.4,282,52,230,na
115,lnaban,CHALLENGER I,561,15.5,676,105,571,na
116,thomas tft,CHALLENGER I,561,13.2,574,76,498,na
117,Jaekun2maX,CHALLENGER I,561,18.1,265,48,217,na
118,Sin 94 ToFu,CHALLENGER I,559,15.1,371,56,315,na
119,A shadowy figure,CHALLENGER I,558,15.8,593,94,499,na
120,Oonnii,CHALLENGER I,558,21.0,353,74,279,na
121,TTV iantyler,CHALLENGER I,555,17.2,349,60,289,na
122,Muffinn TFT,CHALLENGER I,555,18.7,225,42,183,na
123,Mean Mister Kien,CHALLENGER I,554,14.4,735,106,629,na
124,Kalsuo,CHALLENGER I,553,16.6,889,148,741,na
125,Kira,CHALLENGER I,553,16.6,580,96,484,na
126,RIOT thatsPRIMAL,CHALLENGER I,552,11.2,953,107,846,na
127,ttvGooGieGaminG,CHALLENGER I,552,13.9,404,56,348,na
128,LGD Wet1less,CHALLENGER I,550,14.8,305,45,260,na
129,DxnTFT,CHALLENGER I,549,15.9,812,129,683,na
130,Lab Member 001,CHALLENGER I,543,15.8,354,56,298,na
131,Reigncat,CHALLENGER I,543,15.2,303,46,257,na
132,Terde,CHALLENGER I,542,17.6,624,110,514,na
133,17º C,CHALLENGER I,542,18.4,452,83,369,na
134,Blaim,CHALLENGER I,539,16.2,711,115,596,na
135,enchaB,CHALLENGER I,538,18.2,280,51,229,na
136,RippleOverdrive2,CHALLENGER I,538,21.6,176,38,138,na
137,Tinkady,CHALLENGER I,537,18.3,591,108,483,na
138,robinsongz,CHALLENGER I,536,15.3,412,63,349,na
139,Scoped32,CHALLENGER I,534,16.1,410,66,344,na
140,birdy511,CHALLENGER I,534,15.4,369,57,312,na
141,HappyMuffinn,CHALLENGER I,532,18.8,260,49,211,na
142,VX15152242663,CHALLENGER I,530,19.1,593,113,480,na
143,NicholasLy6,CHALLENGER I,529,19.8,293,58,235,na
144,BlackBigBig,CHALLENGER I,525,18.0,510,92,418,na
145,Visual,CHALLENGER I,525,16.8,493,83,410,na
146,Kłaytøn,CHALLENGER I,525,15.1,509,77,432,na
147,Bulls0717,CHALLENGER I,524,11.9,502,60,442,na
148,ttv influrrier,CHALLENGER I,522,14.2,614,87,527,na
149,Dairon TFT,CHALLENGER I,522,16.8,298,50,248,na
150,BentoBot,CHALLENGER I,520,15.5,690,107,583,na
151,lilsteppy,CHALLENGER I,518,20.6,388,80,308,na
152,Eunsol    K,CHALLENGER I,518,14.4,381,55,326,na
153,TheHentaiGod,CHALLENGER I,517,15.8,741,117,624,na
154,douyuTV980762,CHALLENGER I,516,15.2,512,78,434,na
155,Catybear,CHALLENGER I,516,15.1,490,74,416,na
156,kavan,CHALLENGER I,514,16.1,372,60,312,na
157,buscusu,CHALLENGER I,512,18.6,806,150,656,na
158,iCopyKeane,CHALLENGER I,511,12.2,353,43,310,na
159,RamKev,CHALLENGER I,508,14.8,832,123,709,na
160,tomrocks,CHALLENGER I,508,16.5,363,60,303,na
161,chitosechitose,CHALLENGER I,507,14.2,650,92,558,na
162,Midrash,CHALLENGER I,507,16.0,394,63,331,na
163,JinxedJKK,CHALLENGER I,505,16.1,341,55,286,na
164,piglet2448,CHALLENGER I,505,22.6,181,41,140,na
165,KomradeKush,CHALLENGER I,504,12.0,816,98,718,na
166,xplitcit,CHALLENGER I,503,14.7,941,138,803,na
167,Jaekun3maX,CHALLENGER I,502,28.6,112,32,80,na
168,felice,CHALLENGER I,500,15.1,185,28,157,na
169,qie77777mimi,CHALLENGER I,498,17.7,288,51,237,na
170,You MDZZ,CHALLENGER I,498,16.4,310,51,259,na
171,chainpullz,CHALLENGER I,498,13.7,314,43,271,na
172,Wolves Save Me,CHALLENGER I,497,13.0,1030,134,896,na
173,21 Zsy,CHALLENGER I,497,21.4,495,106,389,na
174,George Brown TFT,CHALLENGER I,496,14.4,492,71,421,na
175,piggy2448,CHALLENGER I,493,18.7,374,70,304,na
176,Lemon IceCream,CHALLENGER I,492,12.7,754,96,658,na
177,Fountaiin,CHALLENGER I,491,15.3,254,39,215,na
178,Liquid Saint,CHALLENGER I,490,19.2,359,69,290,na
179,TacticalLukarina,CHALLENGER I,488,15.0,840,126,714,na
180,enaek,CHALLENGER I,485,20.4,406,83,323,na
181,MikeP,CHALLENGER I,484,17.2,151,26,125,na
182,Yondai,CHALLENGER I,483,16.4,481,79,402,na
183,sugasugasofly,CHALLENGER I,483,18.1,387,70,317,na
184,Gurt Games,CHALLENGER I,483,9.1,517,47,470,na
185,AndyofSmurf,CHALLENGER I,483,19.4,180,35,145,na
186,kpopfan7,CHALLENGER I,482,14.1,163,23,140,na
187,the OCE special,CHALLENGER I,478,11.4,844,96,748,na
188,Jaekun4maX,CHALLENGER I,476,22.2,180,40,140,na
189,Mister Lau,CHALLENGER I,474,16.2,808,131,677,na
190,TurboARAM,CHALLENGER I,472,14.6,542,79,463,na
191,WafWafWaffle,CHALLENGER I,472,15.6,392,61,331,na
192,FayeBae,CHALLENGER I,469,14.1,440,62,378,na
193,chickensaveme,CHALLENGER I,469,14.8,277,41,236,na
194,yyasuooo,CHALLENGER I,469,22.2,144,32,112,na
195,Decisivewayy,CHALLENGER I,468,13.5,733,99,634,na
196,Keane fans,CHALLENGER I,450,16.9,1262,214,1048,na
197,DreamErica,CHALLENGER I,448,14.6,1010,147,863,na
198,Incite,CHALLENGER I,446,15.7,760,119,641,na
199,Partnerkiller 02,CHALLENGER I,368,16.1,461,74,387,na
200,eue,CHALLENGER I,356,11.0,871,96,775,na
201,NED carry,"GRANDMASTER I
G",501,17.3,329,57,272,na
202,2418,"GRANDMASTER I
G",483,14.2,353,50,303,na
203,Pawnup,"GRANDMASTER I
G",470,14.2,353,50,303,na
204,AndyofLove,"GRANDMASTER I
G",468,17.1,304,52,252,na
205,jwolly,"GRANDMASTER I
G",467,15.3,360,55,305,na
206,blackwhited,"GRANDMASTER I
G",465,14.3,441,63,378,na
207,El Conejo Malo,"GRANDMASTER I
G",465,20.3,286,58,228,na
208,BadlandzTV,"GRANDMASTER I
G",465,19.4,134,26,108,na
209,esportslaw jr,"GRANDMASTER I
G",464,23.5,196,46,150,na
210,Humilis TFT,"GRANDMASTER I
G",459,18.6,204,38,166,na
211,JiaJiaJiaJiaJia,"GRANDMASTER I
G",457,18.8,489,92,397,na
212,DouYu 980762,"GRANDMASTER I
G",456,21.4,229,49,180,na
213,NALelouuch,"GRANDMASTER I
G",455,12.8,879,113,766,na
214,AceofSpadesDAC,"GRANDMASTER I
G",454,18.0,668,120,548,na
215,WúJi,"GRANDMASTER I
G",448,17.3,260,45,215,na
216,x BadlandzTV x,"GRANDMASTER I
G",445,17.8,208,37,171,na
217,C9 Khroen,"GRANDMASTER I
G",444,19.2,381,73,308,na
218,tinkady69,"GRANDMASTER I
G",444,16.4,244,40,204,na
219,Kintsugí,"GRANDMASTER I
G",443,12.8,854,109,745,na
220,Jaekun1maX,"GRANDMASTER I
G",440,18.2,264,48,216,na
221,ootay,"GRANDMASTER I
G",439,22.1,317,70,247,na
222,Lodo,"GRANDMASTER I
G",439,24.1,162,39,123,na
223,TTV NatrixGGs,"GRANDMASTER I
G",437,12.8,1191,153,1038,na
224,AlanLube,"GRANDMASTER I
G",437,15.8,183,29,154,na
225,Ian952,"GRANDMASTER I
G",436,18.2,493,90,403,na
226,Cindys Dave,"GRANDMASTER I
G",435,15.4,630,97,533,na
227,Deleuzer,"GRANDMASTER I
G",432,13.6,514,70,444,na
228,ARee,"GRANDMASTER I
G",428,14.1,589,83,506,na
229,Tapaz,"GRANDMASTER I
G",428,25.8,186,48,138,na
230,Keane tf,"GRANDMASTER I
G",425,18.8,356,67,289,na
231,micheIIe obama,"GRANDMASTER I
G",424,12.9,348,45,303,na
232,TheWaterBearr,"GRANDMASTER I
G",415,13.8,669,92,577,na
233,TTVHentaiGodTFT,"GRANDMASTER I
G",414,20.8,178,37,141,na
234,IllllllIIIIlllll,"GRANDMASTER I
G",410,18.4,310,57,253,na
235,Flashbâng,"GRANDMASTER I
G",409,8.9,879,78,801,na
236,emilyywang,"GRANDMASTER I
G",404,13.3,1123,149,974,na
237,fast eighth,"GRANDMASTER I
G",404,13.4,238,32,206,na
238,TFT TheTian,"GRANDMASTER I
G",401,17.4,259,45,214,na
239,peeba,"GRANDMASTER I
G",400,17.2,1870,322,1548,na
240,Garchompro,"GRANDMASTER I
G",400,11.5,478,55,423,na
241,Bonzolo,"GRANDMASTER I
G",391,14.8,823,122,701,na
242,Fyslexic Duck,"GRANDMASTER I
G",390,15.4,253,39,214,na
243,Dealer Buling,"GRANDMASTER I
G",389,14.5,546,79,467,na
244,eyafeyafeyaf,"GRANDMASTER I
G",388,14.1,618,87,531,na
245,BetOnMe,"GRANDMASTER I
G",388,14.9,409,61,348,na
246,zTaidana,"GRANDMASTER I
G",386,16.4,365,60,305,na
247,WuHB,"GRANDMASTER I
G",385,17.2,933,161,772,na
248,zugrug,"GRANDMASTER I
G",383,13.5,787,106,681,na
249,WorldFamousFries,"GRANDMASTER I
G",383,18.4,423,78,345,na
250,ItzBeastyTFT69,"GRANDMASTER I
G",381,21.3,164,35,129,na
251,Scoped23,"GRANDMASTER I
G",379,20.4,211,43,168,na
252,a wittle penguin,"GRANDMASTER I
G",376,16.0,269,43,226,na
253,TheMambaMachine,"GRANDMASTER I
G",375,18.3,579,106,473,na
254,LEGOGOGO,"GRANDMASTER I
G",373,17.0,188,32,156,na
255,DannySaysNo,"GRANDMASTER I
G",371,14.9,585,87,498,na
256,MegaInfernoBomb,"GRANDMASTER I
G",366,15.0,266,40,226,na
257,mcsorley33,"GRANDMASTER I
G",366,18.5,184,34,150,na
258,DeIiciousMilfGG,"GRANDMASTER I
G",364,17.7,310,55,255,na
259,Balrox,"GRANDMASTER I
G",363,14.4,188,27,161,na
260,ShakeShakeFries,"GRANDMASTER I
G",362,18.6,242,45,197,na
261,Purify,"GRANDMASTER I
G",358,13.5,1039,140,899,na
262,Doril,"GRANDMASTER I
G",357,13.0,1336,174,1162,na
263,vaIsartan,"GRANDMASTER I
G",355,16.1,472,76,396,na
264,WafWafWaf,"GRANDMASTER I
G",354,16.7,347,58,289,na
265,jªrred,"GRANDMASTER I
G",352,14.0,662,93,569,na
266,Tonyoff,"GRANDMASTER I
G",351,17.8,281,50,231,na
267,02l022,"GRANDMASTER I
G",350,16.0,393,63,330,na
268,TwTv Funkyyfrog,"GRANDMASTER I
G",349,13.2,355,47,308,na
269,trade off,"GRANDMASTER I
G",348,15.7,528,83,445,na
270,Depew,"GRANDMASTER I
G",346,14.1,361,51,310,na
271,hâppy game,"GRANDMASTER I
G",344,17.0,305,52,253,na
272,Msquared,"GRANDMASTER I
G",344,14.4,327,47,280,na
273,YxmNA,"GRANDMASTER I
G",343,15.8,202,32,170,na
274,I Died To A Bard,"GRANDMASTER I
G",337,16.1,548,88,460,na
275,L1ssandra,"GRANDMASTER I
G",337,14.5,427,62,365,na
276,LilRoyW,"GRANDMASTER I
G",332,11.1,964,107,857,na
277,anewwplayer,"GRANDMASTER I
G",332,18.0,278,50,228,na
278,NALiocardia,"GRANDMASTER I
G",328,28.3,120,34,86,na
279,KurumsSoreNut,"GRANDMASTER I
G",328,24.3,136,33,103,na
280,JukeYou,"GRANDMASTER I
G",327,17.9,340,61,279,na
281,FFception,"GRANDMASTER I
G",326,16.8,274,46,228,na
282,4arp,"GRANDMASTER I
G",325,9.8,700,69,631,na
283,tapiokaoisii,"GRANDMASTER I
G",320,10.9,532,58,474,na
284,OmniPie,"GRANDMASTER I
G",319,13.2,830,110,720,na
285,Stonerule,"GRANDMASTER I
G",318,17.5,429,75,354,na
286,Oonii,"GRANDMASTER I
G",313,16.2,501,81,420,na
287,best Taro NA,"GRANDMASTER I
G",310,14.9,403,60,343,na
288,Ricechong,"GRANDMASTER I
G",309,14.1,326,46,280,na
289,MrEllusive,"GRANDMASTER I
G",309,19.6,204,40,164,na
290,ttvidontdocardio,"GRANDMASTER I
G",309,14.5,241,35,206,na
291,1375,"GRANDMASTER I
G",308,22.6,106,24,82,na
292,Incompl,"GRANDMASTER I
G",307,11.2,457,51,406,na
293,GUAO,"GRANDMASTER I
G",306,14.5,352,51,301,na
294,TTV iGJaeger,"GRANDMASTER I
G",306,19.5,200,39,161,na
295,adreh NA,"GRANDMASTER I
G",305,17.1,258,44,214,na
296,TwTV neekynooky,"GRANDMASTER I
G",302,14.8,1378,204,1174,na
297,Volc4884,"GRANDMASTER I
G",301,18.3,306,56,250,na
298,Qwat02,"GRANDMASTER I
G",300,16.2,1485,241,1244,na
299,JustinPerson,"GRANDMASTER I
G",300,12.5,513,64,449,na
300,wxqq757081727,"GRANDMASTER I
G",299,25.3,154,39,115,na
301,thi3n,"GRANDMASTER I
G",296,15.1,1492,225,1267,na
302,TFT Cayrub,"GRANDMASTER I
G",296,14.5,1080,157,923,na
303,Leii,"GRANDMASTER I
G",294,12.8,610,78,532,na
304,Keíko Kubota,"GRANDMASTER I
G",293,19.8,126,25,101,na
305,Slooper TFT,"GRANDMASTER I
G",291,27.0,122,33,89,na
306,michhh12,"GRANDMASTER I
G",290,11.8,434,51,383,na
307,Cheney,"GRANDMASTER I
G",290,15.4,266,41,225,na
308,matchedsock,"GRANDMASTER I
G",290,18.1,105,19,86,na
309,Binhja,"GRANDMASTER I
G",283,16.7,312,52,260,na
310,dpei,"GRANDMASTER I
G",282,16.9,432,73,359,na
311,brknwngs,"GRANDMASTER I
G",281,14.0,1212,170,1042,na
312,zzzzzzZ7,"GRANDMASTER I
G",279,18.7,241,45,196,na
313,Riot C,"GRANDMASTER I
G",278,17.7,294,52,242,na
314,MO LI LV CHA,"GRANDMASTER I
G",275,13.3,503,67,436,na
315,ShaftMcBuldge,"GRANDMASTER I
G",274,18.9,291,55,236,na
316,OFF WHITE XLV,"GRANDMASTER I
G",272,10.8,1533,165,1368,na
317,DocPwn,"GRANDMASTER I
G",272,16.4,415,68,347,na
318,CounTerWu,"GRANDMASTER I
G",271,13.6,627,85,542,na
319,VenusZ,"GRANDMASTER I
G",270,17.5,788,138,650,na
320,gead813,"GRANDMASTER I
G",267,17.9,441,79,362,na
321,BKrisz TFT,"GRANDMASTER I
G",267,13.0,563,73,490,na
322,Takes,"GRANDMASTER I
G",267,14.1,192,27,165,na
323,a speedy boi,"GRANDMASTER I
G",266,17.0,159,27,132,na
324,Dios12138,"GRANDMASTER I
G",265,12.6,348,44,304,na
325,DivìNe,"GRANDMASTER I
G",264,15.8,393,62,331,na
326,markersx TFT,"GRANDMASTER I
G",263,14.7,624,92,532,na
327,GIXinGGG,"GRANDMASTER I
G",261,13.9,317,44,273,na
328,Olive JP,"GRANDMASTER I
G",260,14.4,375,54,321,na
329,TFT Moody,"GRANDMASTER I
G",259,18.1,232,42,190,na
330,Cici XD,"GRANDMASTER I
G",256,14.0,579,81,498,na
331,garet,"GRANDMASTER I
G",252,13.8,537,74,463,na
332,d u j b,"GRANDMASTER I
G",250,14.3,546,78,468,na
333,Old dirver Yin,"GRANDMASTER I
G",249,16.7,714,119,595,na
334,ShineBright,"GRANDMASTER I
G",249,15.8,557,88,469,na
335,Ayetrix,"GRANDMASTER I
G",248,12.0,756,91,665,na
336,Nhân Tâm,"GRANDMASTER I
G",248,16.5,375,62,313,na
337,Cuan TianhouRRRR,"GRANDMASTER I
G",247,16.4,403,66,337,na
338,dontbullme,"GRANDMASTER I
G",247,16.1,323,52,271,na
339,Darthnater,"GRANDMASTER I
G",246,11.6,259,30,229,na
340,Kurumix fangirl,"GRANDMASTER I
G",246,18.7,155,29,126,na
341,thresh hook me,"GRANDMASTER I
G",246,9.5,262,25,237,na
342,mawco,"GRANDMASTER I
G",244,15.2,197,30,167,na
343,HKBag,"GRANDMASTER I
G",241,21.9,151,33,118,na
344,alohu,"GRANDMASTER I
G",240,11.6,448,52,396,na
345,Ballhurts,"GRANDMASTER I
G",239,14.6,622,91,531,na
346,swishersweets1,"GRANDMASTER I
G",238,10.4,775,81,694,na
347,Anbicion,"GRANDMASTER I
G",238,12.3,268,33,235,na
348,nickrystaL,"GRANDMASTER I
G",238,16.2,167,27,140,na
349,Goko Ruri,"GRANDMASTER I
G",235,15.5,322,50,272,na
350,Whae,"GRANDMASTER I
G",233,16.3,578,94,484,na
351,BlakeAustin,"GRANDMASTER I
G",233,15.0,494,74,420,na
352,TTV TangibleTFT,"GRANDMASTER I
G",233,10.4,574,60,514,na
353,The Capsules,"GRANDMASTER I
G",232,16.2,506,82,424,na
354,zebroe,"GRANDMASTER I
G",230,13.6,713,97,616,na
355,Bananaramic,"GRANDMASTER I
G",230,10.8,445,48,397,na
356,AsianGamer5,"GRANDMASTER I
G",229,17.8,1011,180,831,na
357,Timmy the Hog,"GRANDMASTER I
G",228,14.0,556,78,478,na
358,Holyfk,"GRANDMASTER I
G",228,20.0,310,62,248,na
359,shireen4,"GRANDMASTER I
G",226,16.4,403,66,337,na
360,skunkywinn,"GRANDMASTER I
G",225,15.8,526,83,443,na
361,C0C0NUT,"GRANDMASTER I
G",225,10.3,368,38,330,na
362,PrímeTime,"GRANDMASTER I
G",224,13.3,784,104,680,na
363,buu buu desu,"GRANDMASTER I
G",222,13.2,797,105,692,na
364,Blueeeeeeeeeee2,"GRANDMASTER I
G",222,15.2,328,50,278,na
365,vAhern,"GRANDMASTER I
G",222,22.1,213,47,166,na
366,Zhaosongyanisson,"GRANDMASTER I
G",222,13.7,307,42,265,na
367,2YoHae7,"GRANDMASTER I
G",222,12.7,204,26,178,na
368,Stellarat0r,"GRANDMASTER I
G",219,18.8,234,44,190,na
369,WeiXin Jerry79x,"GRANDMASTER I
G",219,21.3,183,39,144,na
370,Meeet,"GRANDMASTER I
G",218,16.6,809,134,675,na
371,Quweuwe,"GRANDMASTER I
G",218,17.7,345,61,284,na
372,Fearcely,"GRANDMASTER I
G",218,17.8,275,49,226,na
373,AceKandil,"GRANDMASTER I
G",217,11.5,584,67,517,na
374,FZY  love,"GRANDMASTER I
G",216,14.6,384,56,328,na
375,lovecyt,"GRANDMASTER I
G",216,14.2,381,54,327,na
376,nMercy Redcode,"GRANDMASTER I
G",216,15.8,317,50,267,na
377,QAQ TAT TvT,"GRANDMASTER I
G",214,17.7,231,41,190,na
378,leepaul,"GRANDMASTER I
G",214,24.0,154,37,117,na
379,silentlif3,"GRANDMASTER I
G",213,20.1,184,37,147,na
380,Âzarin,"GRANDMASTER I
G",211,15.3,275,42,233,na
381,Waifu,"GRANDMASTER I
G",211,28.1,146,41,105,na
382,Nefz7,"GRANDMASTER I
G",211,19.9,161,32,129,na
383,RushWizard,"GRANDMASTER I
G",209,14.8,420,62,358,na
384,numanotaihasin,"GRANDMASTER I
G",209,13.5,148,20,128,na
385,Lex94wo,"GRANDMASTER I
G",208,16.2,581,94,487,na
386,Georgetown Siyu,"GRANDMASTER I
G",206,21.7,318,69,249,na
387,Atherton Wing,"GRANDMASTER I
G",206,16.0,418,67,351,na
388,Ym444,"GRANDMASTER I
G",206,18.3,235,43,192,na
389,Vibrant,"GRANDMASTER I
G",205,15.1,575,87,488,na
390,7cjk,"GRANDMASTER I
G",205,12.8,210,27,183,na
391,xin luan le,"GRANDMASTER I
G",202,15.2,395,60,335,na
392,The Man From Far,"GRANDMASTER I
G",201,19.3,197,38,159,na
393,Genosins,"GRANDMASTER I
G",200,13.6,294,40,254,na
394,Pulsefire Jmj,"GRANDMASTER I
G",199,11.7,1237,145,1092,na
395,captain kookie,"GRANDMASTER I
G",199,10.9,672,73,599,na
396,WowSilenceWow,"GRANDMASTER I
G",198,18.1,288,52,236,na
397,guru9,"GRANDMASTER I
G",197,17.4,852,148,704,na
398,Fluffalogical,"GRANDMASTER I
G",197,14.2,534,76,458,na
399,ChiTown Riven,"GRANDMASTER I
G",197,18.3,164,30,134,na
400,Vitamnss,"GRANDMASTER I
G",196,13.7,299,41,258,na
401,Azcryte,"GRANDMASTER I
G",194,15.7,268,42,226,na
402,Nanase wa Kibou,"GRANDMASTER I
G",192,19.2,370,71,299,na
403,Bawlzing,"GRANDMASTER I
G",190,14.6,364,53,311,na
404,DeejGG,"GRANDMASTER I
G",188,12.0,357,43,314,na
405,twentyyi,"GRANDMASTER I
G",187,16.8,393,66,327,na
406,zennonlwr,"GRANDMASTER I
G",187,14.0,299,42,257,na
407,Nyghty,"GRANDMASTER I
G",187,12.0,342,41,301,na
408,aaronmb2,"GRANDMASTER I
G",185,18.4,418,77,341,na
409,philôlin,"GRANDMASTER I
G",185,13.5,392,53,339,na
410,lonelyfox803,"GRANDMASTER I
G",185,23.0,217,50,167,na
411,DokoMoko,"GRANDMASTER I
G",185,10.5,172,18,154,na
412,kentwuhoo,"GRANDMASTER I
G",183,15.3,255,39,216,na
413,Michael0107,"GRANDMASTER I
G",182,19.3,327,63,264,na
414,CrazyKoala,"GRANDMASTER I
G",182,16.5,243,40,203,na
415,DiDiDik,"GRANDMASTER I
G",181,17.4,350,61,289,na
416,birdy513,"GRANDMASTER I
G",181,20.0,90,18,72,na
417,MID NightShadw,"GRANDMASTER I
G",180,15.1,344,52,292,na
418,Ducksquad,"GRANDMASTER I
G",180,15.6,243,38,205,na
419,elusionist,"GRANDMASTER I
G",180,18.6,194,36,158,na
420,php and java,"GRANDMASTER I
G",179,19.7,309,61,248,na
421,Yoshiwee,"GRANDMASTER I
G",177,19.6,358,70,288,na
422,senorhyder,"GRANDMASTER I
G",176,14.2,751,107,644,na
423,TheArmoredTitant,"GRANDMASTER I
G",176,13.3,684,91,593,na
424,eusouumlucas,"GRANDMASTER I
G",176,13.5,193,26,167,na
425,trísh,"GRANDMASTER I
G",175,12.9,774,100,674,na
426,Chuuper,"GRANDMASTER I
G",175,14.4,493,71,422,na
427,Subism,"GRANDMASTER I
G",175,12.9,518,67,451,na
428,russianbear252,"GRANDMASTER I
G",174,14.4,389,56,333,na
429,NutscrackerosTw,"GRANDMASTER I
G",174,10.5,237,25,212,na
430,IG TheWen,"GRANDMASTER I
G",172,22.9,109,25,84,na
431,King Kenneth,"GRANDMASTER I
G",171,13.0,516,67,449,na
432,gunning4you,"GRANDMASTER I
G",170,16.5,437,72,365,na
433,Toast9197,"GRANDMASTER I
G",170,14.3,447,64,383,na
434,showmesomeflash,"GRANDMASTER I
G",170,17.1,170,29,141,na
435,Kyouko Hori,"GRANDMASTER I
G",169,14.7,572,84,488,na
436,freedom sky,"GRANDMASTER I
G",168,16.9,248,42,206,na
437,TopOu50,"GRANDMASTER I
G",167,15.8,1057,167,890,na
438,GGunit,"GRANDMASTER I
G",166,13.4,849,114,735,na
439,hide on tulsa,"GRANDMASTER I
G",166,22.8,162,37,125,na
440,derajwal,"GRANDMASTER I
G",166,11.7,316,37,279,na
441,xStrangelove,"GRANDMASTER I
G",166,18.1,177,32,145,na
442,HostyIam,"GRANDMASTER I
G",165,17.4,270,47,223,na
443,Chikapu,"GRANDMASTER I
G",164,22.9,214,49,165,na
444,Haí Keyi,"GRANDMASTER I
G",163,15.6,589,92,497,na
445,AhchimCalm,"GRANDMASTER I
G",162,14.8,297,44,253,na
446,Jonghyuk Park,"GRANDMASTER I
G",162,35.0,80,28,52,na
447,BBLance,"GRANDMASTER I
G",160,19.0,331,63,268,na
448,pb1njam,"GRANDMASTER I
G",160,11.0,172,19,153,na
449,aer0st0rm,"GRANDMASTER I
G",159,18.6,279,52,227,na
450,PekiM,"GRANDMASTER I
G",159,20.1,134,27,107,na
451,vaziri,"GRANDMASTER I
G",158,13.2,807,107,700,na
452,Saltygod12,"GRANDMASTER I
G",158,14.4,402,58,344,na
453,trainingacount2,"GRANDMASTER I
G",158,16.3,301,49,252,na
454,Geadtft,"GRANDMASTER I
G",156,20.2,257,52,205,na
455,Markersxx,"GRANDMASTER I
G",155,20.8,120,25,95,na
456,EstablishAlter,"GRANDMASTER I
G",154,19.3,145,28,117,na
457,Knight9z2,"GRANDMASTER I
G",153,15.8,419,66,353,na
458,SpicyAhiPoke,"GRANDMASTER I
G",152,17.4,316,55,261,na
459,SKT T1 Taco Bell,"GRANDMASTER I
G",152,35.4,99,35,64,na
460,ToooCubed,"GRANDMASTER I
G",151,16.5,357,59,298,na
461,Sıx,"GRANDMASTER I
G",151,16.3,190,31,159,na
462,JellyReturns,"GRANDMASTER I
G",149,16.0,407,65,342,na
463,BestTimmmmm,"GRANDMASTER I
G",149,12.1,396,48,348,na
464,BlazeFT,"GRANDMASTER I
G",147,17.4,299,52,247,na
465,T TV bigdirty00,"GRANDMASTER I
G",146,13.7,702,96,606,na
466,DLvx15299128725,"GRANDMASTER I
G",146,19.4,444,86,358,na
467,Athanases,"GRANDMASTER I
G",145,13.8,567,78,489,na
468,The Rat Curse,"GRANDMASTER I
G",144,21.7,138,30,108,na
469,Phantom TFT,"GRANDMASTER I
G",143,12.5,777,97,680,na
470,JinxedJK,"GRANDMASTER I
G",143,16.2,463,75,388,na
471,Puppy Astronaut,"GRANDMASTER I
G",143,10.3,406,42,364,na
472,wjlee911,"GRANDMASTER I
G",143,24.1,116,28,88,na
473,DJ NOclue,"GRANDMASTER I
G",142,16.6,507,84,423,na
474,Amasuro,"GRANDMASTER I
G",142,15.6,160,25,135,na
475,ahtsahtsahts,"GRANDMASTER I
G",141,16.7,150,25,125,na
476,oSkyoo,"GRANDMASTER I
G",140,14.0,1007,141,866,na
477,Botsvar,"GRANDMASTER I
G",140,31.6,76,24,52,na
478,Jeï,"GRANDMASTER I
G",139,15.2,367,56,311,na
479,xiaqigaoshou,"GRANDMASTER I
G",139,20.8,178,37,141,na
480,Jackxoff,"GRANDMASTER I
G",138,17.1,507,87,420,na
481,Mattek,"GRANDMASTER I
G",138,14.2,332,47,285,na
482,ShiningZ,"GRANDMASTER I
G",138,16.7,144,24,120,na
483,GeneralPillage,"GRANDMASTER I
G",138,6.7,268,18,250,na
484,douyu296806,"GRANDMASTER I
G",137,20.5,205,42,163,na
485,DemonHT,"GRANDMASTER I
G",136,14.9,457,68,389,na
486,PlusUltra Eva,"GRANDMASTER I
G",136,14.3,460,66,394,na
487,jaby4,"GRANDMASTER I
G",135,15.3,665,102,563,na
488,4boh,"GRANDMASTER I
G",135,26.4,322,85,237,na
489,PiaPiaP1a,"GRANDMASTER I
G",135,14.2,423,60,363,na
490,Baghty,"GRANDMASTER I
G",135,17.2,145,25,120,na
491,dimaar,"GRANDMASTER I
G",134,25.0,124,31,93,na
492,BurningN,"GRANDMASTER I
G",133,13.1,374,49,325,na
493,tra8edy,"GRANDMASTER I
G",132,19.1,278,53,225,na
494,VF Artful Blank,"GRANDMASTER I
G",132,14.2,366,52,314,na
495,Lenom,"GRANDMASTER I
G",131,16.4,525,86,439,na
496,all3nvan,"GRANDMASTER I
G",131,14.9,569,85,484,na
497,Zer,"GRANDMASTER I
G",131,12.7,599,76,523,na
498,Catt Damon,"GRANDMASTER I
G",131,14.0,243,34,209,na
499,Memefite Tactics,"GRANDMASTER I
G",131,18.0,178,32,146,na
500,mc2van,"GRANDMASTER I
G",130,24.0,129,31,98,na
1,bruninho sl,CHALLENGER I,1822,21.3,591,126,465,br
2,cuckmyblade,CHALLENGER I,1609,24.4,492,120,372,br
3,Zadust,CHALLENGER I,1567,33.2,340,113,227,br
4,inc mplete,CHALLENGER I,1401,17.3,761,132,629,br
5,Odyceuz,CHALLENGER I,1352,23.8,501,119,382,br
6,eusouolucas,CHALLENGER I,1326,18.0,701,126,575,br
7,techzz,CHALLENGER I,1303,23.6,588,139,449,br
8,Slooper,CHALLENGER I,1277,24.8,367,91,276,br
9,FabledDofus,CHALLENGER I,1224,19.7,483,95,388,br
10,Serask,CHALLENGER I,1196,21.8,542,118,424,br
11,Higuree,CHALLENGER I,1119,21.2,548,116,432,br
12,Paralelepipo,CHALLENGER I,1093,26.0,254,66,188,br
13,ftdrain,CHALLENGER I,1086,30.1,279,84,195,br
14,BarksdaIe,CHALLENGER I,1086,29.0,241,70,171,br
15,Gúne,CHALLENGER I,1085,23.3,386,90,296,br
16,Medico do SUS22,CHALLENGER I,1034,18.3,589,108,481,br
17,Archway,CHALLENGER I,1027,17.2,441,76,365,br
18,Dairon,CHALLENGER I,981,21.4,322,69,253,br
19,tartaruguinhas2,CHALLENGER I,977,20.8,558,116,442,br
20,Koala Esbelto,CHALLENGER I,973,20.0,721,144,577,br
21,TG Wed,CHALLENGER I,905,16.9,721,122,599,br
22,m3rdapequena,CHALLENGER I,898,26.1,257,67,190,br
23,Past,CHALLENGER I,836,24.9,473,118,355,br
24,Mierdagrande,CHALLENGER I,816,29.6,213,63,150,br
25,escolinha do inc,CHALLENGER I,806,21.4,420,90,330,br
26,Twitch NickTFT,CHALLENGER I,777,21.4,537,115,422,br
27,OOO,CHALLENGER I,776,18.4,516,95,421,br
28,odyceuZEDeletric,CHALLENGER I,763,44.6,92,41,51,br
29,CD ERICK,CHALLENGER I,759,18.5,260,48,212,br
30,Jael TFT,CHALLENGER I,757,20.6,408,84,324,br
31,Lünna,CHALLENGER I,723,20.1,814,164,650,br
32,ViT4O xD,CHALLENGER I,722,18.4,423,78,345,br
33,Haxwei,CHALLENGER I,706,19.1,215,41,174,br
34,mDobZ,CHALLENGER I,700,18.6,253,47,206,br
35,Vowtz,CHALLENGER I,690,16.6,362,60,302,br
36,Neves,CHALLENGER I,684,18.1,371,67,304,br
37,TFT Azura,CHALLENGER I,684,23.5,234,55,179,br
38,Miss Queen,CHALLENGER I,677,12.7,387,49,338,br
39,RFK Azura,CHALLENGER I,676,26.1,468,122,346,br
40,Royal Kvasterr,CHALLENGER I,652,14.3,440,63,377,br
41,Nescau Insolúvel,CHALLENGER I,647,19.8,339,67,272,br
42,B Lara,CHALLENGER I,644,22.3,323,72,251,br
43,Levi,CHALLENGER I,643,22.9,440,101,339,br
44,O HIPER CARRY,CHALLENGER I,643,15.8,507,80,427,br
45,DEZZlN,CHALLENGER I,638,16.7,491,82,409,br
46,Lula Livrão TFT,CHALLENGER I,633,15.8,430,68,362,br
47,TwitchTV Patr0ci,CHALLENGER I,631,15.6,764,119,645,br
48,Yvissaur,CHALLENGER I,628,22.1,308,68,240,br
49,MATEUS DO SUS DF,CHALLENGER I,617,16.8,481,81,400,br
50,AdrianoK,CHALLENGER I,612,17.9,340,61,279,br
51,T F Toddy,"GRANDMASTER I
G",644,26.3,152,40,112,br
52,CD CFCDuuuuds,"GRANDMASTER I
G",605,14.2,723,103,620,br
53,O HIPER CRIME,"GRANDMASTER I
G",602,14.6,419,61,358,br
54,faker indiano,"GRANDMASTER I
G",601,14.9,470,70,400,br
55,Billy Bait,"GRANDMASTER I
G",600,16.4,709,116,593,br
56,the ego illusion,"GRANDMASTER I
G",589,26.9,223,60,163,br
57,Tsuuzaki,"GRANDMASTER I
G",567,20.3,468,95,373,br
58,Bioosfera,"GRANDMASTER I
G",557,15.5,483,75,408,br
59,Kirbyzin,"GRANDMASTER I
G",552,16.1,645,104,541,br
60,Felipolv000,"GRANDMASTER I
G",547,20.4,201,41,160,br
61,BlasHelldder,"GRANDMASTER I
G",534,19.7,406,80,326,br
62,Allahu TK,"GRANDMASTER I
G",525,12.0,885,106,779,br
63,SÄNT hyun,"GRANDMASTER I
G",505,13.4,800,107,693,br
64,Irisdescent,"GRANDMASTER I
G",501,20.2,247,50,197,br
65,kirinde,"GRANDMASTER I
G",498,14.9,656,98,558,br
66,É o tal do Lula,"GRANDMASTER I
G",490,27.2,320,87,233,br
67,Mon Nom,"GRANDMASTER I
G",489,15.6,661,103,558,br
68,Nihonjin,"GRANDMASTER I
G",487,18.0,383,69,314,br
69,TFT Médico,"GRANDMASTER I
G",480,21.1,175,37,138,br
70,Titos,"GRANDMASTER I
G",477,17.6,408,72,336,br
71,Jvão,"GRANDMASTER I
G",470,19.2,526,101,425,br
72,HawkEyeCs7,"GRANDMASTER I
G",461,16.9,679,115,564,br
73,R Angra,"GRANDMASTER I
G",460,17.5,280,49,231,br
74,ego illusions,"GRANDMASTER I
G",453,20.9,253,53,200,br
75,Encatroll é trix,"GRANDMASTER I
G",447,16.6,283,47,236,br
76,Bandu,"GRANDMASTER I
G",446,17.9,521,93,428,br
77,Garras of Rivia,"GRANDMASTER I
G",445,22.8,241,55,186,br
78,Ezo,"GRANDMASTER I
G",442,16.8,517,87,430,br
79,xCyborg,"GRANDMASTER I
G",373,19.5,328,64,264,br
80,tft igor18,"GRANDMASTER I
G",368,22.1,181,40,141,br
81,Tallis Sauro,"GRANDMASTER I
G",361,18.2,346,63,283,br
82,haveaboavida,"GRANDMASTER I
G",354,25.6,164,42,122,br
83,Shinobu300,"GRANDMASTER I
G",353,19.0,358,68,290,br
84,TWITCHTV Stykr,"GRANDMASTER I
G",352,21.0,338,71,267,br
85,Goiano,"GRANDMASTER I
G",351,15.2,368,56,312,br
86,twitch narkesh1,"GRANDMASTER I
G",350,19.8,328,65,263,br
87,Eu só jogo TFT,"GRANDMASTER I
G",336,17.5,578,101,477,br
88,l Hyper Carry,"GRANDMASTER I
G",333,16.9,1024,173,851,br
89,Melança,"GRANDMASTER I
G",330,16.2,661,107,554,br
90,dG Fuhrmann,"GRANDMASTER I
G",330,25.6,262,67,195,br
91,MonteiroLombrado,"GRANDMASTER I
G",327,14.4,444,64,380,br
92,ttvSidekool,"GRANDMASTER I
G",316,13.7,532,73,459,br
93,Doutor Wily,"GRANDMASTER I
G",316,24.3,296,72,224,br
94,Duest,"GRANDMASTER I
G",312,18.7,209,39,170,br
95,itzzLara,"GRANDMASTER I
G",308,16.7,222,37,185,br
96,Royalzito,"GRANDMASTER I
G",305,17.6,450,79,371,br
97,Batata Rufles,"GRANDMASTER I
G",305,18.1,282,51,231,br
98,SannTFT,"GRANDMASTER I
G",297,18.8,373,70,303,br
99,y Satsue,"GRANDMASTER I
G",294,13.6,140,19,121,br
100,RafaStark,"GRANDMASTER I
G",292,18.1,281,51,230,br
101,MominhoGameplays,"GRANDMASTER I
G",289,17.8,400,71,329,br
102,LosAngelesLakers,"GRANDMASTER I
G",288,20.5,156,32,124,br
103,Smurf divino Jax,"GRANDMASTER I
G",285,20.9,239,50,189,br
104,maça docinha,"GRANDMASTER I
G",279,16.5,266,44,222,br
105,NeeverGiveUp,"GRANDMASTER I
G",276,14.0,477,67,410,br
106,Hisekken,"GRANDMASTER I
G",276,16.4,389,64,325,br
107,CD Noah Hunter,"GRANDMASTER I
G",271,15.4,351,54,297,br
108,Ovas de Peixe,"GRANDMASTER I
G",262,14.9,584,87,497,br
109,Sènna,"GRANDMASTER I
G",262,10.4,415,43,372,br
110,Flangonator,"GRANDMASTER I
G",254,16.3,522,85,437,br
111,Edinaldo Safadão,"GRANDMASTER I
G",252,14.7,292,43,249,br
112,Vampyrus,"GRANDMASTER I
G",251,17.4,877,153,724,br
113,divino Jax JG,"GRANDMASTER I
G",250,11.0,1038,114,924,br
114,vcs sao pateta,"GRANDMASTER I
G",249,12.7,646,82,564,br
115,jelly roll blues,"GRANDMASTER I
G",247,15.2,475,72,403,br
116,twí,"GRANDMASTER I
G",245,15.3,313,48,265,br
117,huggz,"GRANDMASTER I
G",243,17.9,896,160,736,br
118,BARbahh,"GRANDMASTER I
G",241,15.1,324,49,275,br
119,Warrior Lulis,"GRANDMASTER I
G",241,20.7,222,46,176,br
120,Beastar,"GRANDMASTER I
G",240,17.4,305,53,252,br
121,Walladi,"GRANDMASTER I
G",240,16.0,194,31,163,br
122,Daníela,"GRANDMASTER I
G",238,17.3,225,39,186,br
123,SKT1 RyuZUU,"GRANDMASTER I
G",238,14.0,243,34,209,br
124,Siilent,"GRANDMASTER I
G",237,14.3,663,95,568,br
125,HeathClyff,"GRANDMASTER I
G",237,19.0,247,47,200,br
126,MittCrowen,"GRANDMASTER I
G",237,17.8,230,41,189,br
127,SKEPET,"GRANDMASTER I
G",235,12.0,559,67,492,br
128,GarrastaClean,"GRANDMASTER I
G",233,19.8,248,49,199,br
129,Paciente67,"GRANDMASTER I
G",229,24.4,127,31,96,br
130,Zamora Lindão,"GRANDMASTER I
G",228,11.4,422,48,374,br
131,Yuu Better,"GRANDMASTER I
G",226,13.2,1417,187,1230,br
132,Greafen,"GRANDMASTER I
G",226,17.7,571,101,470,br
133,Don Batatone,"GRANDMASTER I
G",225,12.2,221,27,194,br
134,Numb3r2,"GRANDMASTER I
G",223,17.8,366,65,301,br
135,CD Koiti,"GRANDMASTER I
G",223,17.0,265,45,220,br
136,LOVER 97,"GRANDMASTER I
G",218,16.7,162,27,135,br
137,ZaionShow,"GRANDMASTER I
G",217,14.5,296,43,253,br
138,JhoyLow,"GRANDMASTER I
G",217,21.2,193,41,152,br
139,killua do rj,"GRANDMASTER I
G",216,12.1,688,83,605,br
140,gazzsinhoxD,"GRANDMASTER I
G",216,16.6,253,42,211,br
141,TAKOKUCHEIROSO,"GRANDMASTER I
G",216,17.0,235,40,195,br
142,Djcaveira TFT,"GRANDMASTER I
G",215,17.4,637,111,526,br
143,Arckie,"GRANDMASTER I
G",214,19.6,362,71,291,br
144,ViroseMata,"GRANDMASTER I
G",213,21.1,265,56,209,br
145,xXperrsonXx,"GRANDMASTER I
G",212,19.1,278,53,225,br
146,RyüZU,"GRANDMASTER I
G",209,12.1,480,58,422,br
147,StrongAndFlowers,"GRANDMASTER I
G",209,14.4,292,42,250,br
148,anuib,"GRANDMASTER I
G",202,9.1,916,83,833,br
149,DonCrazy,"GRANDMASTER I
G",171,12.3,823,101,722,br
150,San Smurf,"GRANDMASTER I
G",91,17.9,296,53,243,br
151,RESIDENT DA ESCS,MASTER I,212,13.9,792,110,682,br
152,Ahri FIiperama,MASTER I,202,16.0,567,91,476,br
153,maçãcomcanela,MASTER I,201,13.1,472,62,410,br
154,l HaX l,MASTER I,198,11.6,541,63,478,br
155,X Yudi,MASTER I,185,14.5,420,61,359,br
156,Crackudo Pistola,MASTER I,179,15.6,295,46,249,br
157,Rubimhood 2,MASTER I,179,18.6,161,30,131,br
158,Ruivão,MASTER I,177,21.1,223,47,176,br
159,Noé Mechanics,MASTER I,177,12.3,367,45,322,br
160,JUJU DO TFT,MASTER I,170,8.1,1073,87,986,br
161,NgMartins,MASTER I,167,13.3,557,74,483,br
162,Gerson bombeiro,MASTER I,167,16.0,343,55,288,br
163,RoronoaVinny,MASTER I,165,18.8,723,136,587,br
164,FrostxD1,MASTER I,164,12.5,1033,129,904,br
165,Jokerrx,MASTER I,159,15.9,208,33,175,br
166,Deyrot,MASTER I,150,21.9,196,43,153,br
167,Guizi16,MASTER I,147,23.1,199,46,153,br
168,bom coração,MASTER I,146,15.0,300,45,255,br
169,Fã da Gal Gadot,MASTER I,144,14.7,470,69,401,br
170,CD Bruel,MASTER I,144,13.7,422,58,364,br
171,JahBullOn,MASTER I,139,12.6,358,45,313,br
172,xOgunx,MASTER I,138,21.9,242,53,189,br
173,BieuL,MASTER I,138,18.2,291,53,238,br
174,ivelthin2,MASTER I,138,14.5,221,32,189,br
175,Batooré,MASTER I,137,22.1,217,48,169,br
176,XebeckX3,MASTER I,136,17.2,314,54,260,br
177,Adboy,MASTER I,134,19.3,269,52,217,br
178,Gorila Quevoa,MASTER I,133,15.5,827,128,699,br
179,brnztz,MASTER I,133,15.2,362,55,307,br
180,King Vinon,MASTER I,132,17.0,153,26,127,br
181,Tarky,MASTER I,131,22.0,558,123,435,br
182,Terror16,MASTER I,129,14.0,729,102,627,br
183,xShanks,MASTER I,129,13.0,253,33,220,br
184,War Lambari,MASTER I,127,16.6,367,61,306,br
185,Cheleia,MASTER I,124,13.5,260,35,225,br
186,Mino Th,MASTER I,124,19.5,154,30,124,br
187,Interplanetário,MASTER I,124,13.9,201,28,173,br
188,Park Ro Jin,MASTER I,121,13.7,291,40,251,br
189,Allpale,MASTER I,119,19.6,347,68,279,br
190,GlaucondE,MASTER I,116,12.3,171,21,150,br
191,dedinho do lula,MASTER I,115,12.6,285,36,249,br
192,pedinshow,MASTER I,113,14.6,342,50,292,br
193,Fayer,MASTER I,112,14.0,257,36,221,br
194,Shugas,MASTER I,110,14.6,398,58,340,br
195,Kovah,MASTER I,110,13.3,195,26,169,br
196,HIGOR HIGOR TFT,MASTER I,106,18.9,344,65,279,br
197,guuih7,MASTER I,106,17.6,205,36,169,br
198,MarkLinv,MASTER I,104,19.5,220,43,177,br
199,zMysto,MASTER I,104,12.1,190,23,167,br
200,Dani Dani TFT,MASTER I,103,16.6,308,51,257,br
201,xOnlyx,MASTER I,101,17.9,425,76,349,br
202,AugustoKyouma,MASTER I,101,11.5,260,30,230,br
203,Vermei,MASTER I,100,13.0,324,42,282,br
204,Behold Imperius,MASTER I,99,28.1,146,41,105,br
205,BRTitan,MASTER I,99,15.9,251,40,211,br
206,Jarvan IV Jungle,MASTER I,98,13.1,510,67,443,br
207,Djanz,MASTER I,98,16.8,304,51,253,br
208,Roubaram o meu,MASTER I,98,14.9,168,25,143,br
209,TAKOKUFEDENO,MASTER I,96,30.2,96,29,67,br
210,Bruno Raposo,MASTER I,95,11.7,196,23,173,br
211,Tuiu ZX,MASTER I,94,11.3,203,23,180,br
212,MAMILOENDURECIDO,MASTER I,91,15.5,614,95,519,br
213,CapelaOMeior,MASTER I,91,15.5,515,80,435,br
214,Kamimurathan,MASTER I,91,12.1,637,77,560,br
215,Dede1 TFT,MASTER I,90,19.4,253,49,204,br
216,Dézim TFT,MASTER I,89,18.3,164,30,134,br
217,NXL Phoenix,MASTER I,87,11.8,398,47,351,br
218,mitastico,MASTER I,86,15.7,312,49,263,br
219,D A M N    777,MASTER I,84,12.0,817,98,719,br
220,Satyr1,MASTER I,84,13.4,516,69,447,br
221,Giovanni Toth,MASTER I,83,14.1,725,102,623,br
222,sir blackpwner,MASTER I,83,10.5,607,64,543,br
223,AdminDiego,MASTER I,82,14.0,730,102,628,br
224,CygnusReborn,MASTER I,82,9.4,469,44,425,br
225,DeBitous,MASTER I,79,14.9,562,84,478,br
226,haze is vibing,MASTER I,78,17.1,496,85,411,br
227,Marketeiro,MASTER I,76,17.4,293,51,242,br
228,Wyzer,MASTER I,76,14.7,326,48,278,br
229,Major Tactics,MASTER I,75,14.8,431,64,367,br
230,Rafinha TheExile,MASTER I,75,17.4,219,38,181,br
231,PheonixS W,MASTER I,73,18.4,380,70,310,br
232,the little gab,MASTER I,72,18.2,192,35,157,br
233,BixoCarpado,MASTER I,71,14.7,170,25,145,br
234,SpotNik,MASTER I,71,18.6,129,24,105,br
235,Nelpike,MASTER I,69,15.4,299,46,253,br
236,07031997,MASTER I,66,15.4,383,59,324,br
237,nao bane heimer,MASTER I,66,8.3,372,31,341,br
238,A Bia me Come,MASTER I,65,13.7,388,53,335,br
239,O Tal do Cabeça,MASTER I,65,12.9,302,39,263,br
240,Sir Ferreira,MASTER I,63,20.5,190,39,151,br
241,MAMI TIROTEIO,MASTER I,63,18.8,176,33,143,br
242,Kawori Miyazono,MASTER I,62,9.4,1092,103,989,br
243,Padawan p1,MASTER I,62,7.5,387,29,358,br
244,PolariZed,MASTER I,62,30.8,65,20,45,br
245,Guiczar,MASTER I,61,11.9,598,71,527,br
246,sakatoba,MASTER I,61,16.9,373,63,310,br
247,TFT Ryok,MASTER I,61,21.8,133,29,104,br
248,Gama Goblins,MASTER I,58,22.3,139,31,108,br
249,bora demoção,MASTER I,57,16.3,190,31,159,br
250,Weiro,MASTER I,53,19.5,149,29,120,br
251,Pagnig0d,MASTER I,52,15.7,293,46,247,br
252,Eddie Jr,MASTER I,51,20.0,425,85,340,br
253,chemistryMAN,MASTER I,49,15.1,238,36,202,br
254,Bad TFT playerr,MASTER I,49,20.4,113,23,90,br
255,Criisto,MASTER I,48,14.6,439,64,375,br
256,RV Thrash,MASTER I,47,17.2,122,21,101,br
257,LeleoBlindãoTFT,MASTER I,46,18.9,281,53,228,br
258,Rubimhood,MASTER I,45,11.5,305,35,270,br
259,Strixy,MASTER I,44,16.5,394,65,329,br
260,LEONERIX,MASTER I,44,12.8,359,46,313,br
261,MinoThalysson,MASTER I,43,22.0,245,54,191,br
262,Carinha de Raiva,MASTER I,43,19.0,247,47,200,br
263,RamonRF,MASTER I,42,15.9,605,96,509,br
264,A CABEÇA,MASTER I,42,18.5,433,80,353,br
265,IntoxiG,MASTER I,42,15.8,486,77,409,br
266,XebeckX1,MASTER I,42,15.5,238,37,201,br
267,Inside Digitally,MASTER I,42,20.8,154,32,122,br
268,Ieko,MASTER I,41,17.5,342,60,282,br
269,Royalz ll,MASTER I,41,17.0,218,37,181,br
270,Heathcote,MASTER I,41,15.6,199,31,168,br
271,AtomicFinger26,MASTER I,40,16.0,212,34,178,br
272,BtG Wonderweiss,MASTER I,39,14.2,435,62,373,br
273,Guiziin,MASTER I,39,17.6,312,55,257,br
274,Gabymar10,MASTER I,39,14.9,361,54,307,br
275,RehDuarte,MASTER I,39,14.1,370,52,318,br
276,Big beijo pra vc,MASTER I,39,15.1,299,45,254,br
277,HohenshaoBanshoo,MASTER I,39,19.7,147,29,118,br
278,TFT ATEU FALIDO,MASTER I,38,9.5,686,65,621,br
279,Cornélio69,MASTER I,38,23.9,247,59,188,br
280,Eduu,MASTER I,38,16.5,345,57,288,br
281,Draicker,MASTER I,38,16.6,145,24,121,br
282,Odiparoanaiel,MASTER I,38,12.4,194,24,170,br
283,Okabuloz,MASTER I,37,13.2,1269,168,1101,br
284,Viking Vaporuub,MASTER I,37,18.7,225,42,183,br
285,Zamora TFT,MASTER I,37,15.3,157,24,133,br
286,Mitsuzord TFT,MASTER I,36,17.0,176,30,146,br
287,Ulth,MASTER I,35,18.4,565,104,461,br
288,Sina TFT,MASTER I,34,27.7,101,28,73,br
289,xLosTxSouLx TFT,MASTER I,34,18.1,127,23,104,br
290,FLIPEZERA,MASTER I,33,18.8,208,39,169,br
291,DobZ,MASTER I,33,30.2,119,36,83,br
292,Vermiliom,MASTER I,33,10.9,247,27,220,br
293,Buttenbender TFT,MASTER I,32,11.3,564,64,500,br
294,Diegocosta28,MASTER I,32,14.4,348,50,298,br
295,mateuslanhoso,MASTER I,32,20.4,142,29,113,br
296,Bronze,MASTER I,32,14.9,194,29,165,br
297,SNEPIN DOG,MASTER I,31,16.0,692,111,581,br
298,Hadex666,MASTER I,31,19.3,486,94,392,br
299,I just play TFT,MASTER I,31,26.5,132,35,97,br
300,Infestissumam,MASTER I,30,15.4,584,90,494,br
301,Darth Hergeir,MASTER I,30,12.9,472,61,411,br
302,SMURF BIG BEIJO,MASTER I,30,15.4,317,49,268,br
303,CHON5,MASTER I,29,22.6,301,68,233,br
304,Yellow Umbrella,MASTER I,29,14.9,403,60,343,br
305,telessena,MASTER I,28,22.3,314,70,244,br
306,Boludo Aweonado,MASTER I,28,15.9,420,67,353,br
307,TFT Dage,MASTER I,28,17.3,179,31,148,br
308,sup sem chat,MASTER I,28,27.5,109,30,79,br
309,KingLordz1,MASTER I,27,11.0,946,104,842,br
310,Maestoso,MASTER I,27,17.8,439,78,361,br
311,Tony o Motoboy,MASTER I,27,13.2,355,47,308,br
312,Policial boa,MASTER I,27,18.5,173,32,141,br
313,Unfinished song,MASTER I,27,24.0,104,25,79,br
314,Fragile Armor,MASTER I,26,16.4,397,65,332,br
315,Amon TFT,MASTER I,26,12.3,512,63,449,br
316,Citric,MASTER I,26,22.1,131,29,102,br
317,Sukesvs,MASTER I,25,14.4,908,131,777,br
318,LeMort,MASTER I,25,13.0,276,36,240,br
319,Tequilera,MASTER I,25,15.6,225,35,190,br
320,EL TUKAS,MASTER I,24,16.9,509,86,423,br
321,Smurf do Vovo,MASTER I,24,20.6,155,32,123,br
322,lBulleTT,MASTER I,23,20.0,195,39,156,br
323,Vïni,MASTER I,23,10.2,303,31,272,br
324,MiragePH,MASTER I,23,13.2,166,22,144,br
325,Mitsuzord,MASTER I,22,9.0,810,73,737,br
326,C9 LuBu,MASTER I,22,11.0,593,65,528,br
327,Kayle RXSL,MASTER I,21,17.4,363,63,300,br
328,Vixabali,MASTER I,21,12.6,486,61,425,br
329,CADU xTFTx,MASTER I,21,11.2,402,45,357,br
330,xSoulsuke,MASTER I,21,13.7,219,30,189,br
331,nolliA,MASTER I,21,28.6,70,20,50,br
332,Aillon,MASTER I,21,19.4,98,19,79,br
333,1 2 3 4 5 6 7,MASTER I,20,20.6,335,69,266,br
334,BuGad0 TFT,MASTER I,20,10.6,321,34,287,br
335,xewelzer,MASTER I,19,23.7,355,84,271,br
336,FunEngine,MASTER I,19,13.8,304,42,262,br
337,Volt TFT,MASTER I,19,15.5,239,37,202,br
338,BiscoitoS2,MASTER I,18,18.6,338,63,275,br
339,DoctorMadeira2,MASTER I,18,11.8,322,38,284,br
340,i9Sedex,MASTER I,17,22.3,273,61,212,br
341,Aphroddi,MASTER I,17,17.1,286,49,237,br
342,Astholfo,MASTER I,17,18.7,214,40,174,br
343,twt sirius,MASTER I,17,16.0,244,39,205,br
344,Itocris,MASTER I,17,17.1,211,36,175,br
345,FelixBarboza,MASTER I,16,19.0,462,88,374,br
346,Sâm,MASTER I,16,9.8,873,86,787,br
347,miIes halter,MASTER I,16,15.4,505,78,427,br
348,Ralmico,MASTER I,16,20.3,374,76,298,br
349,Lucas reformado,MASTER I,16,17.5,366,64,302,br
350,Ryok,MASTER I,16,15.6,218,34,184,br
351,É o Rauzitus né,MASTER I,16,22.5,142,32,110,br
352,Himejima Akeno,MASTER I,16,17.8,157,28,129,br
353,Meu nome é isso,MASTER I,16,15.5,168,26,142,br
354,bluish flame,MASTER I,15,13.5,355,48,307,br
355,Zesizeru,MASTER I,15,18.2,220,40,180,br
356,Le ismym4in,MASTER I,15,13.1,198,26,172,br
357,Cyber Legacy,MASTER I,14,18.4,282,52,230,br
358,TeMameiAjoelhado,MASTER I,14,26.1,184,48,136,br
359,Cavalo Gaúcho,MASTER I,14,11.8,372,44,328,br
360,znx,MASTER I,14,14.1,256,36,220,br
361,Eu amo mt ela,MASTER I,14,24.0,121,29,92,br
362,kratos2123,MASTER I,14,20.3,133,27,106,br
363,Chera meu shacco,MASTER I,13,17.7,560,99,461,br
364,Ana Beatriz,MASTER I,13,19.5,277,54,223,br
365,xDCariocaxD,MASTER I,13,20.2,193,39,154,br
366,JV O Pendante,MASTER I,13,14.5,200,29,171,br
367,ALFA,MASTER I,13,16.0,175,28,147,br
368,Kh1laf,MASTER I,12,17.2,437,75,362,br
369,l  DoctoR  l,MASTER I,12,19.0,327,62,265,br
370,xLosTxSouLx,MASTER I,12,16.2,315,51,264,br
371,Peepo Happy,MASTER I,12,10.2,470,48,422,br
372,I Vayu I,MASTER I,12,12.3,348,43,305,br
373,Wertech,MASTER I,12,20.6,155,32,123,br
374,Robot29,MASTER I,12,19.7,147,29,118,br
375,Gonzalez666,MASTER I,11,10.9,475,52,423,br
376,SweGGRED,MASTER I,11,19.9,231,46,185,br
377,WL Arthurzinho,MASTER I,11,17.4,218,38,180,br
378,Stephen Hawkings,MASTER I,11,13.0,276,36,240,br
379,MisakaS2,MASTER I,11,18.3,175,32,143,br
380,TFT JV,MASTER I,10,16.0,407,65,342,br
381,AerialBoy,MASTER I,10,14.6,404,59,345,br
382,Ratochinski,MASTER I,10,14.7,265,39,226,br
383,MC Ainzinho,MASTER I,10,13.6,273,37,236,br
384,NARNIANOjr,MASTER I,10,11.9,251,30,221,br
385,Lucin do TFT,MASTER I,9,15.4,492,76,416,br
386,Riconss,MASTER I,9,21.7,272,59,213,br
387,Maiyinha,MASTER I,9,20.6,282,58,224,br
388,Urso Árabe,MASTER I,9,21.5,246,53,193,br
389,I John l,MASTER I,9,14.7,319,47,272,br
390,Joe Fury,MASTER I,9,17.0,253,43,210,br
391,vo pro dofus,MASTER I,9,27.6,87,24,63,br
392,souumlucas,MASTER I,9,27.6,76,21,55,br
393,FawZer,MASTER I,8,17.7,373,66,307,br
394,Lipex,MASTER I,8,20.6,170,35,135,br
395,JoliasJolaias,MASTER I,8,13.3,196,26,170,br
396,Krobalto,MASTER I,7,12.7,465,59,406,br
397,Junho de 1979,MASTER I,7,18.8,261,49,212,br
398,WUK EPICURISTA,MASTER I,7,12.7,379,48,331,br
399,Seu Culindo,MASTER I,7,21.7,166,36,130,br
400,Lombrah,MASTER I,7,15.4,221,34,187,br
401,Macaonn,MASTER I,6,12.7,613,78,535,br
402,Vladinhomir,MASTER I,6,19.3,290,56,234,br
403,Kidzinho,MASTER I,6,14.1,391,55,336,br
404,Sydney Cole,MASTER I,6,19.0,268,51,217,br
405,ANDREA 10 FILHOS,MASTER I,6,11.3,194,22,172,br
406,Until i Die,MASTER I,5,10.9,705,77,628,br
407,MBokos,MASTER I,5,18.6,392,73,319,br
408,l Floky l,MASTER I,5,25.0,236,59,177,br
409,Valor is my main,MASTER I,5,23.9,180,43,137,br
410,Dokin,MASTER I,5,16.0,262,42,220,br
411,Mathsilver,MASTER I,5,15.1,272,41,231,br
412,Yninjabrasil,MASTER I,5,27.6,145,40,105,br
413,IG Balzana,MASTER I,5,18.6,177,33,144,br
414,SpaCeZark,MASTER I,5,17.5,183,32,151,br
415,Chimarraio,MASTER I,5,14.8,210,31,179,br
416,Pessoinha101,MASTER I,5,19.5,154,30,124,br
417,alvesjp,MASTER I,5,16.2,148,24,124,br
418,Amo um Palhaço,MASTER I,4,18.9,334,63,271,br
419,Golden Wings,MASTER I,4,15.8,272,43,229,br
420,swear on styx,MASTER I,4,15.6,160,25,135,br
421,O Tatá é Fota,MASTER I,3,13.9,495,69,426,br
422,ReiCasca,MASTER I,3,13.0,516,67,449,br
423,xDuracelx,MASTER I,3,17.3,323,56,267,br
424,Excelsior XD,MASTER I,3,22.3,224,50,174,br
425,Mãe da Karma,MASTER I,3,18.7,235,44,191,br
426,FLA chips,MASTER I,3,16.8,250,42,208,br
427,Pusk,MASTER I,3,21.8,174,38,136,br
428,Äyrton Senna,MASTER I,3,17.7,203,36,167,br
429,Goiano3Estrelas,MASTER I,3,16.0,219,35,184,br
430,germanTFT,MASTER I,3,22.2,135,30,105,br
431,FireDiamond,MASTER I,3,17.5,160,28,132,br
432,NORVAK,MASTER I,3,17.0,135,23,112,br
433,Little Yumie,MASTER I,2,8.3,879,73,806,br
434,Gahilan,MASTER I,2,14.8,487,72,415,br
435,Feedei no Ferro4,MASTER I,2,13.2,524,69,455,br
436,Billy Bat,MASTER I,2,11.3,577,65,512,br
437,2v2,MASTER I,2,11.1,579,64,515,br
438,smurf cadu xTFTx,MASTER I,2,16.4,383,63,320,br
439,Lermi,MASTER I,2,13.9,446,62,384,br
440,JãoZao13,MASTER I,2,11.1,557,62,495,br
441,Mestre no TFT,MASTER I,2,17.5,292,51,241,br
442,foquís,MASTER I,2,17.0,235,40,195,br
443,BestOne,MASTER I,2,14.4,118,17,101,br
444,SaudosaMaloca,MASTER I,1,15.0,406,61,345,br
445,Makzero,MASTER I,1,14.4,409,59,350,br
446,iCorry,MASTER I,1,22.4,201,45,156,br
447,Beach Goth,MASTER I,1,10.4,404,42,362,br
448,The Gama King,MASTER I,1,17.9,207,37,170,br
449,Allancar,MASTER I,1,26.1,138,36,102,br
450,Niicoso,MASTER I,1,12.7,205,26,179,br
451,cythtei,MASTER I,1,22.3,112,25,87,br
452,LyrikGG,MASTER I,0,15.8,660,104,556,br
453,Oliver FAR,MASTER I,0,11.5,793,91,702,br
454,deiSHA COmigo rs,MASTER I,0,11.4,763,87,676,br
455,SilverSoldier,MASTER I,0,22.0,354,78,276,br
456,Marlboro IceMint,MASTER I,0,21.1,356,75,281,br
457,Totto,MASTER I,0,15.1,497,75,422,br
458,C Marighella,MASTER I,0,19.0,389,74,315,br
459,Dérp,MASTER I,0,13.3,547,73,474,br
460,xGottschalk,MASTER I,0,18.9,366,69,297,br
461,Feeddersticks,MASTER I,0,24.3,280,68,212,br
462,ArenaBulldog TFT,MASTER I,0,15.4,441,68,373,br
463,its doomed,MASTER I,0,20.4,329,67,262,br
464,PinGuim Eu Sou,MASTER I,0,15.9,408,65,343,br
465,TFT Japalterado,MASTER I,0,17.1,368,63,305,br
466,SpeIIman,MASTER I,0,22.5,275,62,213,br
467,FLA Visconde,MASTER I,0,18.6,328,61,267,br
468,nyaw,MASTER I,0,16.1,367,59,308,br
469,Balalaika Pura,MASTER I,0,20.7,280,58,222,br
470,iEnergy,MASTER I,0,14.9,356,53,303,br
471,ÖDlN,MASTER I,0,17.4,287,50,237,br
472,KidoSuno,MASTER I,0,12.9,381,49,332,br
473,felipeeanjos,MASTER I,0,15.9,296,47,249,br
474,Iorek TFT,MASTER I,0,16.4,275,45,230,br
475,Cadê a namorada,MASTER I,0,11.3,390,44,346,br
476,GadaoDeDeus,MASTER I,0,15.5,278,43,235,br
477,Mr Kappa,MASTER I,0,22.9,175,40,135,br
478,O Bessa,MASTER I,0,21.7,184,40,144,br
479,Letacio,MASTER I,0,18.3,213,39,174,br
480,RoyallBurN,MASTER I,0,13.6,287,39,248,br
481,Grakehall,MASTER I,0,12.1,321,39,282,br
482,FoxYin,MASTER I,0,20.3,187,38,149,br
483,Daemonfeuer,MASTER I,0,16.0,237,38,199,br
484,Pabloht,MASTER I,0,12.5,295,37,258,br
485,Adellos,MASTER I,0,11.6,319,37,282,br
486,BADBatavo TFT,MASTER I,0,21.1,166,35,131,br
487,DSM CallMeGod,MASTER I,0,14.5,241,35,206,br
488,TA IN SHOCK KK,MASTER I,0,9.7,361,35,326,br
489,Tryndamere King,MASTER I,0,18.1,188,34,154,br
490,Rendras,MASTER I,0,18.0,183,33,150,br
491,PouWalki,MASTER I,0,17.6,182,32,150,br
492,bshow,MASTER I,0,13.7,234,32,202,br
493,Krayvhus Luvith,MASTER I,0,11.1,288,32,256,br
494,H1p3rioN,MASTER I,0,24.2,128,31,97,br
495,Hater De Kpoper,MASTER I,0,14.4,215,31,184,br
496,Inalvejavel,MASTER I,0,17.3,162,28,134,br
497,Fabulas,MASTER I,0,8.9,314,28,286,br
498,tachyonic,MASTER I,0,18.0,150,27,123,br
499,Rickon Kent,MASTER I,0,22.9,109,25,84,br
500,Lil Darius Bro,MASTER I,0,21.6,111,24,87,br
1,DaSaEbaVMo6niq,CHALLENGER I,1811,25.6,441,113,328,eune
2,TFT Hadaf,CHALLENGER I,1510,26.4,443,117,326,eune
3,Chinese Superbot,CHALLENGER I,1176,25.0,711,178,533,eune
4,Deepityy,CHALLENGER I,1171,26.6,282,75,207,eune
5,Hi Im Hadaf,CHALLENGER I,1116,21.6,282,61,221,eune
6,Deepityyy,CHALLENGER I,1115,29.4,282,83,199,eune
7,Barbalofono,CHALLENGER I,1009,14.1,545,77,468,eune
8,nuenueyouyuegou,CHALLENGER I,1009,31.0,229,71,158,eune
9,qqqwwweeerrrttt,CHALLENGER I,942,27.5,309,85,224,eune
10,Spatula Rasa,CHALLENGER I,929,12.6,1015,128,887,eune
11,ShayonZ,CHALLENGER I,923,24.1,398,96,302,eune
12,yingyi,CHALLENGER I,871,24.9,189,47,142,eune
13,Kier0n,CHALLENGER I,818,24.7,247,61,186,eune
14,BBit,CHALLENGER I,790,26.5,162,43,119,eune
15,kocham michasia,CHALLENGER I,789,33.0,215,71,144,eune
16,Ambitious Noob,CHALLENGER I,779,21.7,355,77,278,eune
17,Quevash,CHALLENGER I,779,21.4,243,52,191,eune
18,Kumihowo,CHALLENGER I,777,27.2,184,50,134,eune
19,End of The Line,CHALLENGER I,752,15.5,1086,168,918,eune
20,Abo Sreee3,CHALLENGER I,741,25.9,321,83,238,eune
21,Fadder,CHALLENGER I,678,18.1,486,88,398,eune
22,Cebo v9,CHALLENGER I,665,23.1,182,42,140,eune
23,Sting Youclif,CHALLENGER I,660,19.3,218,42,176,eune
24,Maro0N,CHALLENGER I,650,25.8,155,40,115,eune
25,longlive,CHALLENGER I,642,13.9,346,48,298,eune
26,shonun,CHALLENGER I,641,27.4,135,37,98,eune
27,Tokuchi Toua,CHALLENGER I,616,18.5,249,46,203,eune
28,Bardton Senna,CHALLENGER I,612,17.6,330,58,272,eune
29,Freak Simba,CHALLENGER I,610,13.0,424,55,369,eune
30,Sesard,CHALLENGER I,599,16.6,296,49,247,eune
31,Strikerko,CHALLENGER I,591,19.5,620,121,499,eune
32,Endø,CHALLENGER I,591,17.0,300,51,249,eune
33,Daniels sagor,CHALLENGER I,586,19.4,222,43,179,eune
34,WP Szati,CHALLENGER I,584,20.1,319,64,255,eune
35,Brynool,CHALLENGER I,582,22.3,242,54,188,eune
36,acoj,CHALLENGER I,574,16.3,251,41,210,eune
37,DIV Fortanu,CHALLENGER I,572,17.8,342,61,281,eune
38,Tryndabeard TTV,CHALLENGER I,565,21.6,190,41,149,eune
39,pjsaig,CHALLENGER I,565,31.2,125,39,86,eune
40,SnailDaddy,CHALLENGER I,556,15.5,592,92,500,eune
41,BillKong,CHALLENGER I,554,20.4,285,58,227,eune
42,Im Sneaky,CHALLENGER I,548,16.8,596,100,496,eune
43,Άνεργος,CHALLENGER I,535,14.5,366,53,313,eune
44,SaintBlacky,CHALLENGER I,534,13.2,627,83,544,eune
45,Swimmable Toast,CHALLENGER I,526,27.2,136,37,99,eune
46,No Ragrets,CHALLENGER I,518,20.1,304,61,243,eune
47,rngshinyruo,CHALLENGER I,512,25.3,182,46,136,eune
48,SB CCisMyCounter,CHALLENGER I,509,18.3,301,55,246,eune
49,Tw1stedFate1,CHALLENGER I,491,27.4,164,45,119,eune
50,jakecn,CHALLENGER I,424,18.4,207,38,169,eune
51,masterboi,"GRANDMASTER I
G",567,13.1,467,61,406,eune
52,tokkila,"GRANDMASTER I
G",566,17.7,345,61,284,eune
53,Redundancia,"GRANDMASTER I
G",559,25.6,305,78,227,eune
54,LuQ876,"GRANDMASTER I
G",534,14.3,750,107,643,eune
55,earlyheart,"GRANDMASTER I
G",522,26.4,148,39,109,eune
56,ŹZ ZZ ZZ ZZ ZZ,"GRANDMASTER I
G",510,15.2,988,150,838,eune
57,MosPeΙeush,"GRANDMASTER I
G",498,17.1,210,36,174,eune
58,Cuudi,"GRANDMASTER I
G",482,17.3,398,69,329,eune
59,kEEN v7,"GRANDMASTER I
G",476,19.6,148,29,119,eune
60,deqiang,"GRANDMASTER I
G",454,20.4,265,54,211,eune
61,Brixilolzsk,"GRANDMASTER I
G",449,16.9,445,75,370,eune
62,RaVen v1,"GRANDMASTER I
G",446,21.6,217,47,170,eune
63,Electrolyze,"GRANDMASTER I
G",445,20.5,254,52,202,eune
64,malac1,"GRANDMASTER I
G",434,14.5,338,49,289,eune
65,JointBongo,"GRANDMASTER I
G",430,25.7,136,35,101,eune
66,abe the savior,"GRANDMASTER I
G",427,15.8,632,100,532,eune
67,4NDI,"GRANDMASTER I
G",414,20.0,695,139,556,eune
68,lBigossl,"GRANDMASTER I
G",412,11.8,355,42,313,eune
69,Nevilter,"GRANDMASTER I
G",391,14.0,321,45,276,eune
70,RNGuziuziuzi,"GRANDMASTER I
G",373,30.1,126,38,88,eune
71,Epitheoritiς,"GRANDMASTER I
G",371,15.6,307,48,259,eune
72,Slanof,"GRANDMASTER I
G",369,15.4,389,60,329,eune
73,hemourenya,"GRANDMASTER I
G",364,20.4,264,54,210,eune
74,aal233,"GRANDMASTER I
G",363,16.2,414,67,347,eune
75,MLxDDD,"GRANDMASTER I
G",361,18.1,380,69,311,eune
76,tftsoftexe,"GRANDMASTER I
G",357,19.2,318,61,257,eune
77,forever52,"GRANDMASTER I
G",356,23.9,167,40,127,eune
78,tousinimab,"GRANDMASTER I
G",352,18.1,299,54,245,eune
79,qiqi277,"GRANDMASTER I
G",350,27.6,123,34,89,eune
80,wangweichuizi,"GRANDMASTER I
G",350,14.9,222,33,189,eune
81,Kőrean Jungler,"GRANDMASTER I
G",333,16.4,816,134,682,eune
82,citrusZZ,"GRANDMASTER I
G",331,16.7,305,51,254,eune
83,wenfan,"GRANDMASTER I
G",327,22.0,159,35,124,eune
84,dendek,"GRANDMASTER I
G",325,20.8,317,66,251,eune
85,Id sex me,"GRANDMASTER I
G",325,36.8,117,43,74,eune
86,victor victoris,"GRANDMASTER I
G",323,13.2,509,67,442,eune
87,OFC Cute,"GRANDMASTER I
G",314,14.5,448,65,383,eune
88,xiaozhuhuijie,"GRANDMASTER I
G",313,19.8,187,37,150,eune
89,MaKharg JG,"GRANDMASTER I
G",307,17.8,427,76,351,eune
90,KREATOPITA,"GRANDMASTER I
G",307,16.6,235,39,196,eune
91,ARNOLD,"GRANDMASTER I
G",302,15.6,764,119,645,eune
92,Cerebel22,"GRANDMASTER I
G",300,14.8,243,36,207,eune
93,Riku Na,"GRANDMASTER I
G",299,30.8,117,36,81,eune
94,Laamakuiskaaja,"GRANDMASTER I
G",298,11.7,633,74,559,eune
95,Nickon,"GRANDMASTER I
G",296,16.8,381,64,317,eune
96,Fine11,"GRANDMASTER I
G",295,15.4,519,80,439,eune
97,Chieftan Nessus,"GRANDMASTER I
G",292,14.4,201,29,172,eune
98,jiaozhiaini,"GRANDMASTER I
G",290,17.8,247,44,203,eune
99,yyyyyye,"GRANDMASTER I
G",286,19.6,407,80,327,eune
100,yuquan,"GRANDMASTER I
G",276,22.6,350,79,271,eune
101,VERONICA RUN RUN,"GRANDMASTER I
G",275,25.4,240,61,179,eune
102,mozhili,"GRANDMASTER I
G",274,17.6,443,78,365,eune
103,Pana2525,"GRANDMASTER I
G",274,21.0,267,56,211,eune
104,MARStoiAN,"GRANDMASTER I
G",271,11.1,559,62,497,eune
105,For chr1st sake,"GRANDMASTER I
G",268,11.1,721,80,641,eune
106,FENG13144,"GRANDMASTER I
G",267,25.3,249,63,186,eune
107,Baschtian,"GRANDMASTER I
G",262,26.5,151,40,111,eune
108,Efrebee,"GRANDMASTER I
G",262,22.9,131,30,101,eune
109,Ih8java,"GRANDMASTER I
G",260,18.5,552,102,450,eune
110,Challenger Heart,"GRANDMASTER I
G",258,20.1,179,36,143,eune
111,xiaofeng998,"GRANDMASTER I
G",256,24.1,137,33,104,eune
112,youzaifanfu,"GRANDMASTER I
G",255,19.7,436,86,350,eune
113,DcStarz,"GRANDMASTER I
G",254,19.7,254,50,204,eune
114,drma330,"GRANDMASTER I
G",253,16.4,293,48,245,eune
115,SKT Mexes,"GRANDMASTER I
G",252,15.3,229,35,194,eune
116,SeekN7eak,"GRANDMASTER I
G",248,18.0,1188,214,974,eune
117,Boudist,"GRANDMASTER I
G",245,16.8,285,48,237,eune
118,Wykonc,"GRANDMASTER I
G",242,17.2,244,42,202,eune
119,huyabinzi,"GRANDMASTER I
G",242,18.3,224,41,183,eune
120,Ο Β Ε Υ,"GRANDMASTER I
G",241,17.3,307,53,254,eune
121,K3NNY1337,"GRANDMASTER I
G",241,14.1,347,49,298,eune
122,Darosch,"GRANDMASTER I
G",241,13.4,276,37,239,eune
123,Cynamon TFT,"GRANDMASTER I
G",240,13.9,653,91,562,eune
124,CHINCZYQ,"GRANDMASTER I
G",240,16.2,136,22,114,eune
125,sfedis,"GRANDMASTER I
G",238,15.0,367,55,312,eune
126,LyAmAm,"GRANDMASTER I
G",238,22.1,154,34,120,eune
127,božský tureto,"GRANDMASTER I
G",235,13.5,245,33,212,eune
128,ETSIDETHABENEIS,"GRANDMASTER I
G",234,16.6,337,56,281,eune
129,duange666,"GRANDMASTER I
G",232,24.3,136,33,103,eune
130,onik1997,"GRANDMASTER I
G",227,40.0,100,40,60,eune
131,Cebanthon,"GRANDMASTER I
G",226,26.0,177,46,131,eune
132,kuaileFN666,"GRANDMASTER I
G",224,29.6,189,56,133,eune
133,kecsketej5,"GRANDMASTER I
G",223,19.3,398,77,321,eune
134,Donger Bonger,"GRANDMASTER I
G",223,31.0,113,35,78,eune
135,Tiro X Eqt,"GRANDMASTER I
G",221,13.8,267,37,230,eune
136,Žiks,"GRANDMASTER I
G",220,19.8,212,42,170,eune
137,gyybtomorrow,"GRANDMASTER I
G",220,18.2,198,36,162,eune
138,qaqqqqq,"GRANDMASTER I
G",216,17.3,214,37,177,eune
139,Ćelestial,"GRANDMASTER I
G",209,15.2,414,63,351,eune
140,ZBlang,"GRANDMASTER I
G",207,28.7,101,29,72,eune
141,Th3 Mask,"GRANDMASTER I
G",199,19.1,540,103,437,eune
142,qwbctyz,"GRANDMASTER I
G",195,29.2,137,40,97,eune
143,klausrofl twitch,"GRANDMASTER I
G",180,13.4,358,48,310,eune
144,tinmar,"GRANDMASTER I
G",166,16.5,327,54,273,eune
145,aosjsjz,"GRANDMASTER I
G",155,21.1,190,40,150,eune
146,DarkSynapse,"GRANDMASTER I
G",145,11.5,1017,117,900,eune
147,nayemnau,"GRANDMASTER I
G",144,19.4,304,59,245,eune
148,TheLazyBastard,"GRANDMASTER I
G",142,22.2,162,36,126,eune
149,maurhapilhGR,"GRANDMASTER I
G",102,16.3,258,42,216,eune
150,JaguarKWT,MASTER I,410,14.2,176,25,151,eune
151,YhongL,MASTER I,298,12.3,259,32,227,eune
152,tiaotiao111,MASTER I,257,15.8,222,35,187,eune
153,jijn3rj4j,MASTER I,245,24.1,141,34,107,eune
154,LeBronze Jàmes,MASTER I,232,19.7,493,97,396,eune
155,islam alghoul,MASTER I,226,15.2,269,41,228,eune
156,rekklescranetail,MASTER I,225,27.2,147,40,107,eune
157,Lucifer Junior,MASTER I,219,18.5,400,74,326,eune
158,NBDandan,MASTER I,218,17.1,170,29,141,eune
159,Lil Vayne J7,MASTER I,217,19.0,716,136,580,eune
160,Chinese0008,MASTER I,216,25.4,110,28,82,eune
161,lordpepigz,MASTER I,212,15.1,312,47,265,eune
162,harimania,MASTER I,210,24.2,153,37,116,eune
163,TFT Poulaki,MASTER I,208,14.6,707,103,604,eune
164,BarneyStinsonGG,MASTER I,203,16.8,493,83,410,eune
165,ziyoumowang,MASTER I,200,28.9,142,41,101,eune
166,sdR,MASTER I,196,18.6,440,82,358,eune
167,Petrusxa030,MASTER I,187,17.0,312,53,259,eune
168,0rchide,MASTER I,186,14.0,444,62,382,eune
169,baobaowo,MASTER I,185,13.5,251,34,217,eune
170,D1e With Me,MASTER I,184,14.4,443,64,379,eune
171,KarnageTheCrane,MASTER I,183,13.3,286,38,248,eune
172,FuriatZ,MASTER I,182,19.8,247,49,198,eune
173,Unlucky Team,MASTER I,179,15.9,188,30,158,eune
174,IceButcher,MASTER I,178,14.2,260,37,223,eune
175,asd110,MASTER I,176,15.8,596,94,502,eune
176,l StreamR l,MASTER I,175,17.4,478,83,395,eune
177,tego typu,MASTER I,174,21.5,149,32,117,eune
178,fangshen,MASTER I,168,17.7,220,39,181,eune
179,Caramyx,MASTER I,167,14.0,450,63,387,eune
180,Hari,MASTER I,167,16.9,136,23,113,eune
181,lidayea,MASTER I,163,14.8,277,41,236,eune
182,shenchao1,MASTER I,157,21.3,230,49,181,eune
183,Razyo,MASTER I,157,16.5,273,45,228,eune
184,chaojisaiyaren,MASTER I,156,24.1,166,40,126,eune
185,LTUGAMER,MASTER I,154,15.9,226,36,190,eune
186,jg díff,MASTER I,152,20.3,261,53,208,eune
187,shalockkrie,MASTER I,152,19.0,179,34,145,eune
188,LetoMallory7,MASTER I,151,12.9,629,81,548,eune
189,SS Srpska Mafija,MASTER I,151,6.5,890,58,832,eune
190,huawuyan,MASTER I,150,16.0,169,27,142,eune
191,Mattinyehedarhed,MASTER I,149,24.2,157,38,119,eune
192,OSG Legend,MASTER I,149,16.3,227,37,190,eune
193,ismeNVT,MASTER I,148,11.8,304,36,268,eune
194,plotak,MASTER I,147,20.5,185,38,147,eune
195,1Hadez2,MASTER I,147,16.1,205,33,172,eune
196,sixoutofsix,MASTER I,147,15.7,198,31,167,eune
197,dlskssss,MASTER I,143,24.4,135,33,102,eune
198,ALEXPOTTERZ,MASTER I,143,15.2,197,30,167,eune
199,songtongyu,MASTER I,142,19.4,144,28,116,eune
200,CoLdQQ,MASTER I,139,15.8,152,24,128,eune
201,Tizy,MASTER I,138,19.8,258,51,207,eune
202,johnniedrake,MASTER I,137,23.2,589,137,452,eune
203,lizhijian,MASTER I,137,17.5,114,20,94,eune
204,Lethal Presencee,MASTER I,135,15.3,419,64,355,eune
205,Alfa Bard,MASTER I,135,23.5,149,35,114,eune
206,PigvCarry,MASTER I,135,12.6,253,32,221,eune
207,qiong1v7,MASTER I,133,24.4,197,48,149,eune
208,Paljo,MASTER I,133,17.6,165,29,136,eune
209,Life Priority,MASTER I,132,17.1,204,35,169,eune
210,o kalos NOE,MASTER I,131,19.5,307,60,247,eune
211,Smith 40i4,MASTER I,130,15.4,390,60,330,eune
212,Szymán,MASTER I,130,15.2,230,35,195,eune
213,theshy1994,MASTER I,129,20.7,135,28,107,eune
214,Czo Tén Master,MASTER I,129,14.1,198,28,170,eune
215,Jeckey Chen,MASTER I,128,17.6,573,101,472,eune
216,Hajzen ˉ,MASTER I,127,28.0,107,30,77,eune
217,kobe24and8,MASTER I,126,16.4,385,63,322,eune
218,MiNo22,MASTER I,126,14.7,245,36,209,eune
219,wiiiii,MASTER I,126,12.0,259,31,228,eune
220,vghjkijnm,MASTER I,125,30.6,85,26,59,eune
221,Mesh Shayfak,MASTER I,124,15.1,677,102,575,eune
222,Krecik x13,MASTER I,122,17.9,145,26,119,eune
223,faker1209,MASTER I,120,19.0,447,85,362,eune
224,MiNo21,MASTER I,120,17.6,289,51,238,eune
225,one shot shaco,MASTER I,119,16.6,332,55,277,eune
226,BT Treide1,MASTER I,118,16.6,283,47,236,eune
227,tiesIgnas,MASTER I,117,12.1,521,63,458,eune
228,Ginoooooo,MASTER I,117,16.7,204,34,170,eune
229,Apa,MASTER I,117,13.7,183,25,158,eune
230,wanghaominws,MASTER I,116,18.3,251,46,205,eune
231,joy761c,MASTER I,115,20.8,212,44,168,eune
232,Ex Samurai,MASTER I,114,20.0,370,74,296,eune
233,felicia999,MASTER I,114,20.7,174,36,138,eune
234,shou7810,MASTER I,113,17.0,153,26,127,eune
235,hdjehhdjw,MASTER I,112,18.2,242,44,198,eune
236,Sbgogogo,MASTER I,112,22.4,165,37,128,eune
237,Mvp UnFeeLer,MASTER I,111,20.5,273,56,217,eune
238,YanYanzzZ,MASTER I,109,21.9,187,41,146,eune
239,Bluntzkri3g420,MASTER I,108,15.6,397,62,335,eune
240,wangyinghui,MASTER I,107,23.5,98,23,75,eune
241,Biaaaaaaaatch,MASTER I,106,13.8,384,53,331,eune
242,Jiangyw888,MASTER I,105,14.1,377,53,324,eune
243,uzirrr,MASTER I,105,18.2,253,46,207,eune
244,Voltisz,MASTER I,104,14.2,444,63,381,eune
245,Foreverstar2,MASTER I,104,23.0,239,55,184,eune
246,Ykxnbo,MASTER I,103,18.9,217,41,176,eune
247,Mingminghenaini,MASTER I,102,24.1,116,28,88,eune
248,The Balla,MASTER I,100,12.9,409,53,356,eune
249,china55open,MASTER I,100,31.8,107,34,73,eune
250,ShadoωMoon,MASTER I,99,15.3,412,63,349,eune
251,GetHoooked,MASTER I,99,12.6,278,35,243,eune
252,Aethna,MASTER I,96,12.9,836,108,728,eune
253,dreamslang,MASTER I,96,17.4,207,36,171,eune
254,icehit,MASTER I,95,13.3,1003,134,869,eune
255,LEonnaxi,MASTER I,94,20.6,267,55,212,eune
256,the blackcok,MASTER I,93,21.1,227,48,179,eune
257,laonazaici,MASTER I,93,14.7,232,34,198,eune
258,xieming999,MASTER I,93,14.7,190,28,162,eune
259,xiaoshirui,MASTER I,91,22.2,171,38,133,eune
260,JJiusan,MASTER I,90,17.9,235,42,193,eune
261,llllllssh,MASTER I,89,23.4,274,64,210,eune
262,gvfgrh4,MASTER I,89,17.8,230,41,189,eune
263,Irôn Sägitta,MASTER I,89,27.9,93,26,67,eune
264,hucanwei,MASTER I,88,24.7,223,55,168,eune
265,chen2017,MASTER I,88,17.2,290,50,240,eune
266,penxuel,MASTER I,86,17.2,395,68,327,eune
267,suhaidashuaige,MASTER I,84,22.0,382,84,298,eune
268,UbicaHer0 No1,MASTER I,83,15.4,214,33,181,eune
269,17zhangpaiNMW,MASTER I,82,18.2,121,22,99,eune
270,WojtoszGG,MASTER I,81,17.1,492,84,408,eune
271,lplGOOD,MASTER I,81,16.4,244,40,204,eune
272,PantherBlood,MASTER I,80,15.0,540,81,459,eune
273,Eyez On mE,MASTER I,79,18.4,575,106,469,eune
274,Sòt,MASTER I,79,19.5,210,41,169,eune
275,Hemaaa,MASTER I,79,27.4,102,28,74,eune
276,dang23,MASTER I,79,20.8,130,27,103,eune
277,dapianke,MASTER I,79,18.0,150,27,123,eune
278,yundingfapaiyuan,MASTER I,78,16.5,272,45,227,eune
279,fange666,MASTER I,78,23.4,107,25,82,eune
280,mosszhou,MASTER I,77,16.8,352,59,293,eune
281,Female XD,MASTER I,76,16.0,648,104,544,eune
282,Erik0 MDMA,MASTER I,76,18.4,434,80,354,eune
283,zhukerong111,MASTER I,76,19.0,247,47,200,eune
284,Róach,MASTER I,75,18.1,365,66,299,eune
285,CW Arrow,MASTER I,75,25.7,144,37,107,eune
286,defouy,MASTER I,75,18.5,157,29,128,eune
287,linyinyin,MASTER I,74,11.8,485,57,428,eune
288,lyy0202,MASTER I,74,15.1,232,35,197,eune
289,SupriZ,MASTER I,74,13.8,247,34,213,eune
290,wanbaoliu,MASTER I,72,16.7,311,52,259,eune
291,Kayle Upton,MASTER I,72,10.2,412,42,370,eune
292,theq123,MASTER I,72,18.1,171,31,140,eune
293,AllSkillNoLuck8,MASTER I,72,18.4,163,30,133,eune
294,mid łane banter,MASTER I,71,21.7,226,49,177,eune
295,fts21,MASTER I,69,19.5,339,66,273,eune
296,laughinglx,MASTER I,68,16.7,203,34,169,eune
297,qp2o2oqp,MASTER I,68,22.5,111,25,86,eune
298,loveLD,MASTER I,68,25.5,94,24,70,eune
299,hi8823,MASTER I,68,19.5,123,24,99,eune
300,Saimonald,MASTER I,67,16.7,276,46,230,eune
301,PIka pUUU,MASTER I,66,13.7,300,41,259,eune
302,ImmolatePL,MASTER I,65,16.9,414,70,344,eune
303,nóChance,MASTER I,65,15.2,433,66,367,eune
304,Stavv,MASTER I,65,18.3,218,40,178,eune
305,axuandog,MASTER I,65,28.6,98,28,70,eune
306,Niziurski,MASTER I,63,13.7,342,47,295,eune
307,haaaayugcr,MASTER I,63,16.3,190,31,159,eune
308,dadal0ng,MASTER I,63,16.5,176,29,147,eune
309,WarlordVengeance,MASTER I,62,13.3,233,31,202,eune
310,uzi1213800,MASTER I,62,32.2,93,30,63,eune
311,Neebo,MASTER I,61,17.7,220,39,181,eune
312,Bad High Roller,MASTER I,61,9.5,221,21,200,eune
313,kst123l,MASTER I,61,16.1,118,19,99,eune
314,SP00KK,MASTER I,60,15.6,681,106,575,eune
315,iximaaa,MASTER I,60,19.5,215,42,173,eune
316,ibananao,MASTER I,59,18.0,350,63,287,eune
317,ice12316,MASTER I,58,21.1,123,26,97,eune
318,RRandomNoob,MASTER I,57,19.8,303,60,243,eune
319,aerodynamicc,MASTER I,57,18.8,288,54,234,eune
320,qqsxxeesd,MASTER I,57,18.9,217,41,176,eune
321,justgomidlane,MASTER I,56,11.6,311,36,275,eune
322,Tarosch,MASTER I,56,16.9,171,29,142,eune
323,bukzna,MASTER I,55,17.5,137,24,113,eune
324,dafengxiongdi,MASTER I,55,21.4,98,21,77,eune
325,baobazhengqi111,MASTER I,55,31.7,63,20,43,eune
326,shaodong,MASTER I,54,13.4,321,43,278,eune
327,sowilo,MASTER I,54,13.7,291,40,251,eune
328,Blackspy48,MASTER I,54,14.7,184,27,157,eune
329,darksin555,MASTER I,53,15.7,331,52,279,eune
330,haopi99,MASTER I,53,19.1,204,39,165,eune
331,Zz52000,MASTER I,53,19.3,166,32,134,eune
332,Hi Im Laure,MASTER I,53,17.6,182,32,150,eune
333,854576720,MASTER I,53,22.1,140,31,109,eune
334,IonlyPlayEvelynn,MASTER I,53,36.7,79,29,50,eune
335,Dethrook,MASTER I,52,22.1,357,79,278,eune
336,IMakeTheRules13,MASTER I,52,11.1,432,48,384,eune
337,antinshhbs,MASTER I,52,24.6,114,28,86,eune
338,OGoneas1sas,MASTER I,52,31.1,74,23,51,eune
339,timifater,MASTER I,51,11.6,302,35,267,eune
340,chinajiangliuer,MASTER I,51,23.0,126,29,97,eune
341,NguyenAn,MASTER I,50,21.3,437,93,344,eune
342,muppymupp,MASTER I,50,22.8,149,34,115,eune
343,Goodjkbad,MASTER I,50,19.8,162,32,130,eune
344,xia555,MASTER I,49,14.5,207,30,177,eune
345,Toxic and Salty,MASTER I,49,20.8,106,22,84,eune
346,wddmw111,MASTER I,48,20.0,230,46,184,eune
347,helllok,MASTER I,48,21.1,194,41,153,eune
348,jhghgh,MASTER I,48,22.2,126,28,98,eune
349,Yuu Noya,MASTER I,48,27.6,76,21,55,eune
350,manancasuflete,MASTER I,47,17.1,338,58,280,eune
351,douyu696,MASTER I,47,21.7,184,40,144,eune
352,rainisnice,MASTER I,46,16.4,231,38,193,eune
353,DDlittleTsu,MASTER I,46,24.2,95,23,72,eune
354,wusuo9,MASTER I,45,17.4,207,36,171,eune
355,Hamootz,MASTER I,44,24.9,329,82,247,eune
356,ACIDONIN,MASTER I,43,18.9,233,44,189,eune
357,BesJhin,MASTER I,42,24.8,121,30,91,eune
358,Wacho,MASTER I,41,19.4,485,94,391,eune
359,kasux,MASTER I,41,26.1,211,55,156,eune
360,yyyyyygx,MASTER I,41,14.3,175,25,150,eune
361,SER,MASTER I,40,16.0,363,58,305,eune
362,fortepiańino,MASTER I,40,26.0,146,38,108,eune
363,huanghaitao,MASTER I,40,14.9,141,21,120,eune
364,Thrae,MASTER I,39,23.3,494,115,379,eune
365,JustÁbro,MASTER I,39,20.8,289,60,229,eune
366,Stephen Càrry,MASTER I,39,17.7,231,41,190,eune
367,chuangzao0o,MASTER I,39,20.5,151,31,120,eune
368,petskuthuder,MASTER I,38,16.1,521,84,437,eune
369,AJunii,MASTER I,38,19.9,156,31,125,eune
370,Aplytos,MASTER I,37,13.0,439,57,382,eune
371,Høwto1v9,MASTER I,37,10.2,157,16,141,eune
372,Maaczka,MASTER I,36,15.0,319,48,271,eune
373,Disguised omak,MASTER I,36,16.4,268,44,224,eune
374,playgosha,MASTER I,34,12.8,758,97,661,eune
375,BlackCats,MASTER I,34,13.9,518,72,446,eune
376,Shean19,MASTER I,34,11.0,571,63,508,eune
377,SoJeon,MASTER I,34,8.4,639,54,585,eune
378,Aryasfanboy,MASTER I,34,13.2,357,47,310,eune
379,ST oRO,MASTER I,34,12.3,261,32,229,eune
380,liminghui,MASTER I,33,18.3,273,50,223,eune
381,Monkey D Luf,MASTER I,33,18.6,226,42,184,eune
382,2D over 3D,MASTER I,33,11.9,293,35,258,eune
383,xiangshiyurenhai,MASTER I,32,15.5,335,52,283,eune
384,Sunserein,MASTER I,32,15.2,290,44,246,eune
385,wojiu20limi,MASTER I,32,22.0,186,41,145,eune
386,Mine is Bigger,MASTER I,32,21.6,97,21,76,eune
387,nousernamesleft,MASTER I,31,15.7,287,45,242,eune
388,nikollaje,MASTER I,30,21.1,397,84,313,eune
389,xxN0N4M3xx,MASTER I,30,24.4,238,58,180,eune
390,IchibanEnjo,MASTER I,30,15.2,178,27,151,eune
391,Stub3000,MASTER I,30,13.8,152,21,131,eune
392,EternalSidd,MASTER I,29,15.5,650,101,549,eune
393,Cormag,MASTER I,29,21.1,213,45,168,eune
394,YeGuang,MASTER I,29,14.6,240,35,205,eune
395,Champzyme,MASTER I,28,17.0,482,82,400,eune
396,Ròot,MASTER I,28,10.2,439,45,394,eune
397,Tsükuyomi,MASTER I,28,13.4,276,37,239,eune
398,Leaguereaper,MASTER I,27,15.8,310,49,261,eune
399,abclulu,MASTER I,27,23.1,130,30,100,eune
400,ffqaqpp,MASTER I,26,15.7,236,37,199,eune
401,Mr Hops,MASTER I,26,7.6,475,36,439,eune
402,Mikæla,MASTER I,26,22.8,149,34,115,eune
403,FL Baby xQi,MASTER I,26,15.0,180,27,153,eune
404,Th3 Kiling Jok3r,MASTER I,25,18.0,416,75,341,eune
405,ghostcc,MASTER I,25,18.5,270,50,220,eune
406,fix this bug pls,MASTER I,25,15.4,324,50,274,eune
407,Sói Ca,MASTER I,25,17.3,277,48,229,eune
408,Xilzao,MASTER I,25,19.2,224,43,181,eune
409,pig8trotters,MASTER I,25,20.1,179,36,143,eune
410,Lord of jugle,MASTER I,25,10.1,286,29,257,eune
411,Abed,MASTER I,24,13.6,572,78,494,eune
412,lourio,MASTER I,24,13.8,522,72,450,eune
413,EG Tropical,MASTER I,24,17.3,404,70,334,eune
414,IasikI,MASTER I,24,18.1,371,67,304,eune
415,withboy,MASTER I,24,11.0,508,56,452,eune
416,Jollteon,MASTER I,23,14.8,541,80,461,eune
417,To Mauro Louki,MASTER I,23,12.3,617,76,541,eune
418,SJ tft dude,MASTER I,23,15.8,285,45,240,eune
419,biggie3,MASTER I,23,18.4,217,40,177,eune
420,aaalp96,MASTER I,23,26.7,135,36,99,eune
421,UNleash the Fury,MASTER I,23,17.4,149,26,123,eune
422,BØüZz,MASTER I,23,18.8,128,24,104,eune
423,Achy88,MASTER I,22,14.0,494,69,425,eune
424,shenchao6666,MASTER I,22,25.2,147,37,110,eune
425,522131,MASTER I,22,20.9,158,33,125,eune
426,Yulicc,MASTER I,22,17.9,173,31,142,eune
427,Houziee,MASTER I,22,20.7,145,30,115,eune
428,Joul,MASTER I,22,13.4,201,27,174,eune
429,zuandiyishangdan,MASTER I,22,19.5,133,26,107,eune
430,moving300money,MASTER I,22,16.7,144,24,120,eune
431,pujsapepa,MASTER I,21,21.2,367,78,289,eune
432,Nyxfire,MASTER I,21,17.4,373,65,308,eune
433,ThinkGlobal,MASTER I,21,15.5,386,60,326,eune
434,kongchao123,MASTER I,21,15.0,333,50,283,eune
435,Zivotinja,MASTER I,21,14.8,277,41,236,eune
436,MoNtEnEgReEn,MASTER I,21,16.1,242,39,203,eune
437,Dominator17,MASTER I,21,14.3,231,33,198,eune
438,xiaotian1,MASTER I,21,23.5,136,32,104,eune
439,ValkyrieSHD,MASTER I,21,15.3,176,27,149,eune
440,Mr Freskos,MASTER I,19,14.1,347,49,298,eune
441,Keres Heres,MASTER I,19,10.3,448,46,402,eune
442,super33jwy,MASTER I,19,16.4,256,42,214,eune
443,maxiaohui,MASTER I,19,15.4,214,33,181,eune
444,tieshansfather,MASTER I,19,17.7,158,28,130,eune
445,K1nGsane,MASTER I,18,28.8,226,65,161,eune
446,Hulanka Esport,MASTER I,18,13.0,184,24,160,eune
447,xiaoxuanl,MASTER I,18,19.5,118,23,95,eune
448,NewFlopy,MASTER I,17,11.8,592,70,522,eune
449,lIlIlIlIorz,MASTER I,17,18.3,268,49,219,eune
450,BERKOVICH,MASTER I,17,10.9,338,37,301,eune
451,xinku1e,MASTER I,17,18.2,181,33,148,eune
452,callmezd,MASTER I,17,15.1,152,23,129,eune
453,In Too Deep,MASTER I,16,14.7,762,112,650,eune
454,Tuken19,MASTER I,16,20.2,198,40,158,eune
455,Trapdub,MASTER I,16,16.4,152,25,127,eune
456,LcS MiRiFiQuE,MASTER I,15,13.2,521,69,452,eune
457,xRaTaTA,MASTER I,15,22.4,236,53,183,eune
458,WildWestCactus,MASTER I,15,10.1,525,53,472,eune
459,GT Wei,MASTER I,15,17.0,229,39,190,eune
460,szTFTko,MASTER I,15,15.6,173,27,146,eune
461,1122334466,MASTER I,15,17.7,147,26,121,eune
462,Archmage,MASTER I,15,29.1,79,23,56,eune
463,Celtaxe,MASTER I,14,15.0,294,44,250,eune
464,VermilIion,MASTER I,14,16.2,234,38,196,eune
465,baifeihe,MASTER I,14,18.4,147,27,120,eune
466,LuZErTX,MASTER I,14,16.3,129,21,108,eune
467,skdcee,MASTER I,13,16.4,281,46,235,eune
468,Vicvicv,MASTER I,13,33.3,114,38,76,eune
469,KnifePartyEMD,MASTER I,12,14.7,662,97,565,eune
470,F1Neee,MASTER I,12,15.3,478,73,405,eune
471,AnubiS Inpu,MASTER I,12,11.7,402,47,355,eune
472,Kubańczy,MASTER I,12,18.3,224,41,183,eune
473,6hhh6bbb,MASTER I,12,19.8,101,20,81,eune
474,Poporori,MASTER I,11,12.0,593,71,522,eune
475,Dark of Death,MASTER I,11,17.5,343,60,283,eune
476,Rank1OrDeath,MASTER I,11,14.5,345,50,295,eune
477,Nikumarekko,MASTER I,11,17.9,262,47,215,eune
478,guaguajiang,MASTER I,11,16.2,210,34,176,eune
479,7454088,MASTER I,11,26.9,108,29,79,eune
480,morzers,MASTER I,11,25.5,98,25,73,eune
481,ZWG0817,MASTER I,10,19.6,285,56,229,eune
482,Erøs,MASTER I,10,17.4,235,41,194,eune
483,YshenA,MASTER I,10,18.4,158,29,129,eune
484,haonaodan,MASTER I,10,16.8,173,29,144,eune
485,iPolaczek,MASTER I,10,11.1,190,21,169,eune
486,fuki30,MASTER I,10,10.8,195,21,174,eune
487,Cant Touch Dis,MASTER I,9,17.1,591,101,490,eune
488,zmy0000,MASTER I,9,19.0,331,63,268,eune
489,PoistMussy,MASTER I,9,22.4,241,54,187,eune
490,Cazamatu,MASTER I,9,16.6,229,38,191,eune
491,Cpt Sonny,MASTER I,9,16.4,214,35,179,eune
492,cff1234,MASTER I,9,16.3,215,35,180,eune
493,LegìtJJ,MASTER I,9,18.1,171,31,140,eune
494,HzTeiry,MASTER I,9,12.3,252,31,221,eune
495,BixLegolas21,MASTER I,9,16.5,121,20,101,eune
496,Trix4Loki,MASTER I,8,14.9,571,85,486,eune
497,Napaljenko,MASTER I,8,16.2,432,70,362,eune
498,Spirit Devilll,MASTER I,8,18.2,263,48,215,eune
499,zhazhahui,MASTER I,8,20.9,148,31,117,eune
500,kepikarios,MASTER I,8,15.9,157,25,132,eune
1,Deis1k,CHALLENGER I,1710,21.4,639,137,502,euw
2,Salvyyy,CHALLENGER I,1672,23.8,282,67,215,euw
3,Salvyyy TFT,CHALLENGER I,1659,24.7,384,95,289,euw
4,DarkHighroll,CHALLENGER I,1569,22.8,430,98,332,euw
5,l2yKo,CHALLENGER I,1428,21.6,1250,270,980,euw
6,DarkHydra,CHALLENGER I,1378,21.3,582,124,458,euw
7,SwellerTiger,CHALLENGER I,1327,19.1,387,74,313,euw
8,Gìngg,CHALLENGER I,1322,25.1,327,82,245,euw
9,Voltariusx,CHALLENGER I,1297,18.6,431,80,351,euw
10,Leon Trotskij,CHALLENGER I,1269,24.0,338,81,257,euw
11,GingGG,CHALLENGER I,1232,22.1,742,164,578,euw
12,SwellerTigerTFT,CHALLENGER I,1197,13.2,646,85,561,euw
13,ImSøFresh,CHALLENGER I,1191,17.7,879,156,723,euw
14,Lallana,CHALLENGER I,1179,18.7,369,69,300,euw
15,Hotline ming,CHALLENGER I,1165,16.0,782,125,657,euw
16,Tcejer,CHALLENGER I,1158,21.0,352,74,278,euw
17,Kagerou OwO,CHALLENGER I,1148,21.2,430,91,339,euw
18,Voltariux,CHALLENGER I,1145,17.7,515,91,424,euw
19,fan2Kstagne,CHALLENGER I,1137,22.6,195,44,151,euw
20,FluffyHS,CHALLENGER I,1087,17.4,403,70,333,euw
21,Un33d,CHALLENGER I,1070,17.4,674,117,557,euw
22,Sunny Lu,CHALLENGER I,1068,17.7,955,169,786,euw
23,Luque,CHALLENGER I,1049,17.4,814,142,672,euw
24,Qetzer,CHALLENGER I,1025,15.5,670,104,566,euw
25,Liquid Tabzz,CHALLENGER I,1012,22.0,558,123,435,euw
26,Lipo Razak,CHALLENGER I,1010,16.6,547,91,456,euw
27,Phbl,CHALLENGER I,1007,14.1,679,96,583,euw
28,Sologesang,CHALLENGER I,988,14.9,583,87,496,euw
29,Sñus,CHALLENGER I,985,18.6,1185,221,964,euw
30,Wet Jungler,CHALLENGER I,957,15.0,686,103,583,euw
31,Phabal,CHALLENGER I,955,14.3,657,94,563,euw
32,Pazi4S,CHALLENGER I,949,12.1,487,59,428,euw
33,Sbstn TFT,CHALLENGER I,932,14.5,538,78,460,euw
34,RyKo v2,CHALLENGER I,929,25.4,323,82,241,euw
35,SmileyCereal,CHALLENGER I,928,17.7,1106,196,910,euw
36,BozzBrain v2,CHALLENGER I,896,14.7,340,50,290,euw
37,AceofSpadesITA,CHALLENGER I,886,19.0,348,66,282,euw
38,Deisik,CHALLENGER I,870,18.9,364,69,295,euw
39,BenVK,CHALLENGER I,869,16.3,619,101,518,euw
40,ll TFT KEKW ll,CHALLENGER I,864,14.4,438,63,375,euw
41,Magarky,CHALLENGER I,859,16.5,509,84,425,euw
42,Raizuken,CHALLENGER I,857,18.3,371,68,303,euw
43,Lev D Trotskij,CHALLENGER I,855,17.8,518,92,426,euw
44,iHG Tuttek,CHALLENGER I,841,16.3,738,120,618,euw
45,kassellen,CHALLENGER I,839,13.4,958,128,830,euw
46,TSM Guillosko,CHALLENGER I,828,15.6,868,135,733,euw
47,outplayingmyself,CHALLENGER I,826,17.7,457,81,376,euw
48,sayvallahbru,CHALLENGER I,819,14.7,389,57,332,euw
49,Iunci,CHALLENGER I,817,17.7,215,38,177,euw
50,slime03,CHALLENGER I,804,17.4,536,93,443,euw
51,IBRAHIMOVIĆ777,CHALLENGER I,788,26.1,211,55,156,euw
52,lsochan,CHALLENGER I,787,16.7,281,47,234,euw
53,Monphis,CHALLENGER I,785,16.4,1208,198,1010,euw
54,Sizm,CHALLENGER I,781,19.5,727,142,585,euw
55,lucky smile boy,CHALLENGER I,771,15.7,1192,187,1005,euw
56,TFT ArKoK,CHALLENGER I,769,15.7,890,140,750,euw
57,Sparakay TFT,CHALLENGER I,766,15.6,262,41,221,euw
58,ahuia,CHALLENGER I,762,20.1,219,44,175,euw
59,PonRoo,CHALLENGER I,761,12.5,1025,128,897,euw
60,Palaloa,CHALLENGER I,758,16.4,244,40,204,euw
61,RICH H0MIE QUAN,CHALLENGER I,753,15.0,286,43,243,euw
62,TFT Buttons,CHALLENGER I,744,16.0,581,93,488,euw
63,Just so xi so,CHALLENGER I,738,18.8,313,59,254,euw
64,BeasTFT2,CHALLENGER I,736,19.6,204,40,164,euw
65,TehSilli,CHALLENGER I,735,19.6,403,79,324,euw
66,Kezman,CHALLENGER I,731,19.7,340,67,273,euw
67,Doud78,CHALLENGER I,728,17.8,325,58,267,euw
68,Zyriosly,CHALLENGER I,725,16.7,902,151,751,euw
69,Tits,CHALLENGER I,719,24.3,230,56,174,euw
70,ajoe1231,CHALLENGER I,718,17.5,810,142,668,euw
71,Khristor,CHALLENGER I,716,14.9,397,59,338,euw
72,Lorus,CHALLENGER I,715,9.1,737,67,670,euw
73,Cachual,CHALLENGER I,715,25.6,219,56,163,euw
74,Zididi,CHALLENGER I,714,15.9,1492,237,1255,euw
75,RazakTFT,CHALLENGER I,713,15.0,1067,160,907,euw
76,JdnTagNovoline,CHALLENGER I,712,20.6,194,40,154,euw
77,Banisher95,CHALLENGER I,711,13.5,488,66,422,euw
78,Palaloa TFT,CHALLENGER I,710,12.9,471,61,410,euw
79,iamTLT,CHALLENGER I,709,12.5,320,40,280,euw
80,dknsbs,CHALLENGER I,708,15.9,552,88,464,euw
81,Göl D Roger,CHALLENGER I,704,12.7,805,102,703,euw
82,Bèst Heca EUW,CHALLENGER I,696,17.8,1343,239,1104,euw
83,Némaïdès,CHALLENGER I,695,14.2,613,87,526,euw
84,Sayorï best girl,CHALLENGER I,695,17.4,242,42,200,euw
85,rare not nice,CHALLENGER I,689,15.4,579,89,490,euw
86,BALOTELLI777,CHALLENGER I,687,18.6,531,99,432,euw
87,Ev4ngelion,CHALLENGER I,680,16.5,701,116,585,euw
88,Rïft,CHALLENGER I,680,16.0,225,36,189,euw
89,Can I mock you,CHALLENGER I,679,29.6,135,40,95,euw
90,Freezzette,CHALLENGER I,677,12.1,638,77,561,euw
91,o0OLyReO0o,CHALLENGER I,675,20.1,288,58,230,euw
92,Can I trust you,CHALLENGER I,674,20.4,280,57,223,euw
93,MogamboDTB,CHALLENGER I,673,12.4,289,36,253,euw
94,TarteMan TFT,CHALLENGER I,667,14.9,455,68,387,euw
95,Xeno TFTx,CHALLENGER I,666,10.3,778,80,698,euw
96,TFT Enzosexe,CHALLENGER I,662,12.2,879,107,772,euw
97,NinjaPavels,CHALLENGER I,662,17.4,299,52,247,euw
98,Un11d,CHALLENGER I,657,17.9,340,61,279,euw
99,AmuuMuu,CHALLENGER I,656,12.0,1055,127,928,euw
100,Drunkiris,CHALLENGER I,651,20.0,300,60,240,euw
101,PUNISH1nG,CHALLENGER I,648,18.0,283,51,232,euw
102,Drünkiris,CHALLENGER I,646,19.4,427,83,344,euw
103,Vicer v2,CHALLENGER I,646,15.1,305,46,259,euw
104,5454,CHALLENGER I,645,14.9,510,76,434,euw
105,Gôn Freeçss,CHALLENGER I,645,20.9,273,57,216,euw
106,BALOTELLI777 TFT,CHALLENGER I,641,15.8,448,71,377,euw
107,Waazabii,CHALLENGER I,641,19.9,191,38,153,euw
108,LeDuck TFT,CHALLENGER I,640,16.9,1138,193,945,euw
109,Adonis17,CHALLENGER I,638,16.7,774,129,645,euw
110,OnlyBetter,CHALLENGER I,638,10.0,411,41,370,euw
111,iPoPz v2,CHALLENGER I,637,19.0,210,40,170,euw
112,Yanís,CHALLENGER I,635,16.1,409,66,343,euw
113,Doud TFT,CHALLENGER I,629,20.7,232,48,184,euw
114,AKA magic,CHALLENGER I,627,12.9,758,98,660,euw
115,JedenTagNovoline,CHALLENGER I,626,23.6,191,45,146,euw
116,IceLoom,CHALLENGER I,625,17.8,241,43,198,euw
117,Oooouuiiiiiiii,CHALLENGER I,624,16.6,531,88,443,euw
118,Xerxan,CHALLENGER I,618,15.0,672,101,571,euw
119,Suisaiga 2,CHALLENGER I,614,17.3,416,72,344,euw
120,Itario,CHALLENGER I,613,12.8,447,57,390,euw
121,kacpersky191TFT,CHALLENGER I,611,14.2,857,122,735,euw
122,YowiTFT,CHALLENGER I,611,20.6,247,51,196,euw
123,Jedi Master AK,CHALLENGER I,606,16.4,939,154,785,euw
124,WINZEEER,CHALLENGER I,606,14.8,725,107,618,euw
125,Kjekken123,CHALLENGER I,606,19.9,508,101,407,euw
126,Zebra TFT,CHALLENGER I,604,17.8,163,29,134,euw
127,always be hape,CHALLENGER I,602,17.5,378,66,312,euw
128,Bränk,CHALLENGER I,600,15.6,463,72,391,euw
129,MCMCinITALY,CHALLENGER I,599,18.5,491,91,400,euw
130,Miiouw,CHALLENGER I,598,14.5,517,75,442,euw
131,Skiizield,CHALLENGER I,596,13.4,982,132,850,euw
132,Nutscrackeros,CHALLENGER I,594,15.3,229,35,194,euw
133,HASHIDA,CHALLENGER I,592,14.0,722,101,621,euw
134,Kÿu,CHALLENGER I,591,17.3,405,70,335,euw
135,LeDuck v2,CHALLENGER I,589,15.3,437,67,370,euw
136,ABEL748,CHALLENGER I,587,12.9,418,54,364,euw
137,Nescro,CHALLENGER I,586,15.7,407,64,343,euw
138,Liber8 Hong Kong,CHALLENGER I,585,17.5,486,85,401,euw
139,idlemonk TFT,CHALLENGER I,583,10.8,618,67,551,euw
140,Warmeur le vrai,CHALLENGER I,582,22.9,223,51,172,euw
141,LIPO Absykos,CHALLENGER I,581,14.7,401,59,342,euw
142,Racklure,CHALLENGER I,580,14.4,909,131,778,euw
143,Tatufo,CHALLENGER I,577,14.1,582,82,500,euw
144,Subahibi,CHALLENGER I,577,14.7,434,64,370,euw
145,I R INVINC1BLE,CHALLENGER I,575,15.1,736,111,625,euw
146,Nyan Zebra,CHALLENGER I,575,16.3,252,41,211,euw
147,stayl23,CHALLENGER I,573,13.8,478,66,412,euw
148,dirtyspear,CHALLENGER I,566,15.3,482,74,408,euw
149,Kenopsia,CHALLENGER I,565,10.1,883,89,794,euw
150,KAD Mason,CHALLENGER I,563,16.5,284,47,237,euw
151,hongmorongguang,CHALLENGER I,561,18.1,353,64,289,euw
152,zomgowy,CHALLENGER I,561,17.5,234,41,193,euw
153,NouLTerass,CHALLENGER I,561,16.8,232,39,193,euw
154,TeemoDaSlayer420,CHALLENGER I,560,20.9,177,37,140,euw
155,Bersalis,CHALLENGER I,557,15.9,326,52,274,euw
156,Summuner Name,CHALLENGER I,556,19.4,289,56,233,euw
157,Sløt,CHALLENGER I,556,17.4,316,55,261,euw
158,VicerTFT,CHALLENGER I,554,15.6,443,69,374,euw
159,5454XD,CHALLENGER I,552,16.9,544,92,452,euw
160,Zaratuska,CHALLENGER I,552,16.1,448,72,376,euw
161,G2 ReventXz,CHALLENGER I,552,20.8,303,63,240,euw
162,męntal,CHALLENGER I,549,13.4,543,73,470,euw
163,Esel51,CHALLENGER I,549,11.7,386,45,341,euw
164,TFT Emperador,CHALLENGER I,548,13.4,892,120,772,euw
165,The Gay Minion,CHALLENGER I,547,13.5,636,86,550,euw
166,Gilozinho,CHALLENGER I,546,13.4,907,122,785,euw
167,Kirbes,CHALLENGER I,545,14.9,435,65,370,euw
168,FengXiaoQiLing,CHALLENGER I,544,23.3,262,61,201,euw
169,Whiteyeas,CHALLENGER I,536,14.7,339,50,289,euw
170,Sirfetchd,CHALLENGER I,535,10.4,297,31,266,euw
171,JollyFaker777,CHALLENGER I,534,16.1,355,57,298,euw
172,ziro1997,CHALLENGER I,531,16.7,347,58,289,euw
173,Shσtgun,CHALLENGER I,530,15.6,778,121,657,euw
174,Bersa TFT,CHALLENGER I,530,15.9,517,82,435,euw
175,A French Rat,CHALLENGER I,530,15.9,472,75,397,euw
176,At The Gates,CHALLENGER I,529,20.7,300,62,238,euw
177,Whiteyeas2,CHALLENGER I,527,18.2,176,32,144,euw
178,Gunmay,CHALLENGER I,525,9.7,784,76,708,euw
179,Pray to RNG god,CHALLENGER I,523,12.8,297,38,259,euw
180,TFTits,CHALLENGER I,522,19.9,181,36,145,euw
181,Tschabading,CHALLENGER I,519,13.5,865,117,748,euw
182,R1CH HOM1E QUAN,CHALLENGER I,518,18.1,215,39,176,euw
183,YowiTFT2,CHALLENGER I,516,20.7,222,46,176,euw
184,TNG Lucy Chan,CHALLENGER I,514,11.3,912,103,809,euw
185,iPoPz,CHALLENGER I,513,16.4,549,90,459,euw
186,Lornyk,CHALLENGER I,512,14.1,914,129,785,euw
187,yooog,CHALLENGER I,511,14.1,547,77,470,euw
188,TheUnbornYordle,CHALLENGER I,511,13.5,348,47,301,euw
189,Lonnen,CHALLENGER I,510,14.0,535,75,460,euw
190,WawaTatata,CHALLENGER I,509,13.7,554,76,478,euw
191,Sτοrm,CHALLENGER I,507,14.9,740,110,630,euw
192,birdyrrr,CHALLENGER I,506,18.6,242,45,197,euw
193,zoomgowy,CHALLENGER I,504,19.2,224,43,181,euw
194,Cry M0re Plz,CHALLENGER I,503,17.8,647,115,532,euw
195,San Jomian,CHALLENGER I,502,13.1,733,96,637,euw
196,Funkfreed,CHALLENGER I,501,16.1,336,54,282,euw
197,EnlèveTesMoufles,CHALLENGER I,498,17.3,294,51,243,euw
198,RaveeOnTFT,CHALLENGER I,497,12.6,547,69,478,euw
199,KlimA,CHALLENGER I,496,15.9,470,75,395,euw
200,Lelouuch,CHALLENGER I,496,16.5,315,52,263,euw
201,OxygenWhiite,CHALLENGER I,494,15.5,291,45,246,euw
202,Banisher95 TFT,CHALLENGER I,493,12.0,443,53,390,euw
203,PITICHI,CHALLENGER I,491,13.8,1076,149,927,euw
204,gluteus maxímus,CHALLENGER I,491,16.3,387,63,324,euw
205,Futaken,CHALLENGER I,491,16.5,261,43,218,euw
206,Wholean,CHALLENGER I,490,12.3,520,64,456,euw
207,Riƒt,CHALLENGER I,488,13.3,719,96,623,euw
208,Ranceta,CHALLENGER I,488,11.4,554,63,491,euw
209,DrGreenthumb0,CHALLENGER I,487,13.8,435,60,375,euw
210,TXK9z,CHALLENGER I,485,13.0,663,86,577,euw
211,SKT Help Me,CHALLENGER I,485,16.4,512,84,428,euw
212,MapleKK,CHALLENGER I,482,19.7,188,37,151,euw
213,diabifleur,CHALLENGER I,480,14.4,596,86,510,euw
214,Sir Bobz,CHALLENGER I,480,10.6,442,47,395,euw
215,ShinoPavels,CHALLENGER I,478,17.4,602,105,497,euw
216,dameoiseau,CHALLENGER I,477,12.3,267,33,234,euw
217,Emoktua,CHALLENGER I,476,19.6,460,90,370,euw
218,Fofo x jisoo,CHALLENGER I,473,14.8,507,75,432,euw
219,TheAware,CHALLENGER I,473,12.7,553,70,483,euw
220,AquareIIe,CHALLENGER I,473,16.9,325,55,270,euw
221,IIDyonisosII,CHALLENGER I,472,13.6,546,74,472,euw
222,Genotik,CHALLENGER I,472,13.3,465,62,403,euw
223,1puRe Clinton,CHALLENGER I,471,15.2,552,84,468,euw
224,Lahar04,CHALLENGER I,471,18.2,220,40,180,euw
225,Ougie Boogie,CHALLENGER I,469,12.7,623,79,544,euw
226,Sparakay,CHALLENGER I,468,13.9,310,43,267,euw
227,birdy513,CHALLENGER I,466,16.2,684,111,573,euw
228,BenVK TFT,CHALLENGER I,465,16.7,329,55,274,euw
229,RaveeOn,CHALLENGER I,463,13.2,478,63,415,euw
230,OxygenWhiteTFT,CHALLENGER I,463,25.4,177,45,132,euw
231,Smokesick,CHALLENGER I,461,17.0,294,50,244,euw
232,S6767,CHALLENGER I,460,15.0,655,98,557,euw
233,LittlePiggyBF,CHALLENGER I,460,12.3,632,78,554,euw
234,Le inter masqué,CHALLENGER I,460,16.3,325,53,272,euw
235,Rehnz,CHALLENGER I,457,14.7,730,107,623,euw
236,UnbornYordle,CHALLENGER I,457,17.7,491,87,404,euw
237,Woaigouge,CHALLENGER I,456,15.6,752,117,635,euw
238,shiromonster000,CHALLENGER I,456,18.2,385,70,315,euw
239,Stonyy v1,CHALLENGER I,454,14.8,535,79,456,euw
240,TFTACKK,CHALLENGER I,454,26.1,180,47,133,euw
241,Maxwellβoltzman,CHALLENGER I,453,17.1,252,43,209,euw
242,TwTv T3BY,CHALLENGER I,453,14.7,232,34,198,euw
243,AieZen 2,CHALLENGER I,452,10.1,276,28,248,euw
244,TAKETHEHONKPILL,CHALLENGER I,451,12.9,481,62,419,euw
245,YPRN Chwbk,CHALLENGER I,451,18.2,313,57,256,euw
246,DRLAMER,CHALLENGER I,450,17.8,1179,210,969,euw
247,Sweet Nydre,CHALLENGER I,450,19.0,142,27,115,euw
248,Lowlander,CHALLENGER I,448,15.8,298,47,251,euw
249,justinng,CHALLENGER I,447,17.6,386,68,318,euw
250,Warmeur TFT,CHALLENGER I,447,18.2,362,66,296,euw
251,chainpullzEU,CHALLENGER I,447,15.8,177,28,149,euw
252,MuttaGanero,CHALLENGER I,446,16.0,451,72,379,euw
253,hi im hochin,CHALLENGER I,446,16.9,314,53,261,euw
254,Maxobido,CHALLENGER I,445,8.2,1333,110,1223,euw
255,Naotan Mid,CHALLENGER I,445,18.3,317,58,259,euw
256,Alpha Player 2,CHALLENGER I,442,15.7,464,73,391,euw
257,Warmeur,CHALLENGER I,439,16.2,402,65,337,euw
258,DatSharzy,CHALLENGER I,439,14.1,433,61,372,euw
259,Benger923,CHALLENGER I,438,14.2,337,48,289,euw
260,redbyte7GR,CHALLENGER I,438,17.4,264,46,218,euw
261,Snoodyboo,CHALLENGER I,437,14.3,631,90,541,euw
262,hyuII,CHALLENGER I,436,16.7,677,113,564,euw
263,xXD4rkN412uT0Xx,CHALLENGER I,436,24.8,165,41,124,euw
264,ÃFG,CHALLENGER I,435,10.7,531,57,474,euw
265,Fairy Breeder,CHALLENGER I,433,15.3,476,73,403,euw
266,Douyu4228274,CHALLENGER I,433,16.8,316,53,263,euw
267,Love anime boy,CHALLENGER I,432,14.5,476,69,407,euw
268,Wedra TF,CHALLENGER I,432,18.0,189,34,155,euw
269,Smartwings,CHALLENGER I,429,17.5,686,120,566,euw
270,WalktheGangplank,CHALLENGER I,429,12.2,302,37,265,euw
271,MrKok0,CHALLENGER I,427,11.9,644,77,567,euw
272,IWannaRideMyPyke,CHALLENGER I,427,14.1,283,40,243,euw
273,Strawberry fish,CHALLENGER I,426,19.7,350,69,281,euw
274,Ferra4Fun,CHALLENGER I,425,10.2,1201,122,1079,euw
275,luffy57773,CHALLENGER I,425,14.1,745,105,640,euw
276,Mediaboy 2,CHALLENGER I,425,15.7,300,47,253,euw
277,Cute Crab,CHALLENGER I,425,15.5,219,34,185,euw
278,mastameow,CHALLENGER I,424,15.4,299,46,253,euw
279,HagbardSolo,CHALLENGER I,424,20.7,116,24,92,euw
280,simplywojtek tft,CHALLENGER I,423,20.6,213,44,169,euw
281,Paradise For All,CHALLENGER I,422,17.8,382,68,314,euw
282,VAieZen,CHALLENGER I,422,12.1,481,58,423,euw
283,VegaHD,CHALLENGER I,422,12.8,376,48,328,euw
284,TwSS Flash,CHALLENGER I,421,16.7,610,102,508,euw
285,Gelado de Buceta,CHALLENGER I,421,16.3,484,79,405,euw
286,Xarizzz,CHALLENGER I,421,14.1,397,56,341,euw
287,Razayel,CHALLENGER I,419,14.2,451,64,387,euw
288,Rioe,CHALLENGER I,419,16.4,299,49,250,euw
289,Ujo,CHALLENGER I,419,15.5,271,42,229,euw
290,Korra HD,CHALLENGER I,415,26.0,127,33,94,euw
291,Nyu Zmurf,CHALLENGER I,414,13.0,338,44,294,euw
292,YourLifeisMineEU,CHALLENGER I,413,13.8,1080,149,931,euw
293,Alrevan TFT,CHALLENGER I,413,12.5,343,43,300,euw
294,Fein7,CHALLENGER I,412,16.4,816,134,682,euw
295,Lammendam,CHALLENGER I,410,12.2,540,66,474,euw
296,ahlinswag,CHALLENGER I,408,15.9,346,55,291,euw
297,Suriyargh,CHALLENGER I,392,12.4,1327,165,1162,euw
298,sun666shine,CHALLENGER I,391,18.4,337,62,275,euw
299,Sheriff1903,CHALLENGER I,376,11.2,698,78,620,euw
300,BKrisz,CHALLENGER I,373,12.6,645,81,564,euw
301,Mynameisdodi,"GRANDMASTER I
G",485,9.9,554,55,499,euw
302,Dedicasse Fahd,"GRANDMASTER I
G",480,16.2,598,97,501,euw
303,Arestidios,"GRANDMASTER I
G",440,15.0,247,37,210,euw
304,Marcoyoung4ever,"GRANDMASTER I
G",437,18.5,195,36,159,euw
305,lovingmyplant,"GRANDMASTER I
G",430,16.9,237,40,197,euw
306,Ryuk DTB,"GRANDMASTER I
G",424,11.4,667,76,591,euw
307,KLeMx,"GRANDMASTER I
G",422,18.1,442,80,362,euw
308,MaCkTFT,"GRANDMASTER I
G",418,12.6,1522,192,1330,euw
309,Skipper173,"GRANDMASTER I
G",417,10.6,302,32,270,euw
310,zoro5773,"GRANDMASTER I
G",415,12.8,834,107,727,euw
311,Nydre,"GRANDMASTER I
G",407,19.2,172,33,139,euw
312,Nutinut,"GRANDMASTER I
G",404,18.8,1091,205,886,euw
313,ZèRô,"GRANDMASTER I
G",397,12.9,736,95,641,euw
314,Qetzz,"GRANDMASTER I
G",397,22.2,153,34,119,euw
315,Döbereiner,"GRANDMASTER I
G",395,15.7,605,95,510,euw
316,spongebob smiley,"GRANDMASTER I
G",392,16.7,408,68,340,euw
317,ttv NevyPT,"GRANDMASTER I
G",390,15.7,381,60,321,euw
318,Dandoo,"GRANDMASTER I
G",390,11.5,401,46,355,euw
319,Bren0,"GRANDMASTER I
G",386,17.6,199,35,164,euw
320,Archie Stõne,"GRANDMASTER I
G",385,15.2,297,45,252,euw
321,Virfel,"GRANDMASTER I
G",384,13.4,878,118,760,euw
322,Shielded,"GRANDMASTER I
G",382,12.0,599,72,527,euw
323,Galoubi,"GRANDMASTER I
G",381,17.3,503,87,416,euw
324,Scafista,"GRANDMASTER I
G",381,15.7,248,39,209,euw
325,Furriya,"GRANDMASTER I
G",381,15.8,221,35,186,euw
326,sklzzkt,"GRANDMASTER I
G",376,14.6,371,54,317,euw
327,TarteMan,"GRANDMASTER I
G",374,17.6,324,57,267,euw
328,barryflashxxxxx,"GRANDMASTER I
G",373,22.2,248,55,193,euw
329,mixer Alx2020,"GRANDMASTER I
G",367,13.9,531,74,457,euw
330,iAFG,"GRANDMASTER I
G",365,11.4,323,37,286,euw
331,Elisav,"GRANDMASTER I
G",361,19.0,126,24,102,euw
332,Summer Influenza,"GRANDMASTER I
G",360,14.4,459,66,393,euw
333,OnlyEloBoost,"GRANDMASTER I
G",358,20.1,189,38,151,euw
334,MarooNTFT,"GRANDMASTER I
G",355,17.8,197,35,162,euw
335,HypnoHS,"GRANDMASTER I
G",352,14.9,571,85,486,euw
336,Oririi,"GRANDMASTER I
G",350,8.6,580,50,530,euw
337,Afase,"GRANDMASTER I
G",349,18.1,210,38,172,euw
338,ShowYourDonger,"GRANDMASTER I
G",348,14.1,306,43,263,euw
339,KRIMEN,"GRANDMASTER I
G",345,11.0,793,87,706,euw
340,you wont win xd,"GRANDMASTER I
G",345,20.3,143,29,114,euw
341,Lost in ur smile,"GRANDMASTER I
G",342,13.7,708,97,611,euw
342,Boguetta,"GRANDMASTER I
G",342,18.5,249,46,203,euw
343,daveblue3,"GRANDMASTER I
G",341,20.8,264,55,209,euw
344,TFT IlIIIllIIlIl,"GRANDMASTER I
G",339,22.4,152,34,118,euw
345,swaqt,"GRANDMASTER I
G",337,20.9,320,67,253,euw
346,SirLowk,"GRANDMASTER I
G",337,12.1,429,52,377,euw
347,Tonichoux,"GRANDMASTER I
G",335,20.2,243,49,194,euw
348,iLLuuu TFT,"GRANDMASTER I
G",334,13.7,496,68,428,euw
349,kaiio,"GRANDMASTER I
G",332,12.9,248,32,216,euw
350,Bananana,"GRANDMASTER I
G",330,15.0,699,105,594,euw
351,Liocardia TFT,"GRANDMASTER I
G",330,27.2,81,22,59,euw
352,Molarck,"GRANDMASTER I
G",326,15.8,317,50,267,euw
353,yoqueloque,"GRANDMASTER I
G",323,18.4,245,45,200,euw
354,HeadButtAlistar,"GRANDMASTER I
G",321,13.0,730,95,635,euw
355,Drazar,"GRANDMASTER I
G",321,10.5,773,81,692,euw
356,Jeon Soyeon,"GRANDMASTER I
G",321,13.1,549,72,477,euw
357,Adastraa,"GRANDMASTER I
G",320,14.8,209,31,178,euw
358,1027,"GRANDMASTER I
G",319,16.6,283,47,236,euw
359,TalexPrime,"GRANDMASTER I
G",317,11.5,1039,120,919,euw
360,The Dedj,"GRANDMASTER I
G",316,12.9,341,44,297,euw
361,GRIEFER XDDD,"GRANDMASTER I
G",315,19.0,195,37,158,euw
362,Rogué,"GRANDMASTER I
G",312,11.8,904,107,797,euw
363,BKrisz TFT,"GRANDMASTER I
G",310,21.8,119,26,93,euw
364,TheFray,"GRANDMASTER I
G",308,15.9,905,144,761,euw
365,Le Grand Palmier,"GRANDMASTER I
G",308,14.6,576,84,492,euw
366,Danguardians,"GRANDMASTER I
G",307,13.5,282,38,244,euw
367,IamnotTLT,"GRANDMASTER I
G",305,14.4,334,48,286,euw
368,Consistent luck,"GRANDMASTER I
G",304,19.4,206,40,166,euw
369,SkunkZzy,"GRANDMASTER I
G",303,12.1,1510,182,1328,euw
370,Liocardia,"GRANDMASTER I
G",301,20.7,116,24,92,euw
371,OOF MACHINE,"GRANDMASTER I
G",298,20.2,208,42,166,euw
372,Les collègues,"GRANDMASTER I
G",297,15.7,172,27,145,euw
373,Sit Sit,"GRANDMASTER I
G",295,15.9,145,23,122,euw
374,Hua Kai Hui Luo,"GRANDMASTER I
G",293,12.6,602,76,526,euw
375,Zyríos,"GRANDMASTER I
G",290,14.1,462,65,397,euw
376,ThisChampIsHard,"GRANDMASTER I
G",290,14.7,327,48,279,euw
377,TaKK TFT,"GRANDMASTER I
G",289,14.7,531,78,453,euw
378,vickytchii,"GRANDMASTER I
G",288,10.3,971,100,871,euw
379,Adamąnt,"GRANDMASTER I
G",288,14.4,562,81,481,euw
380,Gryffus01,"GRANDMASTER I
G",288,12.8,533,68,465,euw
381,aristocrat,"GRANDMASTER I
G",288,16.7,270,45,225,euw
382,Tonsof,"GRANDMASTER I
G",288,19.8,131,26,105,euw
383,joel19,"GRANDMASTER I
G",287,11.4,991,113,878,euw
384,Dinomies,"GRANDMASTER I
G",284,12.5,736,92,644,euw
385,sorrysorrymybad,"GRANDMASTER I
G",284,16.9,401,68,333,euw
386,naphara,"GRANDMASTER I
G",284,14.9,261,39,222,euw
387,DianaEatme,"GRANDMASTER I
G",282,12.7,873,111,762,euw
388,Red Tuxedo,"GRANDMASTER I
G",282,14.6,540,79,461,euw
389,ChiIlman,"GRANDMASTER I
G",279,17.3,179,31,148,euw
390,DemiGodTad,"GRANDMASTER I
G",277,21.4,275,59,216,euw
391,Picikutyus192,"GRANDMASTER I
G",277,16.7,168,28,140,euw
392,LOLsPresident,"GRANDMASTER I
G",276,19.5,421,82,339,euw
393,Ernilol,"GRANDMASTER I
G",276,14.6,226,33,193,euw
394,Towati,"GRANDMASTER I
G",275,13.6,638,87,551,euw
395,Êxii,"GRANDMASTER I
G",275,14.8,453,67,386,euw
396,YxmEU,"GRANDMASTER I
G",275,18.0,167,30,137,euw
397,KongenAlexander,"GRANDMASTER I
G",272,14.8,793,117,676,euw
398,ninthie,"GRANDMASTER I
G",270,17.8,326,58,268,euw
399,Hynan,"GRANDMASTER I
G",267,15.9,673,107,566,euw
400,Pure B1ue,"GRANDMASTER I
G",267,14.1,377,53,324,euw
401,White biubiu,"GRANDMASTER I
G",267,18.7,187,35,152,euw
402,T4nPoP,"GRANDMASTER I
G",263,15.2,1370,208,1162,euw
403,Torlk,"GRANDMASTER I
G",263,14.3,1089,156,933,euw
404,Kizhh,"GRANDMASTER I
G",263,17.1,234,40,194,euw
405,Asyfrost,"GRANDMASTER I
G",262,23.1,160,37,123,euw
406,Rhow,"GRANDMASTER I
G",261,16.6,319,53,266,euw
407,Zwingel,"GRANDMASTER I
G",260,12.4,563,70,493,euw
408,MALODORAN,"GRANDMASTER I
G",260,12.8,383,49,334,euw
409,Lux al 7,"GRANDMASTER I
G",259,13.2,348,46,302,euw
410,grLdIbkqhU,"GRANDMASTER I
G",259,19.3,181,35,146,euw
411,FollowYourShadow,"GRANDMASTER I
G",258,14.3,991,142,849,euw
412,irrelevant RoIe,"GRANDMASTER I
G",257,18.1,271,49,222,euw
413,Chepe Santacruz,"GRANDMASTER I
G",256,13.5,334,45,289,euw
414,TheInvinc1ble,"GRANDMASTER I
G",255,12.8,319,41,278,euw
415,DevilDream II,"GRANDMASTER I
G",254,15.3,275,42,233,euw
416,Azershiit,"GRANDMASTER I
G",253,9.5,472,45,427,euw
417,JollyFaker,"GRANDMASTER I
G",252,14.9,476,71,405,euw
418,Greed bld,"GRANDMASTER I
G",252,14.4,355,51,304,euw
419,Valijn,"GRANDMASTER I
G",251,16.9,302,51,251,euw
420,BeasTFT,"GRANDMASTER I
G",248,14.6,378,55,323,euw
421,Higa,"GRANDMASTER I
G",246,17.1,532,91,441,euw
422,Enclase,"GRANDMASTER I
G",246,14.4,571,82,489,euw
423,Grassouil,"GRANDMASTER I
G",246,16.8,368,62,306,euw
424,kEizy,"GRANDMASTER I
G",246,17.0,270,46,224,euw
425,bat les yeuks,"GRANDMASTER I
G",244,21.6,102,22,80,euw
426,BP Kim Jisoo,"GRANDMASTER I
G",244,16.7,108,18,90,euw
427,Iriiick,"GRANDMASTER I
G",243,16.3,227,37,190,euw
428,Kemal1337,"GRANDMASTER I
G",241,10.4,924,96,828,euw
429,Laeta8,"GRANDMASTER I
G",241,15.2,368,56,312,euw
430,bstln2,"GRANDMASTER I
G",240,24.3,251,61,190,euw
431,TheLudensEkko,"GRANDMASTER I
G",240,14.8,263,39,224,euw
432,Bibia Be Ye Ye,"GRANDMASTER I
G",240,30.4,69,21,48,euw
433,Billgax,"GRANDMASTER I
G",239,13.3,512,68,444,euw
434,TOUNEJAI,"GRANDMASTER I
G",239,20.1,318,64,254,euw
435,LLL Sneaky,"GRANDMASTER I
G",238,16.8,357,60,297,euw
436,Morcovell,"GRANDMASTER I
G",237,15.9,472,75,397,euw
437,GameTFT,"GRANDMASTER I
G",236,15.8,328,52,276,euw
438,Dalesom,"GRANDMASTER I
G",236,16.7,305,51,254,euw
439,robinnou the god,"GRANDMASTER I
G",235,17.7,475,84,391,euw
440,Seksy,"GRANDMASTER I
G",235,21.1,227,48,179,euw
441,etre infame,"GRANDMASTER I
G",234,11.9,514,61,453,euw
442,PAISTI,"GRANDMASTER I
G",233,11.8,865,102,763,euw
443,Enimos,"GRANDMASTER I
G",233,16.0,524,84,440,euw
444,Bobby666666,"GRANDMASTER I
G",233,14.0,464,65,399,euw
445,FearTorgun,"GRANDMASTER I
G",233,16.0,244,39,205,euw
446,LACT,"GRANDMASTER I
G",233,20.9,153,32,121,euw
447,Diderot Le Croco,"GRANDMASTER I
G",232,15.3,248,38,210,euw
448,Lariano813,"GRANDMASTER I
G",232,14.8,236,35,201,euw
449,trècool,"GRANDMASTER I
G",231,13.4,806,108,698,euw
450,Long Ð,"GRANDMASTER I
G",230,13.4,389,52,337,euw
451,Chelito91,"GRANDMASTER I
G",229,14.1,488,69,419,euw
452,ShishiAnnie,"GRANDMASTER I
G",227,18.9,238,45,193,euw
453,DestructorXD,"GRANDMASTER I
G",225,15.0,320,48,272,euw
454,Roboante,"GRANDMASTER I
G",224,18.4,206,38,168,euw
455,crapchiTFT,"GRANDMASTER I
G",223,18.0,294,53,241,euw
456,lin9282,"GRANDMASTER I
G",223,14.9,323,48,275,euw
457,Le Shot,"GRANDMASTER I
G",220,14.0,1279,179,1100,euw
458,OniiiiChan,"GRANDMASTER I
G",220,18.8,515,97,418,euw
459,XilaxamBoy,"GRANDMASTER I
G",220,22.1,167,37,130,euw
460,Kalflo,"GRANDMASTER I
G",219,12.5,1202,150,1052,euw
461,Momor Vig,"GRANDMASTER I
G",219,12.7,764,97,667,euw
462,TFT KΙNG,"GRANDMASTER I
G",219,16.4,256,42,214,euw
463,Jigejiuwo,"GRANDMASTER I
G",218,13.4,396,53,343,euw
464,Havarianlolz,"GRANDMASTER I
G",218,20.0,185,37,148,euw
465,YuukiSamuse,"GRANDMASTER I
G",218,20.4,162,33,129,euw
466,Crvor,"GRANDMASTER I
G",217,14.8,663,98,565,euw
467,Il Mitra,"GRANDMASTER I
G",217,14.4,633,91,542,euw
468,N3m3s1X,"GRANDMASTER I
G",217,14.1,624,88,536,euw
469,C6 Ghost,"GRANDMASTER I
G",217,13.3,646,86,560,euw
470,El Tomdill,"GRANDMASTER I
G",217,14.8,535,79,456,euw
471,clearlove6,"GRANDMASTER I
G",217,16.8,416,70,346,euw
472,Feint TFT,"GRANDMASTER I
G",217,25.3,83,21,62,euw
473,PlayzTFT,"GRANDMASTER I
G",215,15.4,519,80,439,euw
474,Bobobätr,"GRANDMASTER I
G",215,14.2,449,64,385,euw
475,Specter BS,"GRANDMASTER I
G",215,10.5,353,37,316,euw
476,Always top 8 TFT,"GRANDMASTER I
G",214,15.7,510,80,430,euw
477,RiiKKz,"GRANDMASTER I
G",213,15.3,907,139,768,euw
478,o OSi o,"GRANDMASTER I
G",213,16.6,513,85,428,euw
479,Mordmann,"GRANDMASTER I
G",212,14.1,668,94,574,euw
480,SuperZhuo,"GRANDMASTER I
G",212,18.5,492,91,401,euw
481,ThatCrit,"GRANDMASTER I
G",212,14.1,262,37,225,euw
482,Mn Gaenvan,"GRANDMASTER I
G",211,15.3,222,34,188,euw
483,MmmmmmmmmmmmmDZZ,"GRANDMASTER I
G",210,15.0,393,59,334,euw
484,TFT Negan,"GRANDMASTER I
G",209,12.1,795,96,699,euw
485,VESIPETO,"GRANDMASTER I
G",207,14.3,418,60,358,euw
486,Kìrby,"GRANDMASTER I
G",207,16.7,251,42,209,euw
487,AR4B,"GRANDMASTER I
G",206,13.5,453,61,392,euw
488,xJPB,"GRANDMASTER I
G",206,16.9,348,59,289,euw
489,Udji,"GRANDMASTER I
G",205,15.5,566,88,478,euw
490,Badwòman,"GRANDMASTER I
G",205,16.1,465,75,390,euw
491,523666,"GRANDMASTER I
G",204,8.5,659,56,603,euw
492,OSilvR,"GRANDMASTER I
G",204,19.3,238,46,192,euw
493,amneLOL,"GRANDMASTER I
G",203,12.6,452,57,395,euw
494,f8t1ege,"GRANDMASTER I
G",203,12.6,326,41,285,euw
495,antoinaz76,"GRANDMASTER I
G",202,16.9,154,26,128,euw
496,azzlacktumor,"GRANDMASTER I
G",201,15.5,490,76,414,euw
497,schsskpf,"GRANDMASTER I
G",200,12.0,732,88,644,euw
498,Xarouzzz,"GRANDMASTER I
G",200,15.7,319,50,269,euw
499,Magnificent Feta,"GRANDMASTER I
G",200,14.2,316,45,271,euw
500,Garen03,"GRANDMASTER I
G",199,12.3,522,64,458,euw
1,Hiraino,CHALLENGER I,742,22.0,440,97,343,jp
2,KKQ,CHALLENGER I,653,21.2,335,71,264,jp
3,HiROKKtft,CHALLENGER I,584,19.6,311,61,250,jp
4,思い出の昼下がり,CHALLENGER I,544,26.3,209,55,154,jp
5,dayona,CHALLENGER I,494,17.6,1113,196,917,jp
6,hakutou,CHALLENGER I,491,23.9,669,160,509,jp
7,chocotto,CHALLENGER I,484,21.5,470,101,369,jp
8,Best 佐藤 JP,CHALLENGER I,479,24.2,244,59,185,jp
9,Age 21,CHALLENGER I,450,22.5,200,45,155,jp
10,煩いマン,CHALLENGER I,450,18.0,233,42,191,jp
11,じーく,CHALLENGER I,446,19.0,326,62,264,jp
12,害獣あらいぐま,CHALLENGER I,430,13.4,410,55,355,jp
13,むむっ,CHALLENGER I,429,22.3,314,70,244,jp
14,シャドウバース,CHALLENGER I,407,18.9,628,119,509,jp
15,Shroud Fanboy,CHALLENGER I,387,15.8,1084,171,913,jp
16,ajun,CHALLENGER I,373,17.9,739,132,607,jp
17,ひまわり準決勝,CHALLENGER I,372,24.9,193,48,145,jp
18,trotv,CHALLENGER I,364,15.9,516,82,434,jp
19,Best太郎JP,CHALLENGER I,350,21.8,331,72,259,jp
20,kes,CHALLENGER I,341,19.3,368,71,297,jp
21,God Fukuoka,CHALLENGER I,337,19.4,365,71,294,jp
22,etsuya0505,CHALLENGER I,332,16.7,564,94,470,jp
23,えっっ,CHALLENGER I,274,17.8,208,37,171,jp
24,ap top mom die,CHALLENGER I,270,23.6,229,54,175,jp
25,Tぽいんと,CHALLENGER I,249,21.6,278,60,218,jp
26,Adrenaline,CHALLENGER I,243,18.8,501,94,407,jp
27,大門未知子,CHALLENGER I,234,18.9,196,37,159,jp
28,dozepk,CHALLENGER I,227,15.2,440,67,373,jp
29,りーり,CHALLENGER I,220,13.0,972,126,846,jp
30,だよな,CHALLENGER I,211,21.9,169,37,132,jp
31,Hechima777,CHALLENGER I,187,14.8,674,100,574,jp
32,秋水宴,CHALLENGER I,178,16.4,268,44,224,jp
33,まくらi,CHALLENGER I,175,23.2,129,30,99,jp
34,喚くマン,CHALLENGER I,173,18.2,428,78,350,jp
35,さとるくん,CHALLENGER I,171,11.2,445,50,395,jp
36,山田周人,CHALLENGER I,166,16.5,467,77,390,jp
37,sueno09,CHALLENGER I,165,13.8,283,39,244,jp
38,お前のレベル笑,CHALLENGER I,162,21.0,381,80,301,jp
39,賃砲丸出侍,CHALLENGER I,157,23.6,212,50,162,jp
40,るきにゃん,CHALLENGER I,155,17.9,470,84,386,jp
41,沼の大破神,CHALLENGER I,153,19.9,267,53,214,jp
42,nagatoevol,CHALLENGER I,149,17.1,381,65,316,jp
43,ますにゃ,CHALLENGER I,146,13.6,691,94,597,jp
44,loraplayer,CHALLENGER I,123,17.4,809,141,668,jp
45,mikan0x0,CHALLENGER I,122,12.4,719,89,630,jp
46,Piyochan76,CHALLENGER I,122,16.2,265,43,222,jp
47,KR blonde lov,CHALLENGER I,119,21.4,210,45,165,jp
48,xtc,CHALLENGER I,115,18.1,430,78,352,jp
49,rionest,CHALLENGER I,98,17.4,1013,176,837,jp
50,かふす,CHALLENGER I,96,18.3,765,140,625,jp
51,pureheart player,"GRANDMASTER I
G",140,16.6,350,58,292,jp
52,しかめまどか2,"GRANDMASTER I
G",129,23.5,221,52,169,jp
53,Twisted Fate Bot,"GRANDMASTER I
G",119,16.6,343,57,286,jp
54,Waterfox,"GRANDMASTER I
G",117,12.9,301,39,262,jp
55,おしっこちゃん,"GRANDMASTER I
G",113,12.1,630,76,554,jp
56,FoT DazzingDog,"GRANDMASTER I
G",99,21.2,274,58,216,jp
57,macro11,"GRANDMASTER I
G",98,16.7,288,48,240,jp
58,ぼんちょび,"GRANDMASTER I
G",89,26.8,157,42,115,jp
59,Yaruo,"GRANDMASTER I
G",82,16.8,280,47,233,jp
60,elfiny,"GRANDMASTER I
G",78,18.1,166,30,136,jp
61,モルディ貝,"GRANDMASTER I
G",72,16.1,317,51,266,jp
62,えんどほーぷ,"GRANDMASTER I
G",67,8.7,588,51,537,jp
63,Worst Takashi JP,"GRANDMASTER I
G",65,13.1,436,57,379,jp
64,URUUUU,"GRANDMASTER I
G",64,20.0,445,89,356,jp
65,pveman,"GRANDMASTER I
G",59,18.6,311,58,253,jp
66,Count Mak,"GRANDMASTER I
G",58,19.9,437,87,350,jp
67,Satolis,"GRANDMASTER I
G",55,10.1,427,43,384,jp
68,ekollon,"GRANDMASTER I
G",53,18.0,422,76,346,jp
69,hohe,"GRANDMASTER I
G",36,16.4,617,101,516,jp
70,ロルから逃げるな,"GRANDMASTER I
G",36,19.6,163,32,131,jp
71,Jethro Cyrus,"GRANDMASTER I
G",33,14.1,595,84,511,jp
72,Ponty,"GRANDMASTER I
G",32,15.6,780,122,658,jp
73,Jackn,"GRANDMASTER I
G",31,20.8,221,46,175,jp
74,nijimuraact2,"GRANDMASTER I
G",28,15.4,428,66,362,jp
75,bappy,"GRANDMASTER I
G",27,18.0,782,141,641,jp
76,ポッチャマ,"GRANDMASTER I
G",26,11.9,318,38,280,jp
77,kotogane411,"GRANDMASTER I
G",26,17.6,204,36,168,jp
78,Raias,"GRANDMASTER I
G",25,16.3,522,85,437,jp
79,foxbaby123b,"GRANDMASTER I
G",24,13.7,505,69,436,jp
80,名取ざや,"GRANDMASTER I
G",23,23.6,229,54,175,jp
81,マグロマート,"GRANDMASTER I
G",23,19.4,144,28,116,jp
82,MELODY FLAG,"GRANDMASTER I
G",22,20.1,199,40,159,jp
83,millepiedi,"GRANDMASTER I
G",21,14.0,272,38,234,jp
84,ZmLFs2z,"GRANDMASTER I
G",21,21.8,156,34,122,jp
85,pccc,"GRANDMASTER I
G",21,31.1,90,28,62,jp
86,misomega,"GRANDMASTER I
G",18,16.0,405,65,340,jp
87,たなってぃ,"GRANDMASTER I
G",17,16.8,434,73,361,jp
88,曖昧心,"GRANDMASTER I
G",16,14.7,238,35,203,jp
89,夜空丶,"GRANDMASTER I
G",15,19.6,189,37,152,jp
90,vvvvvvvvvipp,"GRANDMASTER I
G",14,17.9,529,95,434,jp
91,丸の内LOLレイナ,"GRANDMASTER I
G",13,16.1,429,69,360,jp
92,Why So Serious,"GRANDMASTER I
G",11,14.8,311,46,265,jp
93,contrail,"GRANDMASTER I
G",11,18.1,149,27,122,jp
94,夏目純夏,"GRANDMASTER I
G",7,25.1,167,42,125,jp
95,dozeqk,"GRANDMASTER I
G",6,18.5,200,37,163,jp
96,tola,"GRANDMASTER I
G",4,14.3,231,33,198,jp
97,ぬこ丸,"GRANDMASTER I
G",1,18.7,476,89,387,jp
98,ぜろななにーいち,"GRANDMASTER I
G",1,22.1,167,37,130,jp
99,Ugokeru Debu Bot,"GRANDMASTER I
G",1,16.2,222,36,186,jp
100,7zigeN,"GRANDMASTER I
G",0,17.7,1001,177,824,jp
101,bonchobi,"GRANDMASTER I
G",0,14.7,462,68,394,jp
102,じょん炊いたー,"GRANDMASTER I
G",0,21.8,308,67,241,jp
103,GoodMannerU5,"GRANDMASTER I
G",0,14.1,439,62,377,jp
104,CosplayGirl,"GRANDMASTER I
G",0,23.7,224,53,171,jp
105,tinko irelia,"GRANDMASTER I
G",0,17.4,247,43,204,jp
106,karakuti,"GRANDMASTER I
G",0,19.8,212,42,170,jp
107,クックパッド歩美,"GRANDMASTER I
G",0,21.1,147,31,116,jp
108,ゲッティスパ美,"GRANDMASTER I
G",0,18.4,163,30,133,jp
109,日高愛,DIAMOND I,96,15.5,420,65,355,jp
110,いまのん,DIAMOND I,92,17.8,353,63,290,jp
111,Eidechse,DIAMOND I,91,16.4,220,36,184,jp
112,shuraha3,DIAMOND I,87,16.3,380,62,318,jp
113,ゆっちー,DIAMOND I,80,12.2,368,45,323,jp
114,しかめまどか,DIAMOND I,75,14.6,1211,177,1034,jp
115,askrp,DIAMOND I,75,17.0,569,97,472,jp
116,Sukizofureni,DIAMOND I,75,13.3,548,73,475,jp
117,lalabybyby,DIAMOND I,75,15.6,461,72,389,jp
118,MichaelChan,DIAMOND I,75,17.7,317,56,261,jp
119,てっくてっく,DIAMOND I,75,19.0,273,52,221,jp
120,ききちま,DIAMOND I,75,18.2,285,52,233,jp
121,福山はさまるJP,DIAMOND I,75,16.3,307,50,257,jp
122,ABEKANZOU,DIAMOND I,75,19.5,210,41,169,jp
123,ButaDaJoe,DIAMOND I,75,19.5,190,37,153,jp
124,スルギすき,DIAMOND I,75,16.7,204,34,170,jp
125,オーシャン増永,DIAMOND I,75,18.8,176,33,143,jp
126,IKUTOMIE,DIAMOND I,75,11.4,228,26,202,jp
127,AikaS,DIAMOND I,74,16.3,728,119,609,jp
128,くりちゃん大好き,DIAMOND I,69,21.4,159,34,125,jp
129,チャイコフスキー,DIAMOND I,68,14.2,1031,146,885,jp
130,XionNoi,DIAMOND I,61,18.4,386,71,315,jp
131,NAGATSUNE,DIAMOND I,60,14.9,562,84,478,jp
132,1515225,DIAMOND I,59,14.9,376,56,320,jp
133,tomonar1,DIAMOND I,57,14.3,391,56,335,jp
134,汝何着品如衣,DIAMOND I,57,16.1,230,37,193,jp
135,いけなる,DIAMOND I,46,17.3,733,127,606,jp
136,Bad Takahashi,DIAMOND I,45,19.0,200,38,162,jp
137,ぽこくま,DIAMOND I,42,18.8,138,26,112,jp
138,koogie,DIAMOND I,39,14.3,343,49,294,jp
139,dngr,DIAMOND I,38,16.2,271,44,227,jp
140,shinano,DIAMOND I,37,15.9,157,25,132,jp
141,low roller,DIAMOND I,36,18.1,177,32,145,jp
142,Remixi,DIAMOND I,35,11.7,196,23,173,jp
143,snatcher,DIAMOND I,34,15.1,538,81,457,jp
144,Kuririman,DIAMOND I,31,14.7,265,39,226,jp
145,imymind,DIAMOND I,31,15.9,239,38,201,jp
146,涼風あおば,DIAMOND I,30,18.8,101,19,82,jp
147,犬走椛,DIAMOND I,29,19.4,103,20,83,jp
148,濃厚鶏白湯拉麺,DIAMOND I,28,17.0,159,27,132,jp
149,shuraha4,DIAMOND I,27,13.5,303,41,262,jp
150,Nochita,DIAMOND I,27,12.4,273,34,239,jp
151,orange7premium,DIAMOND I,25,17.1,461,79,382,jp
152,スタフィー,DIAMOND I,25,23.8,172,41,131,jp
153,世界詞のキア,DIAMOND I,24,16.7,126,21,105,jp
154,うるるる,DIAMOND I,21,21.2,137,29,108,jp
155,NewmetaTrollking,DIAMOND I,19,12.6,374,47,327,jp
156,IlllIlllIlllI,DIAMOND I,18,20.3,177,36,141,jp
157,キャンディ  猫,DIAMOND I,17,19.8,172,34,138,jp
158,halkeye,DIAMOND I,16,14.0,608,85,523,jp
159,neetneo,DIAMOND I,16,20.9,210,44,166,jp
160,副頭取,DIAMOND I,14,13.3,218,29,189,jp
161,HitujiDaJoe,DIAMOND I,13,16.4,195,32,163,jp
162,ヨンジン,DIAMOND I,12,10.0,391,39,352,jp
163,ダンボ君,DIAMOND I,11,17.4,161,28,133,jp
164,にぶさき,DIAMOND I,9,15.2,975,148,827,jp
165,ランダムそうち,DIAMOND I,8,12.8,678,87,591,jp
166,InventusGaming,DIAMOND I,5,10.6,350,37,313,jp
167,福山はさまるNA,DIAMOND I,5,19.7,147,29,118,jp
168,エミュー,DIAMOND I,3,14.5,456,66,390,jp
169,ふうニキ,DIAMOND I,3,11.6,526,61,465,jp
170,enamel,DIAMOND I,3,9.4,341,32,309,jp
171,watchhhhhh,DIAMOND I,3,18.7,150,28,122,jp
172,Rhino Cider,DIAMOND I,3,12.5,192,24,168,jp
173,ciple753,DIAMOND I,2,12.9,301,39,262,jp
174,ジャジャラ,DIAMOND I,2,15.7,197,31,166,jp
175,Sakurakouji Luna,DIAMOND I,2,20.6,126,26,100,jp
176,はんえつか,DIAMOND I,1,16.8,185,31,154,jp
177,醤ØuØ油,DIAMOND I,0,14.0,827,116,711,jp
178,Gafu,DIAMOND I,0,13.5,812,110,702,jp
179,Premium Malt,DIAMOND I,0,13.3,678,90,588,jp
180,gacchapin20,DIAMOND I,0,13.4,649,87,562,jp
181,Kyoutle,DIAMOND I,0,12.7,659,84,575,jp
182,pano,DIAMOND I,0,17.0,448,76,372,jp
183,Shield Samba,DIAMOND I,0,13.3,481,64,417,jp
184,アイルー卿,DIAMOND I,0,15.1,364,55,309,jp
185,ぴにゃぴっぴ,DIAMOND I,0,15.2,354,54,300,jp
186,young4u,DIAMOND I,0,16.3,325,53,272,jp
187,Endcyclone,DIAMOND I,0,27.0,148,40,108,jp
188,laser501,DIAMOND I,0,16.4,237,39,198,jp
189,siva fes,DIAMOND I,0,12.5,279,35,244,jp
190,yatsuhashi567,DIAMOND I,0,13.5,251,34,217,jp
191,下了88,DIAMOND I,0,27.6,116,32,84,jp
192,toudoriDX2,DIAMOND I,0,9.9,302,30,272,jp
193,εOnOз,DIAMOND I,0,18.7,139,26,113,jp
194,nasyoter,DIAMOND I,0,15.1,139,21,118,jp
195,所念皆星河,DIAMOND II,96,18.7,316,59,257,jp
196,にじむら,DIAMOND II,95,12.5,706,88,618,jp
197,newie,DIAMOND II,94,15.5,328,51,277,jp
198,UnpokoKenshi,DIAMOND II,93,17.7,231,41,190,jp
199,AHIKJDK,DIAMOND II,92,27.2,103,28,75,jp
200,center8128,DIAMOND II,87,15.0,173,26,147,jp
201,admin testuser01,DIAMOND II,84,14.5,825,120,705,jp
202,キイロイトリ3,DIAMOND II,80,13.3,255,34,221,jp
203,Hermes0,DIAMOND II,75,16.2,734,119,615,jp
204,うーきち TFT,DIAMOND II,75,18.5,605,112,493,jp
205,korekoreTFT,DIAMOND II,75,14.0,712,100,612,jp
206,えんぢょ,DIAMOND II,75,18.2,422,77,345,jp
207,Y0m02,DIAMOND II,75,14.1,509,72,437,jp
208,やんやんこ,DIAMOND II,75,13.1,435,57,378,jp
209,マヨヒガ,DIAMOND II,75,11.1,458,51,407,jp
210,kamiEli,DIAMOND II,75,14.8,337,50,287,jp
211,7Silky7,DIAMOND II,75,13.2,356,47,309,jp
212,HUSSEY8810,DIAMOND II,75,13.1,314,41,273,jp
213,くりちゃんTFT,DIAMOND II,75,19.5,200,39,161,jp
214,檸檬堂,DIAMOND II,75,16.0,244,39,205,jp
215,ヨダルラーハ,DIAMOND II,75,20.0,170,34,136,jp
216,ウーノ,DIAMOND II,75,14.8,229,34,195,jp
217,ShiitakeForest,DIAMOND II,75,14.0,236,33,203,jp
218,Kaboom,DIAMOND II,75,22.4,85,19,66,jp
219,VTAKU77,DIAMOND II,75,12.0,125,15,110,jp
220,Syutya,DIAMOND II,68,14.8,653,97,556,jp
221,超天才,DIAMOND II,67,16.9,308,52,256,jp
222,ぽんぽん桂,DIAMOND II,63,15.9,571,91,480,jp
223,KICKbach,DIAMOND II,63,12.8,524,67,457,jp
224,HaRpooN,DIAMOND II,61,15.1,523,79,444,jp
225,山下美月,DIAMOND II,54,26.7,105,28,77,jp
226,おやすみの翁,DIAMOND II,54,16.9,136,23,113,jp
227,ばーじん,DIAMOND II,52,15.1,828,125,703,jp
228,Enter Hallownest,DIAMOND II,50,16.0,231,37,194,jp
229,きゅんきゅん,DIAMOND II,47,14.7,422,62,360,jp
230,Caplico,DIAMOND II,47,17.5,246,43,203,jp
231,Makorli,DIAMOND II,45,10.6,226,24,202,jp
232,梧 桐,DIAMOND II,44,14.4,923,133,790,jp
233,彼氏の顔ぽっぴー,DIAMOND II,44,13.5,155,21,134,jp
234,yayo84,DIAMOND II,43,21.9,128,28,100,jp
235,嘘柱 誇張しのぶ,DIAMOND II,42,16.2,191,31,160,jp
236,ZEITAKU man,DIAMOND II,42,22.5,111,25,86,jp
237,Cyzo,DIAMOND II,41,12.4,564,70,494,jp
238,I DO RAMMUS JUNG,DIAMOND II,40,16.2,321,52,269,jp
239,Pattol,DIAMOND II,40,18.7,246,46,200,jp
240,Hirobumi,DIAMOND II,38,20.1,189,38,151,jp
241,おふめたであそぼ,DIAMOND II,36,12.5,144,18,126,jp
242,ミュート,DIAMOND II,35,13.8,297,41,256,jp
243,doxxo,DIAMOND II,34,11.5,253,29,224,jp
244,Religious丶,DIAMOND II,33,17.8,309,55,254,jp
245,Stea 2,DIAMOND II,33,11.3,124,14,110,jp
246,axela,DIAMOND II,32,12.4,177,22,155,jp
247,みすどでぶ,DIAMOND II,28,13.0,192,25,167,jp
248,初心者kyo,DIAMOND II,26,11.0,264,29,235,jp
249,西新井,DIAMOND II,26,15.6,167,26,141,jp
250,ゲレクシス,DIAMOND II,26,18.5,130,24,106,jp
251,黑島沙和i,DIAMOND II,25,29.0,324,94,230,jp
252,びっとこ女子,DIAMOND II,25,13.6,529,72,457,jp
253,mcscrubjr,DIAMOND II,25,16.2,277,45,232,jp
254,にんふ,DIAMOND II,25,16.3,252,41,211,jp
255,detteiusyousa,DIAMOND II,25,11.7,205,24,181,jp
256,菲桑家大魔王,DIAMOND II,23,21.4,281,60,221,jp
257,Asdgum,DIAMOND II,23,14.8,365,54,311,jp
258,仕事がきらいです,DIAMOND II,23,14.2,239,34,205,jp
259,TenderBalls,DIAMOND II,22,16.5,218,36,182,jp
260,靴職人,DIAMOND II,21,13.6,513,70,443,jp
261,hrs,DIAMOND II,21,18.9,306,58,248,jp
262,biubiu,DIAMOND II,19,18.0,372,67,305,jp
263,墨 眉,DIAMOND II,19,14.6,288,42,246,jp
264,NT plz,DIAMOND II,18,13.6,339,46,293,jp
265,xKurosx,DIAMOND II,16,16.5,412,68,344,jp
266,yurarara11,DIAMOND II,15,20.6,489,101,388,jp
267,戦ナ占学竜忍詩機,DIAMOND II,15,7.7,718,55,663,jp
268,Giáo Án Top8 TFT,DIAMOND II,13,20.4,275,56,219,jp
269,thewrongman123,DIAMOND II,12,15.8,323,51,272,jp
270,askrq,DIAMOND II,9,23.4,154,36,118,jp
271,bbegg1nnerr,DIAMOND II,8,16.9,557,94,463,jp
272,メンタルがよわい,DIAMOND II,7,22.1,104,23,81,jp
273,プレデター村上,DIAMOND II,1,12.0,416,50,366,jp
274,ZEINIKU man,DIAMOND II,0,15.9,627,100,527,jp
275,huairenzhushou,DIAMOND II,0,16.8,494,83,411,jp
276,acaria,DIAMOND II,0,23.5,298,70,228,jp
277,akitosoya,DIAMOND II,0,13.9,495,69,426,jp
278,エトペペ,DIAMOND II,0,21.9,310,68,242,jp
279,ぽこた,DIAMOND II,0,18.6,349,65,284,jp
280,ぐくぐくぐく,DIAMOND II,0,13.1,495,65,430,jp
281,理解のある彼くん,DIAMOND II,0,15.6,405,63,342,jp
282,蟹さん,DIAMOND II,0,11.7,437,51,386,jp
283,ーAkiraー,DIAMOND II,0,13.6,367,50,317,jp
284,onamasu,DIAMOND II,0,12.3,348,43,305,jp
285,Eclairr,DIAMOND II,0,16.9,236,40,196,jp
286,ni ma su ra,DIAMOND II,0,16.0,243,39,204,jp
287,Sungoi,DIAMOND II,0,15.4,227,35,192,jp
288,Drosophila,DIAMOND II,0,16.2,210,34,176,jp
289,Hide on the bush,DIAMOND II,0,12.1,281,34,247,jp
290,このばかちんがぁ,DIAMOND II,0,14.7,224,33,191,jp
291,新ふうちゃん,DIAMOND II,0,14.1,234,33,201,jp
292,SanteSante,DIAMOND II,0,12.1,257,31,226,jp
293,えりぽよ,DIAMOND II,0,11.4,264,30,234,jp
294,Angel di maria,DIAMOND II,0,18.8,149,28,121,jp
295,ARAM専,DIAMOND II,0,16.4,165,27,138,jp
296,お下劣大百科,DIAMOND II,0,17.2,128,22,106,jp
297,ezmk3,DIAMOND II,0,11.1,171,19,152,jp
298,GrystalVirgin,DIAMOND III,98,23.0,100,23,77,jp
299,tomosuna,DIAMOND III,97,12.5,208,26,182,jp
300,インターネット,DIAMOND III,93,17.0,147,25,122,jp
301,鳥取で一番強い男,DIAMOND III,91,13.2,380,50,330,jp
302,M700LTR,DIAMOND III,89,14.8,244,36,208,jp
303,moitapchoi1,DIAMOND III,88,8.3,217,18,199,jp
304,492601,DIAMOND III,84,18.8,192,36,156,jp
305,うぃぐ,DIAMOND III,84,10.7,243,26,217,jp
306,MABARIKO,DIAMOND III,81,16.6,505,84,421,jp
307,Stea 0,DIAMOND III,81,12.7,456,58,398,jp
308,RankedBot,DIAMOND III,79,15.0,507,76,431,jp
309,エアは空気,DIAMOND III,77,15.0,412,62,350,jp
310,とっき,DIAMOND III,75,16.6,800,133,667,jp
311,hpppz,DIAMOND III,75,17.5,663,116,547,jp
312,ふるつぼ,DIAMOND III,75,17.8,332,59,273,jp
313,海口江流儿,DIAMOND III,75,22.4,245,55,190,jp
314,此方より彼方まで,DIAMOND III,75,16.2,277,45,232,jp
315,Shinj,DIAMOND III,75,13.2,325,43,282,jp
316,花園めい,DIAMOND III,75,14.1,297,42,255,jp
317,nentou,DIAMOND III,75,16.1,242,39,203,jp
318,nO1v1On,DIAMOND III,75,16.2,234,38,196,jp
319,whiteposs,DIAMOND III,75,10.1,378,38,340,jp
320,Yelin2,DIAMOND III,75,22.3,139,31,108,jp
321,斬帝少女アカメ,DIAMOND III,75,14.3,217,31,186,jp
322,ironman2,DIAMOND III,75,14.3,217,31,186,jp
323,きんたマン,DIAMOND III,75,12.4,185,23,162,jp
324,約束された終末,DIAMOND III,75,26.9,78,21,57,jp
325,たし蟹ｗ,DIAMOND III,75,16.8,119,20,99,jp
326,yukiguniflower,DIAMOND III,70,16.2,148,24,124,jp
327,aind712,DIAMOND III,69,18.2,181,33,148,jp
328,Lusterbell,DIAMOND III,67,16.7,204,34,170,jp
329,otomo,DIAMOND III,66,18.8,128,24,104,jp
330,Sknow,DIAMOND III,65,13.0,445,58,387,jp
331,Soufflebite,DIAMOND III,63,12.3,528,65,463,jp
332,giver,DIAMOND III,63,16.2,247,40,207,jp
333,Rin09,DIAMOND III,60,14.5,200,29,171,jp
334,SUPERSALT,DIAMOND III,59,15.8,476,75,401,jp
335,しろてぃー,DIAMOND III,58,8.8,702,62,640,jp
336,GUNKATANAMAN,DIAMOND III,57,14.9,228,34,194,jp
337,彩月のあ,DIAMOND III,56,15.2,627,95,532,jp
338,yayo841,DIAMOND III,56,12.1,273,33,240,jp
339,ymkd,DIAMOND III,56,16.0,200,32,168,jp
340,priyome,DIAMOND III,56,13.6,206,28,178,jp
341,Shiromine,DIAMOND III,56,19.2,135,26,109,jp
342,りいの,DIAMOND III,55,16.6,385,64,321,jp
343,AquaAura,DIAMOND III,53,19.1,366,70,296,jp
344,Raitora,DIAMOND III,52,14.8,271,40,231,jp
345,Pon2,DIAMOND III,47,15.2,453,69,384,jp
346,Monster Box 20段,DIAMOND III,47,18.5,275,51,224,jp
347,新参者X,DIAMOND III,45,21.5,246,53,193,jp
348,roku123,DIAMOND III,44,16.7,402,67,335,jp
349,Best 三毛猫 jp,DIAMOND III,44,11.4,262,30,232,jp
350,Lyth,DIAMOND III,43,17.5,143,25,118,jp
351,satohige,DIAMOND III,42,16.3,478,78,400,jp
352,iZukama,DIAMOND III,42,11.9,613,73,540,jp
353,forever18,DIAMOND III,42,16.0,350,56,294,jp
354,度し難い,DIAMOND III,40,14.3,621,89,532,jp
355,バロンドール中村,DIAMOND III,40,10.1,762,77,685,jp
356,kumeseniii,DIAMOND III,40,15.3,386,59,327,jp
357,ahegaomj,DIAMOND III,38,16.3,184,30,154,jp
358,電磁抜刀 禍,DIAMOND III,38,13.8,188,26,162,jp
359,srinm,DIAMOND III,37,16.3,454,74,380,jp
360,AD VietNamese,DIAMOND III,37,13.6,470,64,406,jp
361,Joxier,DIAMOND III,36,15.9,496,79,417,jp
362,ええんやで,DIAMOND III,36,12.1,265,32,233,jp
363,cøcø,DIAMOND III,34,13.6,631,86,545,jp
364,ohayou vn,DIAMOND III,33,13.8,630,87,543,jp
365,Beige,DIAMOND III,33,12.5,337,42,295,jp
366,Wuju Senshi,DIAMOND III,31,13.8,434,60,374,jp
367,HibeInBush,DIAMOND III,31,16.0,338,54,284,jp
368,かろかん,DIAMOND III,31,22.6,62,14,48,jp
369,Calimero,DIAMOND III,30,15.4,208,32,176,jp
370,期間限定公開18禁,DIAMOND III,30,18.8,154,29,125,jp
371,Malz,DIAMOND III,30,12.0,216,26,190,jp
372,アイス,DIAMOND III,29,28.8,80,23,57,jp
373,れおすぴ,DIAMOND III,28,16.5,406,67,339,jp
374,titekubo,DIAMOND III,28,13.8,400,55,345,jp
375,kimi1211,DIAMOND III,28,12.2,435,53,382,jp
376,北条加蓮,DIAMOND III,28,10.9,239,26,213,jp
377,Best 井上 JP,DIAMOND III,27,12.2,188,23,165,jp
378,五十音ことは,DIAMOND III,26,15.4,240,37,203,jp
379,林檎盛り,DIAMOND III,25,11.6,541,63,478,jp
380,mari,DIAMOND III,25,24.7,235,58,177,jp
381,summertimer,DIAMOND III,25,15.8,309,49,260,jp
382,空は高く風は歌え,DIAMOND III,25,23.1,173,40,133,jp
383,理科一類,DIAMOND III,25,21.6,185,40,145,jp
384,kuma81,DIAMOND III,25,11.1,314,35,279,jp
385,Rudel,DIAMOND III,25,23.3,146,34,112,jp
386,止まらないオルガ,DIAMOND III,25,44.3,61,27,34,jp
387,zaiga,DIAMOND III,25,23.2,99,23,76,jp
388,Mixiffy,DIAMOND III,25,19.2,99,19,80,jp
389,ウーフ,DIAMOND III,25,23.9,67,16,51,jp
390,Piwxn9,DIAMOND III,25,12.8,125,16,109,jp
391,ばねちゃんねる,DIAMOND III,24,20.0,215,43,172,jp
392,お酒は二十歳になってから,DIAMOND III,24,33.3,72,24,48,jp
393,SteelyRaww,DIAMOND III,23,15.7,464,73,391,jp
394,unenyon,DIAMOND III,22,13.6,324,44,280,jp
395,Rolling,DIAMOND III,22,16.8,185,31,154,jp
396,Veyr Soryr,DIAMOND III,21,16.2,142,23,119,jp
397,ていちん,DIAMOND III,20,15.9,516,82,434,jp
398,hahachay,DIAMOND III,20,13.0,585,76,509,jp
399,ももりんちょ,DIAMOND III,20,18.1,116,21,95,jp
400,setuna,DIAMOND III,18,12.8,374,48,326,jp
401,がいこくじんです,DIAMOND III,18,12.6,350,44,306,jp
402,oni5roshi,DIAMOND III,18,16.6,217,36,181,jp
403,Furry White,DIAMOND III,18,18.8,96,18,78,jp
404,へぶお,DIAMOND III,17,20.5,117,24,93,jp
405,ひもさまだぞ,DIAMOND III,17,28.6,77,22,55,jp
406,だいごちゃん,DIAMOND III,16,14.8,330,49,281,jp
407,Hiromu3,DIAMOND III,15,11.6,476,55,421,jp
408,Habibi Top,DIAMOND III,15,17.2,238,41,197,jp
409,whiteliot99,DIAMOND III,15,13.4,298,40,258,jp
410,SoNor,DIAMOND III,15,10.2,382,39,343,jp
411,TFTgirl,DIAMOND III,15,15.7,223,35,188,jp
412,PogoMix,DIAMOND III,15,13.8,188,26,162,jp
413,Barotte1,DIAMOND III,14,15.1,212,32,180,jp
414,Fraternity,DIAMOND III,14,14.8,196,29,167,jp
415,百年後,DIAMOND III,13,11.9,370,44,326,jp
416,kasuteraman,DIAMOND III,12,10.7,961,103,858,jp
417,くうしか,DIAMOND III,11,13.4,701,94,607,jp
418,OHA,DIAMOND III,11,15.7,166,26,140,jp
419,Ashrin,DIAMOND III,11,13.3,165,22,143,jp
420,あでみん,DIAMOND III,9,12.0,301,36,265,jp
421,oilyoshi,DIAMOND III,8,18.6,446,83,363,jp
422,やりサーのボッチ,DIAMOND III,7,13.7,525,72,453,jp
423,LegalH1gh,DIAMOND III,5,14.8,432,64,368,jp
424,germger,DIAMOND III,5,18.7,262,49,213,jp
425,yuuchao815,DIAMOND III,5,10.9,238,26,212,jp
426,紅葉Maple,DIAMOND III,5,15.0,140,21,119,jp
427,三上悠亜せんせい,DIAMOND III,4,19.7,147,29,118,jp
428,三好と松永,DIAMOND III,4,25.5,102,26,76,jp
429,森七菜,DIAMOND III,3,18.6,602,112,490,jp
430,Orgap,DIAMOND III,3,9.4,297,28,269,jp
431,氷球弾,DIAMOND III,2,22.3,206,46,160,jp
432,もりぴー,DIAMOND III,2,15.6,294,46,248,jp
433,MapleStory2,DIAMOND III,2,12.4,266,33,233,jp
434,keropu,DIAMOND III,1,11.6,430,50,380,jp
435,lll LanPa lll,DIAMOND III,1,12.5,384,48,336,jp
436,じゃこちゃん,DIAMOND III,1,14.2,261,37,224,jp
437,dai1,DIAMOND III,0,15.5,702,109,593,jp
438,REGRETSHE,DIAMOND III,0,17.2,522,90,432,jp
439,robeen,DIAMOND III,0,14.3,544,78,466,jp
440,鈴木汚拓,DIAMOND III,0,12.2,600,73,527,jp
441,真島ヒロ,DIAMOND III,0,13.0,501,65,436,jp
442,ravennnnnnnnnnnn,DIAMOND III,0,11.8,516,61,455,jp
443,ゼファー,DIAMOND III,0,15.8,367,58,309,jp
444,nossou,DIAMOND III,0,15.6,358,56,302,jp
445,下ネタは嫌いです,DIAMOND III,0,19.1,277,53,224,jp
446,もめちん,DIAMOND III,0,10.9,486,53,433,jp
447,でーもんまみ,DIAMOND III,0,17.7,288,51,237,jp
448,CV斎藤千和,DIAMOND III,0,12.9,386,50,336,jp
449,Cong An Xa37,DIAMOND III,0,14.1,340,48,292,jp
450,イキ杉愛苦朗,DIAMOND III,0,16.3,276,45,231,jp
451,ジーコ,DIAMOND III,0,15.5,278,43,235,jp
452,コグマウ,DIAMOND III,0,15.7,267,42,225,jp
453,Lotus Q,DIAMOND III,0,12.5,321,40,281,jp
454,yanemint,DIAMOND III,0,12.5,295,37,258,jp
455,独 尊,DIAMOND III,0,14.2,219,31,188,jp
456,プンプン打つな,DIAMOND III,0,18.5,162,30,132,jp
457,kaede614,DIAMOND III,0,11.8,220,26,194,jp
458,わたなべ,DIAMOND III,0,12.4,186,23,163,jp
459,Kak4rotto,DIAMOND III,0,18.4,98,18,80,jp
460,supelaw,DIAMOND IV,99,10.6,644,68,576,jp
461,cnmWDNMD,DIAMOND IV,98,21.1,312,66,246,jp
462,要糖嘛,DIAMOND IV,96,15.2,223,34,189,jp
463,OffBeat,DIAMOND IV,95,14.7,326,48,278,jp
464,ぽりっぴ,DIAMOND IV,93,13.5,126,17,109,jp
465,sack dance,DIAMOND IV,92,10.5,986,104,882,jp
466,Leaaaaaaaaaaaaaa,DIAMOND IV,90,15.4,324,50,274,jp
467,yorolium,DIAMOND IV,87,15.9,496,79,417,jp
468,もしもボックス,DIAMOND IV,87,15.1,239,36,203,jp
469,gyoko,DIAMOND IV,85,9.7,319,31,288,jp
470,quocdatvv89,DIAMOND IV,84,13.8,587,81,506,jp
471,deárest,DIAMOND IV,83,36.0,50,18,32,jp
472,七秒の記憶,DIAMOND IV,82,12.0,234,28,206,jp
473,天下り常習者,DIAMOND IV,80,16.2,142,23,119,jp
474,じぇいわい,DIAMOND IV,77,16.5,297,49,248,jp
475,ふうせんネコ,DIAMOND IV,77,15.5,219,34,185,jp
476,On Your Left,DIAMOND IV,75,14.6,584,85,499,jp
477,tikpen,DIAMOND IV,75,16.0,412,66,346,jp
478,我我我能c,DIAMOND IV,75,19.1,329,63,266,jp
479,Ryona,DIAMOND IV,75,11.7,520,61,459,jp
480,AZYC,DIAMOND IV,75,21.8,225,49,176,jp
481,銀色赤底の実,DIAMOND IV,75,14.0,350,49,301,jp
482,theend100,DIAMOND IV,75,11.3,388,44,344,jp
483,やなせ TKS,DIAMOND IV,75,16.3,263,43,220,jp
484,ハジラミ,DIAMOND IV,75,14.6,288,42,246,jp
485,Father Christmas,DIAMOND IV,75,16.9,243,41,202,jp
486,shabtyu,DIAMOND IV,75,16.1,255,41,214,jp
487,チンChinn充電,DIAMOND IV,75,15.9,232,37,195,jp
488,wsb,DIAMOND IV,75,14.1,262,37,225,jp
489,四月は君のウソだ,DIAMOND IV,75,15.1,239,36,203,jp
490,lllIIllIIlllII,DIAMOND IV,75,14.6,246,36,210,jp
491,hachi64,DIAMOND IV,75,12.4,274,34,240,jp
492,Inagibukit,DIAMOND IV,75,11.4,299,34,265,jp
493,アングリーチキン,DIAMOND IV,75,17.8,169,30,139,jp
494,hinekura,DIAMOND IV,75,14.8,189,28,161,jp
495,horoTFT,DIAMOND IV,75,10.0,269,27,242,jp
496,たまごのこまた,DIAMOND IV,75,14.5,179,26,153,jp
497,6456tft,DIAMOND IV,75,35.7,70,25,45,jp
498,leben22,DIAMOND IV,75,18.1,138,25,113,jp
499,lunar328,DIAMOND IV,75,13.8,181,25,156,jp
500,R894式,DIAMOND IV,75,9.3,269,25,244,jp
1,AFTV 꼴픽이,CHALLENGER I,1685,19.2,1014,195,819,kr
2,곰과제리2,CHALLENGER I,1627,20.2,312,63,249,kr
3,김린Or남친,CHALLENGER I,1503,18.0,890,160,730,kr
4,스트롱뽀송뽀송,CHALLENGER I,1456,15.1,958,145,813,kr
5,정동글2,CHALLENGER I,1452,18.6,327,61,266,kr
6,홀애비2,CHALLENGER I,1429,18.9,1006,190,816,kr
7,정동글,CHALLENGER I,1412,17.8,596,106,490,kr
8,퐈피는잘못없어,CHALLENGER I,1372,17.6,1187,209,978,kr
9,노마딕,CHALLENGER I,1327,17.8,645,115,530,kr
10,청정민,CHALLENGER I,1304,14.4,1311,189,1122,kr
11,곰과제리,CHALLENGER I,1269,18.4,833,153,680,kr
12,럭키체스777,CHALLENGER I,1242,13.5,681,92,589,kr
13,AFTV 웃바,CHALLENGER I,1240,18.1,585,106,479,kr
14,난몰라,CHALLENGER I,1239,17.2,431,74,357,kr
15,난몰라2,CHALLENGER I,1222,13.0,508,66,442,kr
16,체주미,CHALLENGER I,1203,17.6,307,54,253,kr
17,펠새로이,CHALLENGER I,1201,18.1,733,133,600,kr
18,shungjinsoo,CHALLENGER I,1193,17.9,886,159,727,kr
19,SanChess,CHALLENGER I,1173,17.1,572,98,474,kr
20,알레 델리,CHALLENGER I,1164,23.2,280,65,215,kr
21,BAAMM,CHALLENGER I,1149,18.8,1270,239,1031,kr
22,shungjinsoo2,CHALLENGER I,1141,16.8,457,77,380,kr
23,아기용1,CHALLENGER I,1135,19.9,1615,321,1294,kr
24,Alle Deli,CHALLENGER I,1124,14.8,487,72,415,kr
25,Cherryon,CHALLENGER I,1109,15.4,903,139,764,kr
26,기도메타777,CHALLENGER I,1091,14.1,334,47,287,kr
27,두니주니,CHALLENGER I,1076,18.3,1305,239,1066,kr
28,화살 세례,CHALLENGER I,1058,17.1,694,119,575,kr
29,알맹승지,CHALLENGER I,1051,11.7,599,70,529,kr
30,피노키훈,CHALLENGER I,1045,18.4,815,150,665,kr
31,TZ 제리,CHALLENGER I,1045,14.6,608,89,519,kr
32,깽 만,CHALLENGER I,1033,13.2,823,109,714,kr
33,바삭한빵,CHALLENGER I,1032,18.1,464,84,380,kr
34,Park Eunbin,CHALLENGER I,1032,17.2,464,80,384,kr
35,곰과제리3,CHALLENGER I,1018,16.1,391,63,328,kr
36,마스터 3,CHALLENGER I,1017,10.5,848,89,759,kr
37,종자잇,CHALLENGER I,1014,16.3,410,67,343,kr
38,축 꾸,CHALLENGER I,1004,18.2,831,151,680,kr
39,포식자원툴,CHALLENGER I,995,15.4,939,145,794,kr
40,끓인사발면,CHALLENGER I,971,19.8,378,75,303,kr
41,Fiora TOP,CHALLENGER I,965,12.6,629,79,550,kr
42,머리한입꼬리한입,CHALLENGER I,948,16.4,1018,167,851,kr
43,My Paradise,CHALLENGER I,944,23.2,751,174,577,kr
44,왜 나만 운없냐,CHALLENGER I,937,17.8,348,62,286,kr
45,IIIlllIIIlllII,CHALLENGER I,921,11.3,1321,150,1171,kr
46,코스모TV,CHALLENGER I,910,17.1,697,119,578,kr
47,펠 다,CHALLENGER I,902,23.7,401,95,306,kr
48,카시장인 삿카시,CHALLENGER I,901,14.8,426,63,363,kr
49,패트롤원툴,CHALLENGER I,895,17.2,640,110,530,kr
50,prexis,CHALLENGER I,892,11.0,1062,117,945,kr
51,사랑해꿀아,CHALLENGER I,889,15.1,575,87,488,kr
52,현이야아아,CHALLENGER I,888,13.1,817,107,710,kr
53,정동기리,CHALLENGER I,871,17.4,305,53,252,kr
54,최killing,CHALLENGER I,853,12.4,709,88,621,kr
55,김유Or,CHALLENGER I,853,16.6,464,77,387,kr
56,안산시청,CHALLENGER I,849,17.2,535,92,443,kr
57,hiimg4nmi,CHALLENGER I,844,15.0,802,120,682,kr
58,꽃피그,CHALLENGER I,842,18.4,282,52,230,kr
59,안지영,CHALLENGER I,841,18.3,339,62,277,kr
60,Gritor,CHALLENGER I,835,16.3,1279,209,1070,kr
61,롤체고오수,CHALLENGER I,833,17.1,234,40,194,kr
62,푸딩턱털낼름낼름,CHALLENGER I,832,19.6,322,63,259,kr
63,내가더사기얍,CHALLENGER I,830,15.9,514,82,432,kr
64,로자이어,CHALLENGER I,824,12.7,683,87,596,kr
65,TFT 너밤,CHALLENGER I,821,18.7,481,90,391,kr
66,킨드레드블루그린,CHALLENGER I,812,17.2,785,135,650,kr
67,천득 Youtube,CHALLENGER I,812,16.3,404,66,338,kr
68,천 득,CHALLENGER I,811,14.0,420,59,361,kr
69,woiwoer12,CHALLENGER I,810,16.0,956,153,803,kr
70,궁뎅크니,CHALLENGER I,810,14.5,710,103,607,kr
71,귀여운나르자나,CHALLENGER I,799,22.6,618,140,478,kr
72,그레이스바라기,CHALLENGER I,799,14.5,304,44,260,kr
73,보이지않는기물,CHALLENGER I,787,18.6,474,88,386,kr
74,버그활용법,CHALLENGER I,785,26.1,280,73,207,kr
75,개 북,CHALLENGER I,781,18.0,417,75,342,kr
76,초보끼리합시다,CHALLENGER I,780,14.3,764,109,655,kr
77,랑조췻,CHALLENGER I,779,11.6,1449,168,1281,kr
78,Everton FAN,CHALLENGER I,779,11.3,362,41,321,kr
79,끓인사발면2,CHALLENGER I,773,23.8,214,51,163,kr
80,빅머니장사장,CHALLENGER I,772,18.1,442,80,362,kr
81,Eunso,CHALLENGER I,770,14.9,1019,152,867,kr
82,체스보이민다빈,CHALLENGER I,767,17.2,1315,226,1089,kr
83,고유나,CHALLENGER I,766,16.4,422,69,353,kr
84,바위게줍기장인,CHALLENGER I,763,15.2,874,133,741,kr
85,Younna,CHALLENGER I,759,21.2,184,39,145,kr
86,Keane Tft,CHALLENGER I,758,19.9,186,37,149,kr
87,원도깨비,CHALLENGER I,757,14.7,504,74,430,kr
88,종범1,CHALLENGER I,757,17.8,247,44,203,kr
89,지하닝2,CHALLENGER I,756,19.4,612,119,493,kr
90,챌린저라닉변함,CHALLENGER I,752,11.6,869,101,768,kr
91,꼴픽이 Youtube,CHALLENGER I,751,21.3,183,39,144,kr
92,귀여운쫑이자나,CHALLENGER I,747,16.1,826,133,693,kr
93,15조현지,CHALLENGER I,743,22.1,307,68,239,kr
94,옴팡이,CHALLENGER I,741,19.7,1485,292,1193,kr
95,TFT Xion,CHALLENGER I,741,13.7,1136,156,980,kr
96,lxry,CHALLENGER I,736,14.0,236,33,203,kr
97,Mongri,CHALLENGER I,732,16.4,1336,219,1117,kr
98,Dosu,CHALLENGER I,731,14.2,282,40,242,kr
99,90972114del,CHALLENGER I,729,16.0,1008,161,847,kr
100,시루시루해,CHALLENGER I,725,15.9,687,109,578,kr
101,전설의소라고동,CHALLENGER I,724,15.4,746,115,631,kr
102,TZ 제리쌤,CHALLENGER I,723,16.0,294,47,247,kr
103,찬란하고찬란하게,CHALLENGER I,718,12.4,1131,140,991,kr
104,엠브로돈까스,CHALLENGER I,717,18.0,1497,270,1227,kr
105,AFTV 구루루,CHALLENGER I,714,14.8,1300,193,1107,kr
106,롤접으면여친생김,CHALLENGER I,707,18.0,327,59,268,kr
107,노래하는 쭌,CHALLENGER I,706,10.7,804,86,718,kr
108,안 졍,CHALLENGER I,706,16.4,365,60,305,kr
109,유후a,CHALLENGER I,704,17.1,596,102,494,kr
110,알맹승지2,CHALLENGER I,699,10.5,474,50,424,kr
111,Pnaz,CHALLENGER I,695,29.7,222,66,156,kr
112,줘 너,CHALLENGER I,692,13.4,1045,140,905,kr
113,잉꾸잉꾸잉꾸,CHALLENGER I,691,15.0,700,105,595,kr
114,이집트신화,CHALLENGER I,685,13.0,713,93,620,kr
115,오면 딴다,CHALLENGER I,683,13.5,787,106,681,kr
116,AFTV 깔창부린,CHALLENGER I,682,16.1,1770,286,1484,kr
117,AFTV로얄,CHALLENGER I,677,12.1,1097,133,964,kr
118,possible,CHALLENGER I,677,15.9,527,84,443,kr
119,욕한번채금한번,CHALLENGER I,675,19.6,668,131,537,kr
120,포포도쓰,CHALLENGER I,673,14.3,813,116,697,kr
121,Why do I live,CHALLENGER I,671,17.0,577,98,479,kr
122,TZ 코그멍,CHALLENGER I,671,16.8,423,71,352,kr
123,게므론,CHALLENGER I,670,9.8,927,91,836,kr
124,패트롤원툴2,CHALLENGER I,668,14.7,712,105,607,kr
125,Blanker,CHALLENGER I,667,17.5,770,135,635,kr
126,WE CAN WlN,CHALLENGER I,666,17.3,537,93,444,kr
127,호랑이찌찌젖짜기,CHALLENGER I,664,15.6,539,84,455,kr
128,k1moddi,CHALLENGER I,659,18.3,213,39,174,kr
129,안하기로했자나,CHALLENGER I,658,16.9,319,54,265,kr
130,김음주,CHALLENGER I,657,14.1,767,108,659,kr
131,FateGrand5rder,CHALLENGER I,655,9.3,1132,105,1027,kr
132,혹시그거아냐,CHALLENGER I,655,14.2,387,55,332,kr
133,Roik,CHALLENGER I,652,28.0,132,37,95,kr
134,쓰레쉬핵초고수,CHALLENGER I,651,14.6,800,117,683,kr
135,아갈머리를콰악,CHALLENGER I,650,22.5,204,46,158,kr
136,앗 추워,CHALLENGER I,647,15.0,731,110,621,kr
137,우디르디르,CHALLENGER I,647,15.0,652,98,554,kr
138,참새년,CHALLENGER I,645,13.9,546,76,470,kr
139,조치타칫쿵칫타,CHALLENGER I,638,9.6,407,39,368,kr
140,주나식,CHALLENGER I,636,17.6,244,43,201,kr
141,곽예림,CHALLENGER I,634,12.3,950,117,833,kr
142,오지마요제발,CHALLENGER I,633,11.5,992,114,878,kr
143,치약소년,CHALLENGER I,633,15.5,252,39,213,kr
144,대위 리정혁,CHALLENGER I,632,14.5,605,88,517,kr
145,삐진범,CHALLENGER I,631,14.9,242,36,206,kr
146,last40ne,CHALLENGER I,630,19.1,141,27,114,kr
147,조치타치,CHALLENGER I,629,10.5,792,83,709,kr
148,시즌2대한민국1등,CHALLENGER I,629,15.3,535,82,453,kr
149,미어캣군,CHALLENGER I,629,13.1,428,56,372,kr
150,땅콩달콤,CHALLENGER I,628,15.2,505,77,428,kr
151,proooa,CHALLENGER I,625,16.3,514,84,430,kr
152,깔딱깔딱,CHALLENGER I,624,18.1,785,142,643,kr
153,탑하겠습니다,CHALLENGER I,624,17.8,359,64,295,kr
154,카리조마,CHALLENGER I,623,17.7,513,91,422,kr
155,Ignited,CHALLENGER I,621,12.5,513,64,449,kr
156,YunHyeonSik,CHALLENGER I,618,12.6,364,46,318,kr
157,2000 11 12,CHALLENGER I,616,17.7,282,50,232,kr
158,남자는코멧,CHALLENGER I,614,13.1,390,51,339,kr
159,illilililli1,CHALLENGER I,614,16.3,252,41,211,kr
160,정밍호짱짱걸,CHALLENGER I,609,13.9,981,136,845,kr
161,EMP 모구,CHALLENGER I,609,15.8,438,69,369,kr
162,세번째차인달삼,CHALLENGER I,606,17.3,911,158,753,kr
163,Art DrucKer,CHALLENGER I,606,14.5,691,100,591,kr
164,지니쁘미,CHALLENGER I,605,15.6,275,43,232,kr
165,Trust me only,CHALLENGER I,604,11.0,471,52,419,kr
166,s3unguk,CHALLENGER I,602,14.6,547,80,467,kr
167,불꽃자잇 사생팬,CHALLENGER I,602,14.6,397,58,339,kr
168,멍청아린,CHALLENGER I,601,14.1,580,82,498,kr
169,봄날이갓두,CHALLENGER I,601,11.7,677,79,598,kr
170,대깨포식자,CHALLENGER I,601,13.6,447,61,386,kr
171,똥꼬에펜타킬,CHALLENGER I,596,11.3,405,46,359,kr
172,초식판다,CHALLENGER I,592,13.1,880,115,765,kr
173,길막장인,CHALLENGER I,592,18.0,412,74,338,kr
174,정 찰 돼,CHALLENGER I,591,12.2,433,53,380,kr
175,미래지향사나이,CHALLENGER I,590,15.8,637,101,536,kr
176,어런이222,CHALLENGER I,590,13.9,653,91,562,kr
177,미소왕,CHALLENGER I,590,13.8,630,87,543,kr
178,I Go Challenger,CHALLENGER I,590,14.9,369,55,314,kr
179,멀보노자슥아,CHALLENGER I,587,13.2,740,98,642,kr
180,뱅 탁,CHALLENGER I,586,12.3,496,61,435,kr
181,Schakal,CHALLENGER I,585,13.4,709,95,614,kr
182,이딴겜해주지마,CHALLENGER I,585,38.6,119,46,73,kr
183,Dpr live A,CHALLENGER I,584,14.7,177,26,151,kr
184,AF HappyVirus,CHALLENGER I,583,18.8,282,53,229,kr
185,혹혹훅훅훅,CHALLENGER I,583,13.0,322,42,280,kr
186,진이애완동물,CHALLENGER I,582,15.2,488,74,414,kr
187,Viento 9,CHALLENGER I,575,13.8,477,66,411,kr
188,02Mania,CHALLENGER I,574,17.7,344,61,283,kr
189,빠꾸 없이 빠끄,CHALLENGER I,572,9.8,714,70,644,kr
190,이Or름,CHALLENGER I,571,11.5,998,115,883,kr
191,르제스키,CHALLENGER I,571,17.3,578,100,478,kr
192,베가알쓰리짱,CHALLENGER I,570,13.7,670,92,578,kr
193,너말이야너1,CHALLENGER I,570,13.2,537,71,466,kr
194,요들시너지 룰루,CHALLENGER I,569,13.9,223,31,192,kr
195,쥬상이,CHALLENGER I,568,14.5,303,44,259,kr
196,똥줄타노스,CHALLENGER I,565,17.4,270,47,223,kr
197,달삼이빡빡라이즈,CHALLENGER I,564,14.2,633,90,543,kr
198,터틀 킴,CHALLENGER I,562,12.7,551,70,481,kr
199,AFTV 오대,CHALLENGER I,560,16.1,1417,228,1189,kr
200,V 6 6 V,CHALLENGER I,560,12.3,665,82,583,kr
201,도리찡,CHALLENGER I,559,16.1,534,86,448,kr
202,한겜하고말사이에,CHALLENGER I,554,14.1,789,111,678,kr
203,초급자우대,CHALLENGER I,554,14.3,195,28,167,kr
204,물 배,CHALLENGER I,553,13.1,604,79,525,kr
205,초콜렛공장,CHALLENGER I,553,12.7,353,45,308,kr
206,최 석,CHALLENGER I,553,22.3,193,43,150,kr
207,Daeju imp,CHALLENGER I,553,9.8,437,43,394,kr
208,오우거 돌주먹,CHALLENGER I,550,15.8,562,89,473,kr
209,yunhyunsik,CHALLENGER I,550,17.9,347,62,285,kr
210,눈부신 날,CHALLENGER I,550,16.1,341,55,286,kr
211,AFTV 제로겟,CHALLENGER I,547,9.3,1745,163,1582,kr
212,놀릴준비 끝,CHALLENGER I,547,17.2,244,42,202,kr
213,사뢍해2,CHALLENGER I,543,14.9,483,72,411,kr
214,꽝 백,CHALLENGER I,542,15.6,505,79,426,kr
215,오에리,CHALLENGER I,542,13.5,370,50,320,kr
216,검은비,CHALLENGER I,541,17.1,344,59,285,kr
217,뚱인라구여,CHALLENGER I,536,14.8,701,104,597,kr
218,23세 홍삼길,CHALLENGER I,534,13.6,690,94,596,kr
219,TFT어캣,CHALLENGER I,534,16.8,279,47,232,kr
220,귀여운피즈자나,CHALLENGER I,532,13.4,702,94,608,kr
221,아 갓 씨,CHALLENGER I,532,14.2,493,70,423,kr
222,illililillili,CHALLENGER I,531,22.0,141,31,110,kr
223,개할거없네,CHALLENGER I,530,15.0,608,91,517,kr
224,원딜 좀 키워주자,CHALLENGER I,530,20.1,264,53,211,kr
225,사회관,CHALLENGER I,529,12.5,970,121,849,kr
226,신낫상우,CHALLENGER I,529,16.6,477,79,398,kr
227,고고브라덜,CHALLENGER I,528,15.1,636,96,540,kr
228,깡 백,CHALLENGER I,526,17.0,589,100,489,kr
229,System2,CHALLENGER I,526,22.7,361,82,279,kr
230,경진이,CHALLENGER I,526,16.4,422,69,353,kr
231,AFTV 백기사,CHALLENGER I,526,21.6,273,59,214,kr
232,백석대학교,CHALLENGER I,525,16.7,335,56,279,kr
233,ComeBack,CHALLENGER I,525,14.0,336,47,289,kr
234,노블마인드,CHALLENGER I,524,12.4,451,56,395,kr
235,항상던지지마라,CHALLENGER I,523,15.8,328,52,276,kr
236,TFT Sloth,CHALLENGER I,521,15.4,855,132,723,kr
237,neverf0rgOt,CHALLENGER I,521,12.2,671,82,589,kr
238,나혼산,CHALLENGER I,521,15.3,307,47,260,kr
239,설로재,CHALLENGER I,520,18.3,142,26,116,kr
240,지하닝여자친구,CHALLENGER I,518,17.9,296,53,243,kr
241,배틀그라운드좋아,CHALLENGER I,517,12.5,1217,152,1065,kr
242,칼바람 할아버지,CHALLENGER I,515,18.4,255,47,208,kr
243,sunken,CHALLENGER I,514,16.6,728,121,607,kr
244,육류만,CHALLENGER I,514,16.3,590,96,494,kr
245,bin physical,CHALLENGER I,512,13.1,697,91,606,kr
246,금빵갓,CHALLENGER I,512,12.7,496,63,433,kr
247,쿨한토니,CHALLENGER I,511,15.5,322,50,272,kr
248,갱구찡,CHALLENGER I,510,14.7,681,100,581,kr
249,더 비상한다,CHALLENGER I,510,12.9,364,47,317,kr
250,스펨선비,CHALLENGER I,509,12.3,562,69,493,kr
251,콩콩이는,CHALLENGER I,509,19.0,274,52,222,kr
252,발신짱,CHALLENGER I,508,11.8,696,82,614,kr
253,hyuk1,CHALLENGER I,508,16.4,341,56,285,kr
254,내가 미안훼,CHALLENGER I,508,16.9,189,32,157,kr
255,익 명 아 재,CHALLENGER I,507,19.4,614,119,495,kr
256,롤체실력겜,CHALLENGER I,507,15.6,467,73,394,kr
257,말파 3성,CHALLENGER I,507,12.9,564,73,491,kr
258,비비고김치,CHALLENGER I,507,8.8,467,41,426,kr
259,Dosu0,CHALLENGER I,507,18.1,204,37,167,kr
260,스킬 효과,CHALLENGER I,506,18.3,989,181,808,kr
261,dexxa,CHALLENGER I,504,11.3,1242,140,1102,kr
262,TFT뚝배기수집가,CHALLENGER I,503,13.1,643,84,559,kr
263,체스장인 렝가,CHALLENGER I,502,15.2,316,48,268,kr
264,재 온,CHALLENGER I,501,16.1,279,45,234,kr
265,AFTV 신부형,CHALLENGER I,500,10.3,1108,114,994,kr
266,당 언,CHALLENGER I,499,14.8,1094,162,932,kr
267,홍시띠,CHALLENGER I,498,17.9,414,74,340,kr
268,로또야놀자,CHALLENGER I,497,13.9,981,136,845,kr
269,기생벌레,CHALLENGER I,497,18.5,249,46,203,kr
270,그랜드킴,CHALLENGER I,494,15.2,762,116,646,kr
271,고추니 Tv,CHALLENGER I,494,12.9,897,116,781,kr
272,왕 자,CHALLENGER I,494,12.6,585,74,511,kr
273,총잡이그립다,CHALLENGER I,494,19.3,212,41,171,kr
274,TFT Let it Rain,CHALLENGER I,490,13.7,270,37,233,kr
275,갱뱅후,CHALLENGER I,488,14.6,520,76,444,kr
276,LAD 1,CHALLENGER I,488,13.1,527,69,458,kr
277,그냥시로,CHALLENGER I,486,17.5,599,105,494,kr
278,정말사랑해요,CHALLENGER I,485,9.3,568,53,515,kr
279,코리안조커테드창,CHALLENGER I,485,17.6,284,50,234,kr
280,TFT 1436,CHALLENGER I,485,15.2,276,42,234,kr
281,바닐라공장,CHALLENGER I,484,13.3,241,32,209,kr
282,FT아일랜드,CHALLENGER I,483,15.3,641,98,543,kr
283,콘쓰탄쯔,CHALLENGER I,483,13.5,430,58,372,kr
284,나랑랑이,CHALLENGER I,483,13.6,405,55,350,kr
285,지하닝,CHALLENGER I,483,33.8,139,47,92,kr
286,heals,CHALLENGER I,482,16.7,454,76,378,kr
287,Arsenal92,CHALLENGER I,482,11.6,620,72,548,kr
288,TZ 근영,CHALLENGER I,481,18.9,312,59,253,kr
289,A Prosecutor,CHALLENGER I,480,19.0,289,55,234,kr
290,장난감병정z,CHALLENGER I,479,15.9,832,132,700,kr
291,콩대congdae,CHALLENGER I,479,17.4,338,59,279,kr
292,Teufelhaft,CHALLENGER I,479,13.8,312,43,269,kr
293,TFT HAGWAN,CHALLENGER I,478,12.0,474,57,417,kr
294,개인랭버스기사,CHALLENGER I,477,14.6,591,86,505,kr
295,TR Zombi,CHALLENGER I,477,24.4,164,40,124,kr
296,정말싫어해요,CHALLENGER I,475,9.3,366,34,332,kr
297,롤토체스 강의,CHALLENGER I,464,17.0,265,45,220,kr
298,선대군,CHALLENGER I,461,12.9,481,62,419,kr
299,지하닝팬,CHALLENGER I,454,16.7,318,53,265,kr
300,Lalisa Manobal,CHALLENGER I,348,19.6,234,46,188,kr
301,팹시만 콜라,"GRANDMASTER I
G",478,15.6,320,50,270,kr
302,설화산 티모,"GRANDMASTER I
G",475,12.7,363,46,317,kr
303,설레는마음,"GRANDMASTER I
G",474,16.3,392,64,328,kr
304,지하닝youtube,"GRANDMASTER I
G",471,14.9,436,65,371,kr
305,현이야아,"GRANDMASTER I
G",471,14.6,219,32,187,kr
306,모델한당,"GRANDMASTER I
G",467,25.0,200,50,150,kr
307,백시니,"GRANDMASTER I
G",463,13.4,464,62,402,kr
308,without some,"GRANDMASTER I
G",461,15.2,211,32,179,kr
309,하낫 둘 숨었다,"GRANDMASTER I
G",455,21.0,162,34,128,kr
310,팬더랑놀자,"GRANDMASTER I
G",454,14.1,590,83,507,kr
311,칸체스TV,"GRANDMASTER I
G",451,13.3,413,55,358,kr
312,홀애비따까리,"GRANDMASTER I
G",442,21.4,173,37,136,kr
313,WAF부케,"GRANDMASTER I
G",438,22.8,145,33,112,kr
314,히릿싸이마세,"GRANDMASTER I
G",436,15.2,290,44,246,kr
315,TFT 시리,"GRANDMASTER I
G",435,14.4,839,121,718,kr
316,천득 fan,"GRANDMASTER I
G",433,12.1,1065,129,936,kr
317,AFTV이클립스,"GRANDMASTER I
G",431,19.7,497,98,399,kr
318,가면 따냐,"GRANDMASTER I
G",430,15.2,343,52,291,kr
319,SsGoi,"GRANDMASTER I
G",428,16.3,190,31,159,kr
320,준디네,"GRANDMASTER I
G",427,11.2,1184,133,1051,kr
321,미리리미리3,"GRANDMASTER I
G",427,18.7,182,34,148,kr
322,용욱아 물좀,"GRANDMASTER I
G",427,22.0,127,28,99,kr
323,멧돼지,"GRANDMASTER I
G",426,13.9,886,123,763,kr
324,Teukhan,"GRANDMASTER I
G",425,13.9,1097,153,944,kr
325,hyuk2,"GRANDMASTER I
G",425,12.8,560,72,488,kr
326,두마리의 토끼,"GRANDMASTER I
G",425,14.4,410,59,351,kr
327,bin wieder DA,"GRANDMASTER I
G",421,8.0,361,29,332,kr
328,DelisJin,"GRANDMASTER I
G",417,17.1,269,46,223,kr
329,탈맹은지능순이져,"GRANDMASTER I
G",416,13.2,280,37,243,kr
330,임육뎍,"GRANDMASTER I
G",413,14.8,548,81,467,kr
331,TFT ELLE,"GRANDMASTER I
G",413,16.1,373,60,313,kr
332,데굴데굴,"GRANDMASTER I
G",410,21.1,242,51,191,kr
333,불타는당근,"GRANDMASTER I
G",408,12.9,433,56,377,kr
334,제황산,"GRANDMASTER I
G",405,14.9,900,134,766,kr
335,토토로11,"GRANDMASTER I
G",405,11.8,756,89,667,kr
336,20세기배추,"GRANDMASTER I
G",404,14.8,574,85,489,kr
337,오늘도좋고,"GRANDMASTER I
G",404,11.9,521,62,459,kr
338,Khanchess,"GRANDMASTER I
G",404,18.4,309,57,252,kr
339,샐러리라면,"GRANDMASTER I
G",402,15.1,502,76,426,kr
340,90980619del,"GRANDMASTER I
G",400,16.8,653,110,543,kr
341,hide on bupyeong,"GRANDMASTER I
G",400,16.1,442,71,371,kr
342,이렇게 좋은 날,"GRANDMASTER I
G",399,14.1,575,81,494,kr
343,지르반4살,"GRANDMASTER I
G",398,16.9,561,95,466,kr
344,부스커,"GRANDMASTER I
G",398,11.2,755,85,670,kr
345,인생을사는조진재,"GRANDMASTER I
G",398,14.5,317,46,271,kr
346,울집냥이양아치,"GRANDMASTER I
G",397,14.3,489,70,419,kr
347,두가지,"GRANDMASTER I
G",394,11.4,695,79,616,kr
348,참새년2,"GRANDMASTER I
G",391,20.7,174,36,138,kr
349,DouYu1958671,"GRANDMASTER I
G",389,14.6,383,56,327,kr
350,홈런볼리베어,"GRANDMASTER I
G",387,19.0,327,62,265,kr
351,장주현,"GRANDMASTER I
G",387,18.1,249,45,204,kr
352,TOP하겠습니다,"GRANDMASTER I
G",385,17.0,529,90,439,kr
353,TZ 홀리,"GRANDMASTER I
G",383,19.5,333,65,268,kr
354,꼐 속,"GRANDMASTER I
G",382,13.8,702,97,605,kr
355,허른이,"GRANDMASTER I
G",382,12.6,507,64,443,kr
356,꿀항아리,"GRANDMASTER I
G",381,14.5,373,54,319,kr
357,Mid Hernia,"GRANDMASTER I
G",378,15.1,345,52,293,kr
358,빠 꿈,"GRANDMASTER I
G",377,16.2,321,52,269,kr
359,나카모리 아키나,"GRANDMASTER I
G",376,12.3,568,70,498,kr
360,쪼해피롱,"GRANDMASTER I
G",375,19.4,939,182,757,kr
361,OHCLADDAB,"GRANDMASTER I
G",374,15.4,227,35,192,kr
362,정수옥빠,"GRANDMASTER I
G",372,15.7,345,54,291,kr
363,하와와 아담,"GRANDMASTER I
G",371,18.2,666,121,545,kr
364,성록썬더,"GRANDMASTER I
G",371,16.3,338,55,283,kr
365,CHESS BOY,"GRANDMASTER I
G",370,22.9,118,27,91,kr
366,족발당수,"GRANDMASTER I
G",363,19.4,160,31,129,kr
367,협 착,"GRANDMASTER I
G",362,17.4,242,42,200,kr
368,프리맥,"GRANDMASTER I
G",361,14.2,1034,147,887,kr
369,모지리궁상,"GRANDMASTER I
G",360,14.7,423,62,361,kr
370,맛좋은꿀,"GRANDMASTER I
G",359,16.1,689,111,578,kr
371,RICOH,"GRANDMASTER I
G",357,21.8,216,47,169,kr
372,진스턴,"GRANDMASTER I
G",356,12.2,806,98,708,kr
373,빛을 본 그림자,"GRANDMASTER I
G",355,13.8,643,89,554,kr
374,트위치 yuuubin,"GRANDMASTER I
G",353,13.6,295,40,255,kr
375,AFTV BIDULGI,"GRANDMASTER I
G",352,14.1,512,72,440,kr
376,호감형스킬샷,"GRANDMASTER I
G",352,22.5,138,31,107,kr
377,이순방,"GRANDMASTER I
G",351,11.5,894,103,791,kr
378,Jun Club,"GRANDMASTER I
G",351,25.0,164,41,123,kr
379,롤토체스asdf,"GRANDMASTER I
G",350,23.7,118,28,90,kr
380,불빠따쩝쩝이,"GRANDMASTER I
G",349,15.9,465,74,391,kr
381,야 연,"GRANDMASTER I
G",347,12.4,783,97,686,kr
382,고양이무한리필,"GRANDMASTER I
G",347,15.3,268,41,227,kr
383,범 원,"GRANDMASTER I
G",347,20.3,143,29,114,kr
384,볼베3성주셈,"GRANDMASTER I
G",345,14.9,857,128,729,kr
385,검눈이,"GRANDMASTER I
G",344,20.0,150,30,120,kr
386,마법공학소라고동,"GRANDMASTER I
G",343,19.6,582,114,468,kr
387,이류환,"GRANDMASTER I
G",342,13.4,232,31,201,kr
388,AFTV 빠따,"GRANDMASTER I
G",340,16.8,411,69,342,kr
389,KIMSEONIL,"GRANDMASTER I
G",337,15.8,266,42,224,kr
390,eunje0ng,"GRANDMASTER I
G",336,12.4,637,79,558,kr
391,saw and see,"GRANDMASTER I
G",336,14.1,546,77,469,kr
392,용국이꼬츄,"GRANDMASTER I
G",335,11.1,594,66,528,kr
393,why do i live2,"GRANDMASTER I
G",335,17.8,174,31,143,kr
394,돼지꼬리원숭이,"GRANDMASTER I
G",333,20.6,228,47,181,kr
395,이라로랑,"GRANDMASTER I
G",332,11.4,998,114,884,kr
396,야쿨르트,"GRANDMASTER I
G",331,13.5,459,62,397,kr
397,빛보다빠른빤스런,"GRANDMASTER I
G",331,14.7,238,35,203,kr
398,AFTV 전기시너지,"GRANDMASTER I
G",330,15.3,563,86,477,kr
399,미리리미리2,"GRANDMASTER I
G",329,13.5,274,37,237,kr
400,토토로조아,"GRANDMASTER I
G",328,17.5,228,40,188,kr
401,X Videos 방금봄,"GRANDMASTER I
G",326,14.3,1006,144,862,kr
402,AP Innovaticn,"GRANDMASTER I
G",325,14.8,311,46,265,kr
403,TFT홍스타,"GRANDMASTER I
G",325,24.4,156,38,118,kr
404,소브로,"GRANDMASTER I
G",323,15.9,371,59,312,kr
405,제토체스,"GRANDMASTER I
G",323,19.5,277,54,223,kr
406,궁디파,"GRANDMASTER I
G",323,15.5,239,37,202,kr
407,크 우,"GRANDMASTER I
G",322,16.1,392,63,329,kr
408,WAF,"GRANDMASTER I
G",322,25.8,190,49,141,kr
409,4px,"GRANDMASTER I
G",322,23.1,208,48,160,kr
410,AFTV 진혼곡2,"GRANDMASTER I
G",319,17.0,300,51,249,kr
411,버버니,"GRANDMASTER I
G",317,23.8,143,34,109,kr
412,2라2성,"GRANDMASTER I
G",316,16.2,407,66,341,kr
413,롤체하러왓어요,"GRANDMASTER I
G",315,15.3,523,80,443,kr
414,TFT 빠코,"GRANDMASTER I
G",315,16.7,408,68,340,kr
415,4픽얼굴벨코즈,"GRANDMASTER I
G",314,15.8,495,78,417,kr
416,Bongo Bong,"GRANDMASTER I
G",314,14.4,291,42,249,kr
417,빵상신,"GRANDMASTER I
G",313,16.9,455,77,378,kr
418,AFTV빙이,"GRANDMASTER I
G",312,13.8,624,86,538,kr
419,우리크,"GRANDMASTER I
G",309,15.4,720,111,609,kr
420,김준용1,"GRANDMASTER I
G",309,16.2,389,63,326,kr
421,춘드레드,"GRANDMASTER I
G",309,33.1,166,55,111,kr
422,전 짝 시,"GRANDMASTER I
G",309,12.3,445,55,390,kr
423,정신이있니없니,"GRANDMASTER I
G",309,14.4,160,23,137,kr
424,Ayaka,"GRANDMASTER I
G",308,15.4,481,74,407,kr
425,Danny 선생님,"GRANDMASTER I
G",307,13.1,658,86,572,kr
426,0l한울,"GRANDMASTER I
G",307,22.6,230,52,178,kr
427,DearMemory,"GRANDMASTER I
G",304,15.1,576,87,489,kr
428,The 진감,"GRANDMASTER I
G",302,13.1,1258,165,1093,kr
429,고릴라머리,"GRANDMASTER I
G",301,13.8,543,75,468,kr
430,카포포카,"GRANDMASTER I
G",301,14.1,411,58,353,kr
431,miguk,"GRANDMASTER I
G",300,19.1,204,39,165,kr
432,Oena,"GRANDMASTER I
G",299,13.5,519,70,449,kr
433,조 립,"GRANDMASTER I
G",299,15.4,273,42,231,kr
434,싱글벙글얍,"GRANDMASTER I
G",297,13.2,939,124,815,kr
435,JJ오렌지ll,"GRANDMASTER I
G",295,14.8,764,113,651,kr
436,집사야 나 츄르줘,"GRANDMASTER I
G",295,14.4,581,84,497,kr
437,무질량,"GRANDMASTER I
G",295,15.0,406,61,345,kr
438,모리가와,"GRANDMASTER I
G",294,11.7,515,60,455,kr
439,수원 나무늘보,"GRANDMASTER I
G",294,17.0,282,48,234,kr
440,오공 손,"GRANDMASTER I
G",292,16.4,843,138,705,kr
441,소크라테스v,"GRANDMASTER I
G",290,17.9,323,58,265,kr
442,프로젝트마스타이,"GRANDMASTER I
G",286,11.7,590,69,521,kr
443,검은눈썹,"GRANDMASTER I
G",285,12.5,384,48,336,kr
444,노랑닉,"GRANDMASTER I
G",285,15.8,279,44,235,kr
445,나만강아지없어힝,"GRANDMASTER I
G",284,14.2,400,57,343,kr
446,Autochesser,"GRANDMASTER I
G",283,13.8,443,61,382,kr
447,흑to the형,"GRANDMASTER I
G",283,14.3,314,45,269,kr
448,ChoRok,"GRANDMASTER I
G",282,15.4,260,40,220,kr
449,LlMITED,"GRANDMASTER I
G",280,12.4,169,21,148,kr
450,코그무,"GRANDMASTER I
G",277,12.4,875,109,766,kr
451,능가전역진까030,"GRANDMASTER I
G",277,12.4,671,83,588,kr
452,그저피할뿐,"GRANDMASTER I
G",275,18.1,298,54,244,kr
453,로리고수,"GRANDMASTER I
G",274,14.7,476,70,406,kr
454,itstoy,"GRANDMASTER I
G",274,14.0,372,52,320,kr
455,진 형,"GRANDMASTER I
G",273,14.5,234,34,200,kr
456,에잉때려쳐,"GRANDMASTER I
G",272,21.8,124,27,97,kr
457,갱따위 귀찮아,"GRANDMASTER I
G",271,15.0,593,89,504,kr
458,tV motolora,"GRANDMASTER I
G",270,7.8,1303,101,1202,kr
459,부산대 신의주,"GRANDMASTER I
G",270,12.6,435,55,380,kr
460,호로방망이,"GRANDMASTER I
G",269,15.6,838,131,707,kr
461,언더파치고싶엉,"GRANDMASTER I
G",269,16.4,292,48,244,kr
462,귀족찡,"GRANDMASTER I
G",269,22.4,165,37,128,kr
463,또옹쟁이,"GRANDMASTER I
G",268,12.9,278,36,242,kr
464,롱지호,"GRANDMASTER I
G",266,15.8,562,89,473,kr
465,AHin 데스,"GRANDMASTER I
G",266,19.0,369,70,299,kr
466,NaeID,"GRANDMASTER I
G",265,15.5,549,85,464,kr
467,헤카림버스,"GRANDMASTER I
G",264,13.0,299,39,260,kr
468,한가윤,"GRANDMASTER I
G",262,18.3,153,28,125,kr
469,secondMVP,"GRANDMASTER I
G",261,18.0,489,88,401,kr
470,Seonghun96,"GRANDMASTER I
G",261,12.6,514,65,449,kr
471,c cup,"GRANDMASTER I
G",259,14.4,415,60,355,kr
472,공주만의깃털기사,"GRANDMASTER I
G",259,12.8,420,54,366,kr
473,MantaStyle,"GRANDMASTER I
G",259,15.6,224,35,189,kr
474,밥똥롤체,"GRANDMASTER I
G",258,17.5,692,121,571,kr
475,입털면찾아서죽임,"GRANDMASTER I
G",257,13.2,227,30,197,kr
476,종 구 팔,"GRANDMASTER I
G",255,17.4,1041,181,860,kr
477,시나몬 국어,"GRANDMASTER I
G",255,13.5,607,82,525,kr
478,TZ제리2,"GRANDMASTER I
G",253,16.8,167,28,139,kr
479,벤치110키로,"GRANDMASTER I
G",252,19.2,287,55,232,kr
480,kimodd1,"GRANDMASTER I
G",251,16.6,241,40,201,kr
481,부 깽,"GRANDMASTER I
G",249,15.8,398,63,335,kr
482,냥냥권 고수,"GRANDMASTER I
G",246,14.7,1017,149,868,kr
483,Arky,"GRANDMASTER I
G",246,13.2,1130,149,981,kr
484,리스망,"GRANDMASTER I
G",245,12.0,752,90,662,kr
485,스트롱섹시,"GRANDMASTER I
G",245,21.2,179,38,141,kr
486,이시엘,"GRANDMASTER I
G",244,13.3,473,63,410,kr
487,Javacity Coffee,"GRANDMASTER I
G",244,17.5,228,40,188,kr
488,루 윈,"GRANDMASTER I
G",243,22.7,176,40,136,kr
489,빠빠빠삐삐,"GRANDMASTER I
G",243,16.7,120,20,100,kr
490,정글러s발련아,"GRANDMASTER I
G",241,16.2,600,97,503,kr
491,AFTV빙이저격수,"GRANDMASTER I
G",241,12.3,285,35,250,kr
492,밀턴프리드먼,"GRANDMASTER I
G",239,13.4,588,79,509,kr
493,알수없음1,"GRANDMASTER I
G",238,15.0,532,80,452,kr
494,메로나공장,"GRANDMASTER I
G",233,13.9,202,28,174,kr
495,붤 붤,"GRANDMASTER I
G",233,20.8,125,26,99,kr
496,따대남,"GRANDMASTER I
G",230,16.2,580,94,486,kr
497,silicic,"GRANDMASTER I
G",230,11.9,503,60,443,kr
498,파괴의신노틸러스,"GRANDMASTER I
G",229,11.5,817,94,723,kr
499,곰산당볼붕이,"GRANDMASTER I
G",229,15.9,308,49,259,kr
500,한남 이달룬,"GRANDMASTER I
G",227,15.7,502,79,423,kr
1,Tewesineitor,CHALLENGER I,1498,29.1,306,89,217,lan
2,Rayio,CHALLENGER I,1305,23.1,928,214,714,lan
3,akalyzer,CHALLENGER I,1279,26.7,688,184,504,lan
4,Líon,CHALLENGER I,1211,20.5,556,114,442,lan
5,Crycer,CHALLENGER I,1007,30.3,304,92,212,lan
6,Quantum8,CHALLENGER I,962,23.7,287,68,219,lan
7,CarryMe Akashi,CHALLENGER I,925,20.1,487,98,389,lan
8,SákuraHana,CHALLENGER I,921,32.6,224,73,151,lan
9,Yami Laicus,CHALLENGER I,896,27.7,303,84,219,lan
10,GhoStorm,CHALLENGER I,865,21.0,404,85,319,lan
11,NVS Bowen,CHALLENGER I,859,20.1,329,66,263,lan
12,bite of destiny,CHALLENGER I,771,21.2,538,114,424,lan
13,xBjaker,CHALLENGER I,768,20.8,308,64,244,lan
14,Cerealito,CHALLENGER I,753,18.3,409,75,334,lan
15,NVS Bowi,CHALLENGER I,685,23.1,242,56,186,lan
16,KilljoyMex,CHALLENGER I,652,23.1,242,56,186,lan
17,Ch1wy,CHALLENGER I,641,14.0,735,103,632,lan
18,Dal,CHALLENGER I,638,19.2,364,70,294,lan
19,lmlWarCrY,CHALLENGER I,629,21.7,300,65,235,lan
20,itken,CHALLENGER I,574,16.6,1010,168,842,lan
21,KiraDessu,CHALLENGER I,560,22.9,402,92,310,lan
22,MyzteryAlex,CHALLENGER I,557,12.5,944,118,826,lan
23,PipoMaster,CHALLENGER I,546,22.2,306,68,238,lan
24,QuiMi,CHALLENGER I,513,20.4,362,74,288,lan
25,MaRiO bRoS,CHALLENGER I,500,17.7,767,136,631,lan
26,RiftHerald,CHALLENGER I,495,17.7,209,37,172,lan
27,Dlanor,CHALLENGER I,484,20.9,444,93,351,lan
28,7DS HyperSpace,CHALLENGER I,476,21.7,1047,227,820,lan
29,Garto Ward,CHALLENGER I,475,17.6,319,56,263,lan
30,AztecMx,CHALLENGER I,475,13.4,238,32,206,lan
31,2D Jaro,CHALLENGER I,471,23.8,755,180,575,lan
32,Redmoonwolf,CHALLENGER I,448,11.9,354,42,312,lan
33,Hi im Clark,CHALLENGER I,431,22.6,288,65,223,lan
34,andmont,CHALLENGER I,418,19.7,264,52,212,lan
35,ianakin7,CHALLENGER I,415,18.2,781,142,639,lan
36,TftAcademy,CHALLENGER I,413,12.9,548,71,477,lan
37,Soul 1,CHALLENGER I,407,23.4,256,60,196,lan
38,Sealcune Mbappé,CHALLENGER I,406,19.0,563,107,456,lan
39,Lysıthea,CHALLENGER I,400,23.2,371,86,285,lan
40,shiry,CHALLENGER I,394,19.8,273,54,219,lan
41,Exus,CHALLENGER I,392,21.5,288,62,226,lan
42,melizaX,CHALLENGER I,390,17.4,338,59,279,lan
43,Im not villo,CHALLENGER I,389,21.0,366,77,289,lan
44,Ardén,CHALLENGER I,389,12.6,532,67,465,lan
45,KllK EditZ,CHALLENGER I,389,18.1,288,52,236,lan
46,Mr Mugui,CHALLENGER I,381,17.1,1020,175,845,lan
47,JOnnyLR,CHALLENGER I,376,17.1,357,61,296,lan
48,AntonyGamingTFT,CHALLENGER I,374,15.5,489,76,413,lan
49,TheBadMF,CHALLENGER I,363,16.9,350,59,291,lan
50,Slix,CHALLENGER I,345,24.6,175,43,132,lan
51,Quántum,"GRANDMASTER I
G",407,23.6,174,41,133,lan
52,Garchomp,"GRANDMASTER I
G",356,27.4,186,51,135,lan
53,Frondavil,"GRANDMASTER I
G",346,15.7,432,68,364,lan
54,Vampiro Playero,"GRANDMASTER I
G",346,19.0,310,59,251,lan
55,warlocksky,"GRANDMASTER I
G",328,14.6,253,37,216,lan
56,Kurokoba,"GRANDMASTER I
G",323,19.0,179,34,145,lan
57,oliver10,"GRANDMASTER I
G",305,19.2,271,52,219,lan
58,thewghost,"GRANDMASTER I
G",302,24.4,197,48,149,lan
59,Putint,"GRANDMASTER I
G",293,19.5,266,52,214,lan
60,Siempremuerto,"GRANDMASTER I
G",291,15.3,340,52,288,lan
61,No soy exoor,"GRANDMASTER I
G",267,25.1,175,44,131,lan
62,Gio9811,"GRANDMASTER I
G",255,15.7,236,37,199,lan
63,Gargota,"GRANDMASTER I
G",252,21.5,297,64,233,lan
64,Maguita,"GRANDMASTER I
G",248,18.1,332,60,272,lan
65,Too Sweet,"GRANDMASTER I
G",243,25.9,131,34,97,lan
66,PoronghaNegra,"GRANDMASTER I
G",234,17.1,397,68,329,lan
67,Revengp,"GRANDMASTER I
G",231,20.7,217,45,172,lan
68,CrisT1an,"GRANDMASTER I
G",228,22.5,169,38,131,lan
69,Rambotehamatado,"GRANDMASTER I
G",227,16.1,434,70,364,lan
70,Main Q,"GRANDMASTER I
G",227,19.6,281,55,226,lan
71,ransabia,"GRANDMASTER I
G",224,14.4,626,90,536,lan
72,Dondenuncias,"GRANDMASTER I
G",218,28.6,161,46,115,lan
73,TFT Lelouch,"GRANDMASTER I
G",218,14.2,260,37,223,lan
74,Marenn,"GRANDMASTER I
G",207,13.6,287,39,248,lan
75,NAOS911,"GRANDMASTER I
G",206,11.6,614,71,543,lan
76,javia316,"GRANDMASTER I
G",203,15.2,487,74,413,lan
77,Cleopatro,"GRANDMASTER I
G",201,34.3,105,36,69,lan
78,Need more skins,"GRANDMASTER I
G",195,15.4,376,58,318,lan
79,Cjddd,"GRANDMASTER I
G",194,15.8,221,35,186,lan
80,Psend,"GRANDMASTER I
G",190,19.7,198,39,159,lan
81,G2 Josar,"GRANDMASTER I
G",186,19.1,335,64,271,lan
82,Xkorzo YT,"GRANDMASTER I
G",177,28.4,95,27,68,lan
83,LiL Exoor,"GRANDMASTER I
G",176,23.9,201,48,153,lan
84,Warblo,"GRANDMASTER I
G",174,24.4,405,99,306,lan
85,25356,"GRANDMASTER I
G",172,16.9,307,52,255,lan
86,Twistä,"GRANDMASTER I
G",168,10.8,353,38,315,lan
87,Rodo TFT,"GRANDMASTER I
G",164,15.9,239,38,201,lan
88,Khorge,"GRANDMASTER I
G",156,19.7,132,26,106,lan
89,panchoAngüis,"GRANDMASTER I
G",153,23.5,306,72,234,lan
90,Khorge PN,"GRANDMASTER I
G",145,19.0,210,40,170,lan
91,Vork,"GRANDMASTER I
G",144,15.1,443,67,376,lan
92,llArthzll,"GRANDMASTER I
G",142,23.9,331,79,252,lan
93,Pompo,"GRANDMASTER I
G",142,18.0,345,62,283,lan
94,Ucr,"GRANDMASTER I
G",139,14.6,377,55,322,lan
95,Jir0,"GRANDMASTER I
G",138,15.7,504,79,425,lan
96,zeiik,"GRANDMASTER I
G",138,16.9,267,45,222,lan
97,liou,"GRANDMASTER I
G",136,17.6,131,23,108,lan
98,FordHealer,"GRANDMASTER I
G",135,27.0,74,20,54,lan
99,McGregorr,"GRANDMASTER I
G",132,18.8,420,79,341,lan
100,Stupefy,"GRANDMASTER I
G",123,13.2,440,58,382,lan
101,JONN93,"GRANDMASTER I
G",122,13.1,595,78,517,lan
102,Pushesz,"GRANDMASTER I
G",117,18.7,348,65,283,lan
103,AbrahamBM,"GRANDMASTER I
G",117,16.8,191,32,159,lan
104,lkokito,"GRANDMASTER I
G",116,18.4,418,77,341,lan
105,ExtraWuiller,"GRANDMASTER I
G",116,14.3,245,35,210,lan
106,Pedro Bae,"GRANDMASTER I
G",113,24.6,349,86,263,lan
107,Nightlover,"GRANDMASTER I
G",109,17.3,330,57,273,lan
108,Pauleandro,"GRANDMASTER I
G",107,8.3,577,48,529,lan
109,xHeroskillx,"GRANDMASTER I
G",107,15.8,240,38,202,lan
110,Aletsis,"GRANDMASTER I
G",107,22.1,145,32,113,lan
111,WJ Rem,"GRANDMASTER I
G",106,15.3,306,47,259,lan
112,Phobosss,"GRANDMASTER I
G",105,14.4,348,50,298,lan
113,TheOnlyTeddy,"GRANDMASTER I
G",105,17.1,252,43,209,lan
114,Seìyu,"GRANDMASTER I
G",104,15.1,285,43,242,lan
115,No Mercy,"GRANDMASTER I
G",103,16.6,583,97,486,lan
116,TrafalgarL4w,"GRANDMASTER I
G",103,20.4,412,84,328,lan
117,TFT Ares,"GRANDMASTER I
G",102,11.0,547,60,487,lan
118,aeal99,"GRANDMASTER I
G",102,12.6,199,25,174,lan
119,lx Rayhad xl,"GRANDMASTER I
G",100,21.4,159,34,125,lan
120,rambo12345678,"GRANDMASTER I
G",99,14.7,523,77,446,lan
121,Skan011,"GRANDMASTER I
G",99,14.0,236,33,203,lan
122,lyonew,"GRANDMASTER I
G",98,13.7,504,69,435,lan
123,Chesspants,"GRANDMASTER I
G",97,18.8,197,37,160,lan
124,Dizzy DestroyLAN,"GRANDMASTER I
G",96,20.9,91,19,72,lan
125,Anivio,"GRANDMASTER I
G",95,16.7,288,48,240,lan
126,papusmaximus,"GRANDMASTER I
G",95,6.5,324,21,303,lan
127,bEiMáR,"GRANDMASTER I
G",91,13.6,797,108,689,lan
128,BarbeQ,"GRANDMASTER I
G",90,15.7,562,88,474,lan
129,GøldLyon,"GRANDMASTER I
G",90,16.5,309,51,258,lan
130,Skaaarl,"GRANDMASTER I
G",90,16.3,257,42,215,lan
131,TFTJefe,"GRANDMASTER I
G",89,14.8,283,42,241,lan
132,Desü,"GRANDMASTER I
G",87,14.6,478,70,408,lan
133,TheFenixx,"GRANDMASTER I
G",86,30.8,208,64,144,lan
134,Gatito Cósmıco,"GRANDMASTER I
G",85,17.6,239,42,197,lan
135,BarbieQ,"GRANDMASTER I
G",85,27.5,109,30,79,lan
136,ILY Elena Rubí,"GRANDMASTER I
G",85,23.9,113,27,86,lan
137,Cloud strife,"GRANDMASTER I
G",85,16.8,155,26,129,lan
138,socio2k,"GRANDMASTER I
G",83,18.0,311,56,255,lan
139,Don Stban,"GRANDMASTER I
G",80,21.7,129,28,101,lan
140,God JdGa,"GRANDMASTER I
G",78,23.1,359,83,276,lan
141,XiaoPo06,"GRANDMASTER I
G",74,13.4,581,78,503,lan
142,Vey,"GRANDMASTER I
G",73,16.9,219,37,182,lan
143,DragoFenix2,"GRANDMASTER I
G",70,16.0,293,47,246,lan
144,Venonmanzer,"GRANDMASTER I
G",70,10.6,265,28,237,lan
145,Moncho,"GRANDMASTER I
G",69,12.8,156,20,136,lan
146,GS Lancelot,"GRANDMASTER I
G",68,17.8,264,47,217,lan
147,l Moe l,"GRANDMASTER I
G",68,12.6,310,39,271,lan
148,EN1GMA,"GRANDMASTER I
G",44,18.1,784,142,642,lan
149,Apödaca,"GRANDMASTER I
G",31,25.7,265,68,197,lan
150,Power,"GRANDMASTER I
G",0,14.0,400,56,344,lan
151,ChinoRobin,MASTER I,109,24.5,245,60,185,lan
152,JoseM29,MASTER I,66,16.0,350,56,294,lan
153,Nebura,MASTER I,65,19.5,205,40,165,lan
154,96Cronus05,MASTER I,63,21.2,203,43,160,lan
155,soli hdz,MASTER I,62,17.3,427,74,353,lan
156,Tactics,MASTER I,57,7.2,919,66,853,lan
157,Awela Requiem,MASTER I,57,23.2,233,54,179,lan
158,Ęnder,MASTER I,54,16.5,176,29,147,lan
159,DLT Macloud,MASTER I,51,17.2,487,84,403,lan
160,JulesMont,MASTER I,50,21.2,231,49,182,lan
161,TheGearZ,MASTER I,50,11.7,180,21,159,lan
162,Stuff,MASTER I,49,14.0,386,54,332,lan
163,Lą Sultąną,MASTER I,49,28.7,94,27,67,lan
164,Frozte,MASTER I,48,17.9,223,40,183,lan
165,Orange,MASTER I,47,12.0,482,58,424,lan
166,D4nyle,MASTER I,46,14.1,1537,217,1320,lan
167,Arcaanine,MASTER I,45,10.7,590,63,527,lan
168,YaphetS Karma,MASTER I,44,23.0,165,38,127,lan
169,Mahito,MASTER I,44,23.7,114,27,87,lan
170,scarmg,MASTER I,43,20.0,350,70,280,lan
171,Lechuga Húmeda,MASTER I,42,16.7,252,42,210,lan
172,Wild Octupus,MASTER I,41,23.9,180,43,137,lan
173,Espemss,MASTER I,39,14.9,222,33,189,lan
174,Wamuu,MASTER I,38,17.4,379,66,313,lan
175,Danté,MASTER I,38,19.0,331,63,268,lan
176,NKG Madness,MASTER I,38,21.9,196,43,153,lan
177,Lą Mąscotą,MASTER I,38,15.2,151,23,128,lan
178,Fêderico,MASTER I,36,17.1,315,54,261,lan
179,DenisLuluch,MASTER I,35,16.1,359,58,301,lan
180,TOMATOFARMER535,MASTER I,35,9.4,614,58,556,lan
181,DHA Arslan,MASTER I,35,7.7,542,42,500,lan
182,HaganeNoren,MASTER I,34,20.5,215,44,171,lan
183,FjBlanco,MASTER I,32,17.7,362,64,298,lan
184,Marvelous,MASTER I,32,17.6,262,46,216,lan
185,diandi,MASTER I,31,19.0,258,49,209,lan
186,LaGoorda,MASTER I,31,18.1,155,28,127,lan
187,Enryu The Red,MASTER I,30,18.6,307,57,250,lan
188,Gizu,MASTER I,29,13.2,416,55,361,lan
189,chërlyn,MASTER I,28,23.4,320,75,245,lan
190,Devilx500,MASTER I,28,13.7,497,68,429,lan
191,Utephh,MASTER I,27,16.1,260,42,218,lan
192,Archi,MASTER I,27,12.7,237,30,207,lan
193,Dirmund,MASTER I,27,9.8,264,26,238,lan
194,El HuachicoIero,MASTER I,27,15.9,94,15,79,lan
195,Farek,MASTER I,26,12.9,659,85,574,lan
196,Tengen Uzui,MASTER I,26,22.7,198,45,153,lan
197,BlitzDance,MASTER I,25,18.2,148,27,121,lan
198,Camipson,MASTER I,24,15.0,233,35,198,lan
199,ALXNIGHT,MASTER I,23,15.8,366,58,308,lan
200,elchicolinux,MASTER I,22,15.8,247,39,208,lan
201,Šęcręt Aurôrą,MASTER I,21,14.2,288,41,247,lan
202,DiiimiTRY,MASTER I,19,19.1,188,36,152,lan
203,Wínter,MASTER I,17,17.6,205,36,169,lan
204,SotoOZoto,MASTER I,17,24.3,107,26,81,lan
205,Druu TFT,MASTER I,15,18.3,420,77,343,lan
206,Sorrento0,MASTER I,14,16.4,401,66,335,lan
207,GerrySaiyan15,MASTER I,14,15.6,282,44,238,lan
208,Ezcanør,MASTER I,14,13.4,299,40,259,lan
209,Sleepfer,MASTER I,13,13.5,791,107,684,lan
210,NTS Dr Edwin,MASTER I,13,14.2,169,24,145,lan
211,matazorros,MASTER I,12,19.8,192,38,154,lan
212,WilvySmile,MASTER I,11,15.4,747,115,632,lan
213,MXG JonhWonka,MASTER I,11,23.9,117,28,89,lan
214,JULK37,MASTER I,10,16.0,156,25,131,lan
215,ICostDRE,MASTER I,9,16.5,552,91,461,lan
216,Akua,MASTER I,9,17.4,201,35,166,lan
217,TaquitoAIPastor,MASTER I,9,18.1,149,27,122,lan
218,j41746943J,MASTER I,8,15.7,267,42,225,lan
219,DedosLocos7u7,MASTER I,8,14.4,250,36,214,lan
220,SKY Trafalgar,MASTER I,7,15.5,503,78,425,lan
221,Sëkker,MASTER I,7,20.8,216,45,171,lan
222,Kestoc,MASTER I,7,16.7,234,39,195,lan
223,AlXDXD,MASTER I,6,17.7,209,37,172,lan
224,LFT Zero,MASTER I,6,16.9,148,25,123,lan
225,Flexus,MASTER I,5,17.5,206,36,170,lan
226,Miguel Aleman,MASTER I,5,17.4,195,34,161,lan
227,juandotft,MASTER I,5,16.3,178,29,149,lan
228,darksiders9,MASTER I,5,14.1,205,29,176,lan
229,Porygon,MASTER I,5,23.4,111,26,85,lan
230,xXReyXx,MASTER I,4,16.5,260,43,217,lan
231,Scrum1233,MASTER I,3,17.5,309,54,255,lan
232,A K A DeckeR GNR,MASTER I,3,15.5,284,44,240,lan
233,VarelaG4M3R,MASTER I,3,9.2,467,43,424,lan
234,III    MÅC   III,MASTER I,2,11.0,593,65,528,lan
235,4manu4,MASTER I,2,15.1,291,44,247,lan
236,thor0077,MASTER I,2,14.1,198,28,170,lan
237,boli é corozo,MASTER I,2,22.2,99,22,77,lan
238,Drefaz,MASTER I,1,16.2,431,70,361,lan
239,Tømmy Wiseau,MASTER I,1,14.9,468,70,398,lan
240,MidGod,MASTER I,1,14.9,154,23,131,lan
241,Rcadillo,MASTER I,0,15.5,845,131,714,lan
242,JustAdc,MASTER I,0,15.8,653,103,550,lan
243,donberli,MASTER I,0,15.9,546,87,459,lan
244,Hittler Sama UwU,MASTER I,0,21.2,378,80,298,lan
245,ZyppoTFT,MASTER I,0,17.2,396,68,328,lan
246,Kyokenn,MASTER I,0,15.1,398,60,338,lan
247,EvilAgeent,MASTER I,0,17.0,336,57,279,lan
248,PAPILFOELREY,MASTER I,0,14.4,353,51,302,lan
249,ahsodan,MASTER I,0,14.8,332,49,283,lan
250,Volk13,MASTER I,0,12.8,350,45,305,lan
251,fciencias,MASTER I,0,16.5,255,42,213,lan
252,marcitox,MASTER I,0,16.0,250,40,210,lan
253,DL DIAMOND DL,MASTER I,0,13.2,281,37,244,lan
254,Farlicious,MASTER I,0,24.8,145,36,109,lan
255,Aguri Onishi,MASTER I,0,18.9,169,32,137,lan
256,V Draeko,MASTER I,0,10.0,300,30,270,lan
257,marduko,MASTER I,0,11.2,260,29,231,lan
258,GREIVIN,MASTER I,0,9.7,289,28,261,lan
259,Entei,DIAMOND I,93,21.6,148,32,116,lan
260,BoscoBramblefoot,DIAMOND I,90,19.0,237,45,192,lan
261,SabritasOriginal,DIAMOND I,89,19.9,292,58,234,lan
262,MIROLINDO,DIAMOND I,82,19.1,235,45,190,lan
263,itai yamete papa,DIAMOND I,82,17.8,242,43,199,lan
264,spymomkiller,DIAMOND I,79,15.7,236,37,199,lan
265,ºªº,DIAMOND I,77,18.9,371,70,301,lan
266,Sigma the black,DIAMOND I,76,10.4,298,31,267,lan
267,F Ë N R I R Wølf,DIAMOND I,76,16.3,153,25,128,lan
268,Hide øn bušh,DIAMOND I,75,18.3,923,169,754,lan
269,DreigonzxD,DIAMOND I,75,19.8,445,88,357,lan
270,Metapod69 3,DIAMOND I,75,17.8,411,73,338,lan
271,TierDany,DIAMOND I,75,21.3,338,72,266,lan
272,Apolden,DIAMOND I,75,14.0,506,71,435,lan
273,OblivionDrake,DIAMOND I,75,12.8,516,66,450,lan
274,Rafoski,DIAMOND I,75,10.7,561,60,501,lan
275,xXSenshouXx,DIAMOND I,75,21.1,266,56,210,lan
276,Karlosd6,DIAMOND I,75,19.6,265,52,213,lan
277,NVS Mlchael,DIAMOND I,75,23.7,207,49,158,lan
278,Luisillo senpai,DIAMOND I,75,16.1,304,49,255,lan
279,Tamarhindo,DIAMOND I,75,15.8,240,38,202,lan
280,Freakiest show,DIAMOND I,75,21.1,142,30,112,lan
281,TFT ransabia,DIAMOND I,75,27.2,103,28,75,lan
282,V Fénix,DIAMOND I,75,10.7,196,21,175,lan
283,XxsummaruuxX,DIAMOND I,75,12.5,120,15,105,lan
284,0 Horus,DIAMOND I,74,16.4,311,51,260,lan
285,EternalWarriorXD,DIAMOND I,74,21.8,206,45,161,lan
286,Ovejomaru,DIAMOND I,72,18.9,307,58,249,lan
287,Gallher,DIAMOND I,70,18.5,482,89,393,lan
288,Fherpaz,DIAMOND I,69,13.0,438,57,381,lan
289,El Rolox,DIAMOND I,67,25.4,114,29,85,lan
290,I N G L E,DIAMOND I,67,13.5,148,20,128,lan
291,DEMETRIOSKING,DIAMOND I,66,23.3,133,31,102,lan
292,Compa Kiki,DIAMOND I,66,16.4,140,23,117,lan
293,Crs Pursuit,DIAMOND I,64,15.2,302,46,256,lan
294,wolfteamx5,DIAMOND I,63,15.1,642,97,545,lan
295,TFT Kalo,DIAMOND I,63,10.5,733,77,656,lan
296,FeaT7,DIAMOND I,63,17.4,253,44,209,lan
297,Marrochet,DIAMOND I,61,11.6,310,36,274,lan
298,Cuervó,DIAMOND I,59,18.4,309,57,252,lan
299,Riflorez,DIAMOND I,58,11.6,913,106,807,lan
300,rakids,DIAMOND I,57,8.3,515,43,472,lan
301,Wukong Radiante,DIAMOND I,57,16.0,262,42,220,lan
302,Sopa e Mondongo,DIAMOND I,56,20.5,112,23,89,lan
303,Sr Escanor,DIAMOND I,54,15.7,325,51,274,lan
304,Llámame Minizyzz,DIAMOND I,53,17.0,194,33,161,lan
305,Enr1que,DIAMOND I,52,11.5,641,74,567,lan
306,Rkman,DIAMOND I,52,19.1,194,37,157,lan
307,gujet,DIAMOND I,52,16.7,209,35,174,lan
308,McNov4ec,DIAMOND I,52,18.8,144,27,117,lan
309,TeversomuchT,DIAMOND I,51,12.7,417,53,364,lan
310,ChrisVinsmoke,DIAMOND I,50,23.8,290,69,221,lan
311,DarkSpoiled,DIAMOND I,50,16.7,390,65,325,lan
312,very cute girl,DIAMOND I,50,20.0,310,62,248,lan
313,RedsKnight,DIAMOND I,50,18.1,337,61,276,lan
314,ElGuasoNPerú,DIAMOND I,50,14.3,399,57,342,lan
315,ccrixalis,DIAMOND I,50,17.6,295,52,243,lan
316,Pao Wang 595,DIAMOND I,50,17.4,299,52,247,lan
317,HoIIow Knight,DIAMOND I,50,14.2,352,50,302,lan
318,Konohá,DIAMOND I,50,17.7,271,48,223,lan
319,Frank,DIAMOND I,50,20.1,229,46,183,lan
320,Osorongo GG,DIAMOND I,50,19.6,230,45,185,lan
321,VGIA Manute,DIAMOND I,50,14.0,314,44,270,lan
322,Gral Torin,DIAMOND I,50,18.2,231,42,189,lan
323,edwardp00,DIAMOND I,50,17.1,239,41,198,lan
324,Play,DIAMOND I,50,11.6,335,39,296,lan
325,persian rugs,DIAMOND I,50,19.8,182,36,146,lan
326,OGT Sergio,DIAMOND I,50,19.7,183,36,147,lan
327,swarosky,DIAMOND I,50,14.3,252,36,216,lan
328,General Rou,DIAMOND I,50,24.6,142,35,107,lan
329,Senna Palmer,DIAMOND I,50,22.1,131,29,102,lan
330,JottaEle,DIAMOND I,50,12.8,210,27,183,lan
331,Hi im Zeuus,DIAMOND I,50,15.4,136,21,115,lan
332,Genesis IV,DIAMOND I,49,16.2,160,26,134,lan
333,YAYADC,DIAMOND I,48,12.6,175,22,153,lan
334,Sr Frito,DIAMOND I,47,15.3,432,66,366,lan
335,Bebessiitaaaa,DIAMOND I,47,15.5,386,60,326,lan
336,TheKinginelNorth,DIAMOND I,46,12.7,569,72,497,lan
337,Mr chane,DIAMOND I,44,17.1,362,62,300,lan
338,AriChan,DIAMOND I,43,10.7,270,29,241,lan
339,Cristhianhusk,DIAMOND I,42,17.6,410,72,338,lan
340,Spianda,DIAMOND I,42,20.8,279,58,221,lan
341,YokedWar,DIAMOND I,42,17.5,228,40,188,lan
342,Pelososo,DIAMOND I,42,15.7,230,36,194,lan
343,SayGGpls,DIAMOND I,41,15.0,525,79,446,lan
344,HuevoCrudo,DIAMOND I,41,14.3,460,66,394,lan
345,rubiinskey,DIAMOND I,41,20.7,237,49,188,lan
346,eldrit,DIAMOND I,41,16.6,295,49,246,lan
347,nikolaz9393,DIAMOND I,41,16.3,288,47,241,lan
348,Roy Mustang XD,DIAMOND I,41,12.9,340,44,296,lan
349,Dancho,DIAMOND I,41,16.3,245,40,205,lan
350,0 Torment,DIAMOND I,41,15.9,208,33,175,lan
351,Yagami Squall,DIAMOND I,38,15.2,368,56,312,lan
352,maykol06,DIAMOND I,38,17.4,230,40,190,lan
353,XMozart,DIAMOND I,38,13.1,236,31,205,lan
354,Kommless,DIAMOND I,38,17.1,175,30,145,lan
355,Dani Di Twitch,DIAMOND I,38,14.7,204,30,174,lan
356,Firelx,DIAMOND I,38,17.5,160,28,132,lan
357,Beerwish,DIAMOND I,37,15.0,667,100,567,lan
358,Betomofcydonia,DIAMOND I,37,12.0,308,37,271,lan
359,Sonagi,DIAMOND I,37,18.1,149,27,122,lan
360,Jei7,DIAMOND I,36,18.3,262,48,214,lan
361,Zoh Rain Munda,DIAMOND I,36,15.9,251,40,211,lan
362,Spooky boogie,DIAMOND I,36,10.5,277,29,248,lan
363,xMiguelOx,DIAMOND I,35,13.3,520,69,451,lan
364,ChupemElPrime,DIAMOND I,35,19.5,277,54,223,lan
365,jimmypagesoler,DIAMOND I,35,13.9,273,38,235,lan
366,WMG Vi,DIAMOND I,34,19.4,360,70,290,lan
367,Rey Menelao,DIAMOND I,34,15.1,451,68,383,lan
368,merrymaker,DIAMOND I,34,20.6,184,38,146,lan
369,Mitchaellkd,DIAMOND I,34,18.0,183,33,150,lan
370,Odinbel,DIAMOND I,33,8.8,557,49,508,lan
371,Nettlesome,DIAMOND I,33,11.1,334,37,297,lan
372,javordavor,DIAMOND I,32,18.8,186,35,151,lan
373,SugarSon69,DIAMOND I,31,17.9,363,65,298,lan
374,Happy brownnie,DIAMOND I,31,13.9,288,40,248,lan
375,God avenged,DIAMOND I,31,18.6,167,31,136,lan
376,JeremyHax,DIAMOND I,30,16.7,348,58,290,lan
377,Chowy,DIAMOND I,30,17.4,321,56,265,lan
378,ShonWick,DIAMOND I,30,16.7,227,38,189,lan
379,JIDEG,DIAMOND I,29,16.0,394,63,331,lan
380,PupusaDeQueso7u7,DIAMOND I,28,16.6,453,75,378,lan
381,Pan the bono,DIAMOND I,28,16.1,366,59,307,lan
382,Tyranarius,DIAMOND I,28,20.1,144,29,115,lan
383,ABjomies,DIAMOND I,27,18.3,575,105,470,lan
384,Zaxxkk,DIAMOND I,27,21.0,138,29,109,lan
385,Dark Room,DIAMOND I,26,13.8,448,62,386,lan
386,Dark Ceniza,DIAMOND I,26,15.0,266,40,226,lan
387,Adele,DIAMOND I,25,20.9,230,48,182,lan
388,KO iRushx,DIAMOND I,25,16.6,283,47,236,lan
389,Danith,DIAMOND I,25,20.0,165,33,132,lan
390,Tucus,DIAMOND I,25,10.5,267,28,239,lan
391,alberth321,DIAMOND I,25,9.8,275,27,248,lan
392,TFT Legend,DIAMOND I,25,36.8,68,25,43,lan
393,Ron Whiskey,DIAMOND I,25,16.7,120,20,100,lan
394,looljavier,DIAMOND I,24,14.8,209,31,178,lan
395,xPuxi Nike,DIAMOND I,24,12.0,258,31,227,lan
396,Dan Nassor,DIAMOND I,23,17.5,496,87,409,lan
397,Invyktus,DIAMOND I,23,12.9,224,29,195,lan
398,KidHellion,DIAMOND I,22,13.2,204,27,177,lan
399,Dont Lose Aru,DIAMOND I,21,13.5,341,46,295,lan
400,Zhørieg,DIAMOND I,21,17.5,200,35,165,lan
401,Funtreng,DIAMOND I,20,14.8,494,73,421,lan
402,TFT Cadix,DIAMOND I,20,15.9,420,67,353,lan
403,Nigel18,DIAMOND I,20,8.4,298,25,273,lan
404,XmagodiosX,DIAMOND I,19,16.4,201,33,168,lan
405,Mr 139610051704,DIAMOND I,19,15.2,145,22,123,lan
406,The Fhack23,DIAMOND I,18,15.9,848,135,713,lan
407,JotaJota507,DIAMOND I,18,10.7,915,98,817,lan
408,Canbun,DIAMOND I,18,19.2,318,61,257,lan
409,Melec,DIAMOND I,18,21.4,229,49,180,lan
410,DelvinBeltre,DIAMOND I,18,14.6,302,44,258,lan
411,captainfifi,DIAMOND I,18,20.2,94,19,75,lan
412,Right Cłick,DIAMOND I,17,16.5,430,71,359,lan
413,Odyn31,DIAMOND I,17,18.4,331,61,270,lan
414,DhannielUchiha,DIAMOND I,17,17.2,233,40,193,lan
415,SsyaelAporro,DIAMOND I,17,16.0,237,38,199,lan
416,Brazen,DIAMOND I,17,15.2,210,32,178,lan
417,CLK1,DIAMOND I,16,21.8,124,27,97,lan
418,Rak Hollow,DIAMOND I,16,13.5,178,24,154,lan
419,jjvanegask77,DIAMOND I,15,17.6,165,29,136,lan
420,Ðiaztavo,DIAMOND I,12,17.2,524,90,434,lan
421,HT Feeling Good,DIAMOND I,12,8.5,316,27,289,lan
422,INF Rohclem,DIAMOND I,12,12.8,188,24,164,lan
423,zBoanerGes,DIAMOND I,11,15.5,187,29,158,lan
424,FV oglam,DIAMOND I,10,17.9,207,37,170,lan
425,PATRlA,DIAMOND I,10,15.4,110,17,93,lan
426,Emili4n,DIAMOND I,9,27.9,305,85,220,lan
427,Hugalaoruga,DIAMOND I,8,19.4,227,44,183,lan
428,Churritoo,DIAMOND I,7,17.2,402,69,333,lan
429,WindUp Boy,DIAMOND I,7,20.1,314,63,251,lan
430,Fireyix,DIAMOND I,7,22.6,177,40,137,lan
431,Hide on Petare,DIAMOND I,7,27.4,117,32,85,lan
432,Bréak,DIAMOND I,6,26.0,308,80,228,lan
433,NedS3,DIAMOND I,6,16.4,378,62,316,lan
434,Gedo Yoch,DIAMOND I,5,16.9,154,26,128,lan
435,Epic Diozgor,DIAMOND I,4,15.8,284,45,239,lan
436,Souł,DIAMOND I,4,14.9,301,45,256,lan
437,Sakuno,DIAMOND I,4,20.3,187,38,149,lan
438,K0RZ0,DIAMOND I,4,18.2,181,33,148,lan
439,Loptyr,DIAMOND I,4,15.3,144,22,122,lan
440,xXLeagueOfFizzXx,DIAMOND I,3,19.5,873,170,703,lan
441,Almighty Nich,DIAMOND I,3,17.0,206,35,171,lan
442,Soy el Alemán,DIAMOND I,1,12.2,458,56,402,lan
443,Best Amumu Korea,DIAMOND I,1,18.5,260,48,212,lan
444,La Fiera Deidad,DIAMOND I,0,19.4,478,93,385,lan
445,WorstHierbaMala,DIAMOND I,0,21.2,433,92,341,lan
446,Secco,DIAMOND I,0,16.9,533,90,443,lan
447,moonify,DIAMOND I,0,15.0,487,73,414,lan
448,Crackie,DIAMOND I,0,12.1,588,71,517,lan
449,Unique Stylish,DIAMOND I,0,20.1,348,70,278,lan
450,BLACKCAMON,DIAMOND I,0,19.9,311,62,249,lan
451,Virgen Guadalupe,DIAMOND I,0,16.4,378,62,316,lan
452,Nikyu,DIAMOND I,0,21.8,275,60,215,lan
453,Da Fuking Rengar,DIAMOND I,0,19.5,307,60,247,lan
454,Agonys Embrace,DIAMOND I,0,16.5,346,57,289,lan
455,caguilarg96,DIAMOND I,0,20.5,273,56,217,lan
456,El Cholo Ivan 25,DIAMOND I,0,17.8,314,56,258,lan
457,FrogZero,DIAMOND I,0,23.9,230,55,175,lan
458,Yuuru,DIAMOND I,0,20.1,274,55,219,lan
459,Independent Cat,DIAMOND I,0,15.9,340,54,286,lan
460,Byaku Desu,DIAMOND I,0,21.7,230,50,180,lan
461,Noob Daniel,DIAMOND I,0,17.8,269,48,221,lan
462,ATG LEINHEART,DIAMOND I,0,15.1,317,48,269,lan
463,Des Lichts,DIAMOND I,0,16.4,262,43,219,lan
464,Seikap,DIAMOND I,0,11.7,367,43,324,lan
465,Diego Abraham SP,DIAMOND I,0,21.8,188,41,147,lan
466,Tocino,DIAMOND I,0,23.0,174,40,134,lan
467,RomaTroyano,DIAMOND I,0,20.5,195,40,155,lan
468,Leonidasfed,DIAMOND I,0,14.1,284,40,244,lan
469,El Dque,DIAMOND I,0,22.1,172,38,134,lan
470,crazy999666,DIAMOND I,0,16.8,226,38,188,lan
471,JhonWonka,DIAMOND I,0,20.2,183,37,146,lan
472,javierpe,DIAMOND I,0,19.8,187,37,150,lan
473,Possesiv,DIAMOND I,0,17.0,218,37,181,lan
474,S 3 K K I,DIAMOND I,0,16.7,222,37,185,lan
475,JeffBlack0619,DIAMOND I,0,14.4,249,36,213,lan
476,xDuke ł,DIAMOND I,0,19.9,176,35,141,lan
477,MG Japo,DIAMOND I,0,19.4,180,35,145,lan
478,RNG Ktr0,DIAMOND I,0,28.1,121,34,87,lan
479,Fayrer,DIAMOND I,0,15.4,221,34,187,lan
480,Níetzsche,DIAMOND I,0,27.3,121,33,88,lan
481,Seexy INFECTION,DIAMOND I,0,23.0,139,32,107,lan
482,Misaka Mikoto,DIAMOND I,0,21.4,145,31,114,lan
483,lSorol,DIAMOND I,0,19.5,149,29,120,lan
484,Gyró Zeppeli,DIAMOND I,0,18.1,160,29,131,lan
485,Chibs TFT,DIAMOND I,0,15.4,182,28,154,lan
486,SAV Nooba,DIAMOND I,0,17.9,151,27,124,lan
487,Topoyiyo100,DIAMOND I,0,15.8,164,26,138,lan
488,All for Øne,DIAMOND I,0,15.4,169,26,143,lan
489,OTP Rumble,DIAMOND I,0,15.7,159,25,134,lan
490,OTP Vladimir,DIAMOND I,0,16.8,143,24,119,lan
491,Frani,DIAMOND I,0,14.9,154,23,131,lan
492,ZOLE,DIAMOND I,0,12.2,188,23,165,lan
493,TSM Hiro,DIAMOND I,0,15.9,138,22,116,lan
494,edhson19,DIAMOND I,0,16.1,124,20,104,lan
495,Xero Mad,DIAMOND I,0,9.1,186,17,169,lan
496,Blach,DIAMOND I,0,17.6,91,16,75,lan
497,Lelauch,DIAMOND II,99,21.9,164,36,128,lan
498,R2FarwolD2,DIAMOND II,96,20.0,130,26,104,lan
499,Jaso 057,DIAMOND II,95,17.3,277,48,229,lan
500,MiauMiauMiau,DIAMOND II,95,15.5,297,46,251,lan
1,FaryaAndWoIyo,CHALLENGER I,1768,29.5,349,103,246,las
2,Shireen4,CHALLENGER I,1682,27.0,507,137,370,las
3,Kłaytøn,CHALLENGER I,1651,24.8,408,101,307,las
4,Tolengo73,CHALLENGER I,1225,27.2,519,141,378,las
5,S de Sencillo,CHALLENGER I,1115,18.7,1353,253,1100,las
6,JustDream,CHALLENGER I,1099,17.7,913,162,751,las
7,DarksBit,CHALLENGER I,993,24.0,254,61,193,las
8,UCH TheLiNe,CHALLENGER I,983,31.0,261,81,180,las
9,No Quarter,CHALLENGER I,852,21.4,387,83,304,las
10,Highroll,CHALLENGER I,848,20.2,647,131,516,las
11,Altenahue,CHALLENGER I,833,22.9,488,112,376,las
12,Samenix,CHALLENGER I,811,27.4,285,78,207,las
13,FuryTank,CHALLENGER I,768,21.7,327,71,256,las
14,Priend,CHALLENGER I,760,17.9,621,111,510,las
15,Fourloko RX,CHALLENGER I,726,21.4,276,59,217,las
16,CooLDownJJ,CHALLENGER I,696,25.0,296,74,222,las
17,LifesBadTFT,CHALLENGER I,691,21.7,258,56,202,las
18,Fan de la Linea,CHALLENGER I,681,25.5,192,49,143,las
19,Christus,CHALLENGER I,600,29.7,148,44,104,las
20,Changuito 10,CHALLENGER I,586,21.5,191,41,150,las
21,shuuumpy,CHALLENGER I,568,19.9,413,82,331,las
22,Dukie,CHALLENGER I,538,20.0,185,37,148,las
23,Jesus,CHALLENGER I,526,23.2,142,33,109,las
24,New Stage,CHALLENGER I,523,19.1,324,62,262,las
25,Girlfromnoxuss,CHALLENGER I,522,20.1,623,125,498,las
26,Bugame,CHALLENGER I,504,22.6,221,50,171,las
27,UCH Morfer,CHALLENGER I,498,17.6,290,51,239,las
28,RoSweL TacTicS,CHALLENGER I,484,14.8,899,133,766,las
29,Gara Arg,CHALLENGER I,444,18.8,399,75,324,las
30,Greyd0n,CHALLENGER I,440,13.6,413,56,357,las
31,Åzok,CHALLENGER I,438,15.9,433,69,364,las
32,Karnal,CHALLENGER I,417,14.9,522,78,444,las
33,TFT MMR Perfect,CHALLENGER I,409,17.4,529,92,437,las
34,Wazapper,CHALLENGER I,393,16.2,320,52,268,las
35,Nico Del Baño,CHALLENGER I,377,26.1,153,40,113,las
36,ChakoPopoco,CHALLENGER I,376,15.3,469,72,397,las
37,Cupiditas,CHALLENGER I,373,20.1,304,61,243,las
38,xiomax,CHALLENGER I,369,16.5,334,55,279,las
39,InvadersMD,CHALLENGER I,366,16.1,727,117,610,las
40,sendohrai,CHALLENGER I,365,18.1,309,56,253,las
41,AUGUSTOMARCO,CHALLENGER I,359,14.6,342,50,292,las
42,Lyked,CHALLENGER I,356,25.7,261,67,194,las
43,Rubik,CHALLENGER I,351,17.1,269,46,223,las
44,Gei Ye Si,CHALLENGER I,346,19.4,465,90,375,las
45,MorteMTW,CHALLENGER I,345,17.0,606,103,503,las
46,MättZ,CHALLENGER I,340,11.3,505,57,448,las
47,Fradox22,CHALLENGER I,332,21.3,188,40,148,las
48,ACÁ MANDO YO,CHALLENGER I,328,20.9,421,88,333,las
49,iudex Jevic,CHALLENGER I,323,17.6,728,128,600,las
50,100cityfico,CHALLENGER I,298,11.2,473,53,420,las
51,ANIMEWEEBLORD420,"GRANDMASTER I
G",361,26.5,132,35,97,las
52,Emad Joestar,"GRANDMASTER I
G",341,18.0,211,38,173,las
53,ROH inSec t0,"GRANDMASTER I
G",317,14.4,422,61,361,las
54,404NameeNotFound,"GRANDMASTER I
G",307,16.3,510,83,427,las
55,Don Galli,"GRANDMASTER I
G",300,19.6,158,31,127,las
56,Mr GFS Reaper,"GRANDMASTER I
G",299,22.0,482,106,376,las
57,ElbalmoR,"GRANDMASTER I
G",299,17.2,290,50,240,las
58,Raruto,"GRANDMASTER I
G",297,13.8,268,37,231,las
59,BC Thoryn,"GRANDMASTER I
G",288,21.1,223,47,176,las
60,ssbita,"GRANDMASTER I
G",285,18.6,306,57,249,las
61,RNGPDD,"GRANDMASTER I
G",285,24.8,109,27,82,las
62,hartung,"GRANDMASTER I
G",271,16.1,353,57,296,las
63,Xork,"GRANDMASTER I
G",263,20.5,443,91,352,las
64,Tr1ckster,"GRANDMASTER I
G",253,29.7,111,33,78,las
65,Cvictoria Bryant,"GRANDMASTER I
G",248,16.2,470,76,394,las
66,SouLXisT,"GRANDMASTER I
G",232,19.5,226,44,182,las
67,iForeverBronze,"GRANDMASTER I
G",227,16.7,795,133,662,las
68,StuPot,"GRANDMASTER I
G",223,16.8,292,49,243,las
69,RetoSuperado,"GRANDMASTER I
G",222,15.5,349,54,295,las
70,TwitchTVLifesBad,"GRANDMASTER I
G",203,26.5,151,40,111,las
71,Ryuuk Kyuu,"GRANDMASTER I
G",202,15.0,167,25,142,las
72,HeRz BenT,"GRANDMASTER I
G",191,19.5,328,64,264,las
73,JueguenNormal,"GRANDMASTER I
G",187,14.9,469,70,399,las
74,geoffroy123,"GRANDMASTER I
G",186,14.5,145,21,124,las
75,TWOEASY,"GRANDMASTER I
G",160,13.7,262,36,226,las
76,Dogor,"GRANDMASTER I
G",157,16.2,283,46,237,las
77,Rekatria,"GRANDMASTER I
G",157,17.9,218,39,179,las
78,Kozukî Oden,"GRANDMASTER I
G",156,12.2,237,29,208,las
79,QT FD,"GRANDMASTER I
G",152,17.7,576,102,474,las
80,KenMasters7,"GRANDMASTER I
G",146,23.1,143,33,110,las
81,Ghosty321,"GRANDMASTER I
G",144,14.6,405,59,346,las
82,Óxidos Basicos,"GRANDMASTER I
G",141,16.3,288,47,241,las
83,BolaDeLomo,"GRANDMASTER I
G",141,15.5,296,46,250,las
84,DONBOMBASTIC,"GRANDMASTER I
G",137,16.8,274,46,228,las
85,Zionooooo,"GRANDMASTER I
G",135,16.5,236,39,197,las
86,Dtoke Freestyler,"GRANDMASTER I
G",132,13.9,454,63,391,las
87,TOXIAS,"GRANDMASTER I
G",131,17.1,187,32,155,las
88,el ayuwóki,"GRANDMASTER I
G",126,14.9,482,72,410,las
89,Danielove,"GRANDMASTER I
G",125,14.2,360,51,309,las
90,animesenpai2,"GRANDMASTER I
G",125,14.6,253,37,216,las
91,ACD Doomleg,"GRANDMASTER I
G",122,15.0,600,90,510,las
92,xZaMaSx,"GRANDMASTER I
G",122,16.4,366,60,306,las
93,CodMeiro,"GRANDMASTER I
G",122,15.1,312,47,265,las
94,LuckyDuit,"GRANDMASTER I
G",120,16.3,282,46,236,las
95,Desgr4cia,"GRANDMASTER I
G",119,10.4,1010,105,905,las
96,Gaattsu,"GRANDMASTER I
G",116,12.9,535,69,466,las
97,YourGod22,"GRANDMASTER I
G",116,12.5,248,31,217,las
98,xaimmer,"GRANDMASTER I
G",115,16.8,507,85,422,las
99,Elsa Nito,"GRANDMASTER I
G",107,14.3,434,62,372,las
100,NachoG95,"GRANDMASTER I
G",106,16.9,492,83,409,las
101,CriXaLis,"GRANDMASTER I
G",106,17.7,429,76,353,las
102,Masul,"GRANDMASTER I
G",103,18.4,321,59,262,las
103,Broncelotee,"GRANDMASTER I
G",102,14.9,469,70,399,las
104,zaqlev,"GRANDMASTER I
G",101,18.0,266,48,218,las
105,Peronism,"GRANDMASTER I
G",94,14.8,283,42,241,las
106,EMiguel,"GRANDMASTER I
G",94,20.8,168,35,133,las
107,KeRikoWisKi,"GRANDMASTER I
G",91,14.9,268,40,228,las
108,ElnicoMata,"GRANDMASTER I
G",90,12.2,674,82,592,las
109,LOLEROPERONOPACO,"GRANDMASTER I
G",89,19.0,305,58,247,las
110,CuriousChameIeon,"GRANDMASTER I
G",88,20.5,415,85,330,las
111,ravenoneforeva,"GRANDMASTER I
G",88,20.8,313,65,248,las
112,toy chikita,"GRANDMASTER I
G",88,21.2,207,44,163,las
113,KTP Yoshi,"GRANDMASTER I
G",87,13.7,444,61,383,las
114,Sirzechsl,"GRANDMASTER I
G",87,13.2,416,55,361,las
115,henryqez,"GRANDMASTER I
G",87,16.1,328,53,275,las
116,Daelon TFT,"GRANDMASTER I
G",85,12.9,409,53,356,las
117,NOSABIAQUEPONE,"GRANDMASTER I
G",84,16.6,193,32,161,las
118,SlashFullMuteAll,"GRANDMASTER I
G",83,15.7,338,53,285,las
119,Hardcorito Facho,"GRANDMASTER I
G",82,17.6,227,40,187,las
120,Tortuga Inmortal,"GRANDMASTER I
G",81,14.0,485,68,417,las
121,HuNnnTeR,"GRANDMASTER I
G",79,16.4,793,130,663,las
122,Dungeon,"GRANDMASTER I
G",79,16.2,383,62,321,las
123,TU WAIFU ME AMA,"GRANDMASTER I
G",77,17.9,173,31,142,las
124,Shadow Ares,"GRANDMASTER I
G",77,16.0,156,25,131,las
125,iPurge1,"GRANDMASTER I
G",73,13.7,386,53,333,las
126,64 Bits,"GRANDMASTER I
G",73,13.7,233,32,201,las
127,Cv 366,"GRANDMASTER I
G",72,17.5,206,36,170,las
128,TheClasman,"GRANDMASTER I
G",66,14.6,412,60,352,las
129,UCH Koro,"GRANDMASTER I
G",65,17.4,344,60,284,las
130,Sáyron,"GRANDMASTER I
G",65,13.2,433,57,376,las
131,Crux,"GRANDMASTER I
G",61,15.5,348,54,294,las
132,Daian21,"GRANDMASTER I
G",61,8.4,403,34,369,las
133,Luchiiitoo,"GRANDMASTER I
G",60,13.9,344,48,296,las
134,skitifornia,"GRANDMASTER I
G",59,14.5,571,83,488,las
135,Xerwell,"GRANDMASTER I
G",59,15.1,404,61,343,las
136,Zeikana,"GRANDMASTER I
G",59,17.2,348,60,288,las
137,BTS TFT Player,"GRANDMASTER I
G",58,21.6,306,66,240,las
138,Necroshine77,"GRANDMASTER I
G",57,19.4,372,72,300,las
139,TheDanieTFT,"GRANDMASTER I
G",57,13.2,182,24,158,las
140,Lean Live,"GRANDMASTER I
G",56,14.2,331,47,284,las
141,Viangrele,"GRANDMASTER I
G",55,24.8,303,75,228,las
142,WaIter White Jr,"GRANDMASTER I
G",55,13.2,417,55,362,las
143,Beldum,"GRANDMASTER I
G",54,16.2,290,47,243,las
144,psyque,"GRANDMASTER I
G",54,19.7,198,39,159,las
145,Tactics iBaggy,"GRANDMASTER I
G",54,14.8,230,34,196,las
146,Ola soi Smurf,"GRANDMASTER I
G",53,32.9,82,27,55,las
147,KravenPa,"GRANDMASTER I
G",26,17.1,428,73,355,las
148,VortexN,"GRANDMASTER I
G",25,14.8,398,59,339,las
149,UCH StartNoob,"GRANDMASTER I
G",2,12.2,222,27,195,las
150,Brooklyn Baby,MASTER I,84,24.7,158,39,119,las
151,xl Zero lx,MASTER I,70,12.4,715,89,626,las
152,Best Teemo LAS,MASTER I,66,16.0,482,77,405,las
153,Sikolio,MASTER I,64,18.3,398,73,325,las
154,Heisnb3rg,MASTER I,64,19.4,206,40,166,las
155,xikhario,MASTER I,55,16.4,330,54,276,las
156,SOY AGNÓSTICO,MASTER I,55,13.1,305,40,265,las
157,Lonkiwi,MASTER I,54,16.3,436,71,365,las
158,carkrod,MASTER I,52,14.6,678,99,579,las
159,Ledasor,MASTER I,52,21.0,224,47,177,las
160,TiagoAbner,MASTER I,51,13.3,294,39,255,las
161,Sadness Xiu,MASTER I,51,12.2,286,35,251,las
162,Keru,MASTER I,50,16.0,331,53,278,las
163,Penzio,MASTER I,50,13.2,273,36,237,las
164,spiirati,MASTER I,48,14.8,418,62,356,las
165,ElDryzler,MASTER I,45,11.7,377,44,333,las
166,Blasgare,MASTER I,45,9.1,340,31,309,las
167,Kamajuchi77,MASTER I,42,16.1,572,92,480,las
168,GGetafe,MASTER I,41,18.9,550,104,446,las
169,El Palo Me Mama,MASTER I,41,19.8,182,36,146,las
170,LIEUTENANT DAN,MASTER I,36,17.6,273,48,225,las
171,tft main lol,MASTER I,36,21.8,101,22,79,las
172,LioCR7,MASTER I,35,14.6,500,73,427,las
173,Riften,MASTER I,35,16.4,183,30,153,las
174,Wolf Bak,MASTER I,34,15.7,459,72,387,las
175,ikarosdesu,MASTER I,33,15.7,115,18,97,las
176,T2W DOGORwashere,MASTER I,32,19.7,254,50,204,las
177,Ingeld,MASTER I,27,14.9,403,60,343,las
178,WWWWWWW,MASTER I,27,14.9,376,56,320,las
179,HUAWEI AFeng,MASTER I,23,31.0,71,22,49,las
180,guitardead,MASTER I,22,18.2,209,38,171,las
181,Casi te gano,MASTER I,21,8.1,850,69,781,las
182,MaurooCARP,MASTER I,20,17.9,234,42,192,las
183,Trimsk,MASTER I,20,14.6,247,36,211,las
184,LL Jhin,MASTER I,20,15.8,184,29,155,las
185,Belfreath,MASTER I,19,12.2,294,36,258,las
186,MateDeCoco,MASTER I,19,16.8,208,35,173,las
187,Cueervoo,MASTER I,18,14.7,428,63,365,las
188,UruSativaCarryJr,MASTER I,17,20.5,215,44,171,las
189,Twitch Jaypi9,MASTER I,16,16.1,719,116,603,las
190,1nstant Karma,MASTER I,16,15.4,369,57,312,las
191,Farnese,MASTER I,15,15.3,489,75,414,las
192,dimeloneri,MASTER I,15,12.6,325,41,284,las
193,Super Carlitos,MASTER I,14,11.9,552,66,486,las
194,Zoa,MASTER I,14,16.3,208,34,174,las
195,Hao,MASTER I,14,9.9,202,20,182,las
196,Laud,MASTER I,14,13.7,124,17,107,las
197,God DMZ,MASTER I,12,16.3,331,54,277,las
198,Kiroichy,MASTER I,12,21.3,230,49,181,las
199,Seminare,MASTER I,11,16.4,310,51,259,las
200,Kellu Afen,MASTER I,11,16.1,273,44,229,las
201,Quantum Cobalt,MASTER I,10,17.1,275,47,228,las
202,LeBlanc Uchiha,MASTER I,9,14.1,1081,152,929,las
203,Kraft Tilted,MASTER I,9,20.0,290,58,232,las
204,Naron Bashor,MASTER I,8,13.0,408,53,355,las
205,Deku611,MASTER I,7,12.6,420,53,367,las
206,nymph666,MASTER I,7,12.7,369,47,322,las
207,Pandiwe2K,MASTER I,7,18.6,161,30,131,las
208,Error 402,MASTER I,7,14.1,205,29,176,las
209,CisTHD,MASTER I,6,15.8,467,74,393,las
210,SubLimE QQ,MASTER I,6,20.6,253,52,201,las
211,xFlogger,MASTER I,5,15.7,440,69,371,las
212,Pochocles,MASTER I,5,18.8,261,49,212,las
213,Gramitaa,MASTER I,4,15.9,351,56,295,las
214,Berzedker,MASTER I,3,17.6,272,48,224,las
215,Perekkles,MASTER I,2,17.9,307,55,252,las
216,Serteck,MASTER I,2,17.2,209,36,173,las
217,LeoPalac10,MASTER I,2,19.8,177,35,142,las
218,xXWelintonQuiwXx,MASTER I,2,11.9,210,25,185,las
219,Gasté 13900 IP,MASTER I,1,16.8,368,62,306,las
220,El Magias TFT,MASTER I,1,18.4,299,55,244,las
221,shxpeetheee,MASTER I,1,12.9,356,46,310,las
222,OgilvyRaboLoko,MASTER I,1,15.2,276,42,234,las
223,Alberto Canto,MASTER I,1,23.5,170,40,130,las
224,Preshelec,MASTER I,1,15.7,178,28,150,las
225,143,MASTER I,1,15.4,169,26,143,las
226,OrangeMoon,MASTER I,0,18.8,922,173,749,las
227,IICelesteII,MASTER I,0,15.8,603,95,508,las
228,MamàEstaPresa,MASTER I,0,21.5,302,65,237,las
229,Pastero en Bici,MASTER I,0,16.7,384,64,320,las
230,SIMPH,MASTER I,0,20.4,280,57,223,las
231,xXhermaniguiXx,MASTER I,0,19.9,276,55,221,las
232,khotax,MASTER I,0,15.0,340,51,289,las
233,Lyrion Tannister,MASTER I,0,19.8,247,49,198,las
234,El Dorainiken,MASTER I,0,17.1,281,48,233,las
235,AnimalBlanco,MASTER I,0,10.8,433,47,386,las
236,Piash,MASTER I,0,16.3,251,41,210,las
237,Down Powers,MASTER I,0,20.6,189,39,150,las
238,skeeve,MASTER I,0,17.5,211,37,174,las
239,Dycoop,MASTER I,0,18.5,189,35,154,las
240,Darkscreem,MASTER I,0,10.8,279,30,249,las
241,iEgoist,MASTER I,0,13.9,209,29,180,las
242,GALLig,MASTER I,0,33.3,78,26,52,las
243,Stoned Bulbasaur,MASTER I,0,12.9,201,26,175,las
244,Zpeed,MASTER I,0,12.6,206,26,180,las
245,Fugazi,MASTER I,0,22.5,71,16,55,las
246,Te Xuan Ze,MASTER I,0,10.4,154,16,138,las
247,marm4,DIAMOND I,99,15.6,397,62,335,las
248,Im not Frisco,DIAMOND I,99,14.5,214,31,183,las
249,SoyPis,DIAMOND I,96,15.8,569,90,479,las
250,Asolea Tela No,DIAMOND I,93,20.7,300,62,238,las
251,manuaj97,DIAMOND I,88,17.2,192,33,159,las
252,Celtiwi,DIAMOND I,87,17.6,278,49,229,las
253,SirBłack,DIAMOND I,84,14.8,330,49,281,las
254,elPepi,DIAMOND I,83,13.3,188,25,163,las
255,Ye Feng,DIAMOND I,78,19.8,374,74,300,las
256,ProyectD,DIAMOND I,78,15.0,313,47,266,las
257,saitosan1,DIAMOND I,75,12.8,870,111,759,las
258,Mapachee,DIAMOND I,75,20.9,378,79,299,las
259,Fifiii,DIAMOND I,75,17.3,370,64,306,las
260,CZ Furudo Nate,DIAMOND I,75,16.8,382,64,318,las
261,miami115,DIAMOND I,75,17.4,345,60,285,las
262,ElPantuGG,DIAMOND I,75,20.4,255,52,203,las
263,Little Rookiee,DIAMOND I,75,20.8,245,51,194,las
264,Yruke,DIAMOND I,75,16.0,300,48,252,las
265,xiduoduo,DIAMOND I,75,21.8,170,37,133,las
266,Gressu,DIAMOND I,75,13.5,259,35,224,las
267,Nicops1231,DIAMOND I,75,16.9,189,32,157,las
268,Doni,DIAMOND I,75,17.0,182,31,151,las
269,Óxidos Ácidos,DIAMOND I,75,18.5,162,30,132,las
270,xTato,DIAMOND I,75,14.4,188,27,161,las
271,Termo Stan Lee,DIAMOND I,75,23.0,100,23,77,las
272,LionLAN,DIAMOND I,75,28.0,75,21,54,las
273,Evil Puppy,DIAMOND I,72,21.0,706,148,558,las
274,El Gørdo J,DIAMOND I,72,15.8,550,87,463,las
275,Areee,DIAMOND I,70,16.5,243,40,203,las
276,Efesum,DIAMOND I,69,17.1,228,39,189,las
277,TuTuRu,DIAMOND I,69,30.4,115,35,80,las
278,NOT A MONKEY,DIAMOND I,64,13.5,208,28,180,las
279,ManuelAIcayaga,DIAMOND I,61,15.3,196,30,166,las
280,Warra,DIAMOND I,60,16.2,290,47,243,las
281,Josecristo,DIAMOND I,59,15.3,522,80,442,las
282,pnc123,DIAMOND I,59,18.1,215,39,176,las
283,SargentoFoley,DIAMOND I,59,23.4,107,25,82,las
284,OmegaStark,DIAMOND I,58,16.6,368,61,307,las
285,kraxs,DIAMOND I,57,14.3,476,68,408,las
286,tomm1g,DIAMOND I,57,15.5,213,33,180,las
287,Mid Ghost,DIAMOND I,56,13.8,998,138,860,las
288,V9 Priax,DIAMOND I,56,23.8,143,34,109,las
289,Carlinhoxs,DIAMOND I,56,14.4,167,24,143,las
290,xPaula,DIAMOND I,55,16.9,362,61,301,las
291,QuiTaEsMalTe,DIAMOND I,54,18.3,317,58,259,las
292,67 iq player,DIAMOND I,54,20.8,120,25,95,las
293,Chino Rios,DIAMOND I,53,17.8,444,79,365,las
294,Facuu RP,DIAMOND I,53,16.1,454,73,381,las
295,AlexKin,DIAMOND I,52,16.6,446,74,372,las
296,Pinnche,DIAMOND I,52,28.2,223,63,160,las
297,ZucaLIVE,DIAMOND I,52,13.6,383,52,331,las
298,Echex,DIAMOND I,52,21.9,96,21,75,las
299,Sandsword,DIAMOND I,51,18.3,311,57,254,las
300,Kinimaru,DIAMOND I,51,13.9,238,33,205,las
301,Random Plâyer,DIAMOND I,50,17.2,512,88,424,las
302,pancitodemoldee,DIAMOND I,50,13.6,440,60,380,las
303,Elba Ginaso,DIAMOND I,50,20.4,289,59,230,las
304,El Chipa,DIAMOND I,50,24.0,221,53,168,las
305,Xavhi,DIAMOND I,50,20.6,257,53,204,las
306,TuKoX,DIAMOND I,50,14.7,354,52,302,las
307,ShiroBanee,DIAMOND I,50,11.6,431,50,381,las
308,Niño Sad,DIAMOND I,50,18.9,248,47,201,las
309,pickleegar,DIAMOND I,50,20.5,219,45,174,las
310,EdsondoSaantos,DIAMOND I,50,16.6,265,44,221,las
311,BelZeButh,DIAMOND I,50,17.8,241,43,198,las
312,Jordan R Belfort,DIAMOND I,50,23.2,181,42,139,las
313,Yogursito,DIAMOND I,50,15.3,275,42,233,las
314,TFT daddy,DIAMOND I,50,19.3,197,38,159,las
315,ßunkow,DIAMOND I,50,21.8,170,37,133,las
316,Gatito Grrrrr,DIAMOND I,50,17.2,215,37,178,las
317,QUIEROmitft,DIAMOND I,50,14.8,243,36,207,las
318,LoLiLoV3r,DIAMOND I,50,22.4,147,33,114,las
319,Jhisus14,DIAMOND I,50,11.4,288,33,255,las
320,Dim4s,DIAMOND I,50,21.6,139,30,109,las
321,Spaark  TFT,DIAMOND I,50,15.9,189,30,159,las
322,Ba5 Menethor,DIAMOND I,50,26.9,104,28,76,las
323,DacerOne,DIAMOND I,50,16.5,170,28,142,las
324,Alapar,DIAMOND I,50,17.9,140,25,115,las
325,Flaco Friky,DIAMOND I,50,14.7,163,24,139,las
326,Krovsavetik,DIAMOND I,49,13.0,276,36,240,las
327,elJebush,DIAMOND I,48,16.6,193,32,161,las
328,n50,DIAMOND I,47,17.7,548,97,451,las
329,xLuxray729,DIAMOND I,46,22.4,286,64,222,las
330,lManno,DIAMOND I,46,21.4,294,63,231,las
331,Barrioneta,DIAMOND I,46,17.8,309,55,254,las
332,PulpoTiernizado,DIAMOND I,46,11.1,413,46,367,las
333,The Tøp ßender,DIAMOND I,44,14.5,330,48,282,las
334,miguelDarkGhot,DIAMOND I,44,11.7,350,41,309,las
335,JoseFill,DIAMOND I,43,16.9,485,82,403,las
336,Kimarus,DIAMOND I,43,20.0,295,59,236,las
337,DTW,DIAMOND I,41,14.0,371,52,319,las
338,Braay,DIAMOND I,41,22.1,208,46,162,las
339,TonnyD,DIAMOND I,40,22.7,462,105,357,las
340,StarPlzTFT,DIAMOND I,40,17.6,210,37,173,las
341,DTW 2,DIAMOND I,38,16.7,227,38,189,las
342,Pilinvert,DIAMOND I,38,18.5,162,30,132,las
343,nicoffir,DIAMOND I,37,17.5,143,25,118,las
344,Zoeciety,DIAMOND I,36,10.3,417,43,374,las
345,xllBorquezzz,DIAMOND I,36,19.2,177,34,143,las
346,NovaChron0,DIAMOND I,35,14.2,564,80,484,las
347,Vorg Zangief,DIAMOND I,35,14.6,343,50,293,las
348,Orco13,DIAMOND I,35,16.9,267,45,222,las
349,Asteriox,DIAMOND I,35,11.9,227,27,200,las
350,Le Suc,DIAMOND I,35,26.1,92,24,68,las
351,Mr Storm,DIAMOND I,34,19.1,622,119,503,las
352,UCH Dario,DIAMOND I,34,12.1,398,48,350,las
353,Haise,DIAMOND I,33,15.8,183,29,154,las
354,Bladeking107,DIAMOND I,32,14.5,400,58,342,las
355,Leyton0,DIAMOND I,32,20.7,261,54,207,las
356,SoulStealerr,DIAMOND I,32,14.7,346,51,295,las
357,Glitz,DIAMOND I,32,17.4,115,20,95,las
358,Sparks,DIAMOND I,32,16.8,119,20,99,las
359,SilverChains,DIAMOND I,31,25.2,135,34,101,las
360,Im Tulancelot,DIAMOND I,30,21.3,202,43,159,las
361,Mitsuri Kanroji,DIAMOND I,29,14.9,562,84,478,las
362,relax bro,DIAMOND I,29,13.9,344,48,296,las
363,RestlesSSouL,DIAMOND I,29,11.4,308,35,273,las
364,Sebamegaa,DIAMOND I,28,18.1,558,101,457,las
365,Jupeson,DIAMOND I,28,13.9,554,77,477,las
366,Cronoz,DIAMOND I,27,21.9,233,51,182,las
367,Gearth,DIAMOND I,27,16.7,156,26,130,las
368,PatadadeMogolico,DIAMOND I,27,13.4,171,23,148,las
369,Cheche tft,DIAMOND I,26,17.5,383,67,316,las
370,LionFlashVoice,DIAMOND I,26,13.1,236,31,205,las
371,thereisnourflvl,DIAMOND I,25,26.8,250,67,183,las
372,elgodi,DIAMOND I,25,22.0,264,58,206,las
373,Øbi,DIAMOND I,25,23.2,211,49,162,las
374,The Unƒørgiven,DIAMOND I,25,15.9,283,45,238,las
375,thepappo,DIAMOND I,25,17.5,234,41,193,las
376,Nerhuk,DIAMOND I,25,13.9,274,38,236,las
377,Arizona Zervas,DIAMOND I,24,15.7,356,56,300,las
378,neos102,DIAMOND I,24,21.4,206,44,162,las
379,Evasor07,DIAMOND I,23,19.9,201,40,161,las
380,Caver,DIAMOND I,23,15.2,250,38,212,las
381,TsubasOSO,DIAMOND I,23,17.5,200,35,165,las
382,LK Kuty,DIAMOND I,22,15.3,241,37,204,las
383,Shako,DIAMOND I,22,14.3,217,31,186,las
384,Rodd26,DIAMOND I,22,14.0,186,26,160,las
385,The Katarina,DIAMOND I,21,14.3,238,34,204,las
386,Veni a jugar,DIAMOND I,20,17.2,302,52,250,las
387,Mitsukurina,DIAMOND I,20,18.4,217,40,177,las
388,generaldark,DIAMOND I,20,22.9,153,35,118,las
389,moisesinho1,DIAMOND I,20,22.0,141,31,110,las
390,LenzU,DIAMOND I,19,20.8,168,35,133,las
391,AlonsOcean,DIAMOND I,18,11.7,350,41,309,las
392,Kog Mawrley,DIAMOND I,18,19.1,178,34,144,las
393,dimebag14king,DIAMOND I,17,11.4,454,52,402,las
394,spartanoperez,DIAMOND I,17,15.0,320,48,272,las
395,thunderboy4000,DIAMOND I,17,11.4,297,34,263,las
396,Agustin4521,DIAMOND I,16,18.9,359,68,291,las
397,Dorre912,DIAMOND I,15,14.2,431,61,370,las
398,Pinsto,DIAMOND I,15,19.5,210,41,169,las
399,RevëntXz,DIAMOND I,15,19.8,177,35,142,las
400,Rìcky Arjona,DIAMOND I,15,14.6,206,30,176,las
401,Krayziql,DIAMOND I,15,16.4,165,27,138,las
402,Hellfire,DIAMOND I,14,20.5,292,60,232,las
403,DAM Cacu,DIAMOND I,14,16.7,209,35,174,las
404,Khezitho,DIAMOND I,13,19.9,322,64,258,las
405,YvesMad,DIAMOND I,12,22.0,141,31,110,las
406,NoobPlayerOfTFT,DIAMOND I,11,10.8,646,70,576,las
407,REPORT PIÑERA BG,DIAMOND I,11,14.6,192,28,164,las
408,EL Empijjado,DIAMOND I,10,13.0,1217,158,1059,las
409,deBlois,DIAMOND I,10,16.7,324,54,270,las
410,QQPanda,DIAMOND I,10,24.5,159,39,120,las
411,Aizer,DIAMOND I,9,15.4,169,26,143,las
412,JacKp0t,DIAMOND I,9,12.5,176,22,154,las
413,SKT Toddy,DIAMOND I,8,12.1,282,34,248,las
414,Howling Abyss,DIAMOND I,8,9.0,200,18,182,las
415,Raceka,DIAMOND I,7,19.0,337,64,273,las
416,YUATI,DIAMOND I,7,17.5,297,52,245,las
417,e7 Kyubey,DIAMOND I,7,17.7,248,44,204,las
418,The SkyDrill,DIAMOND I,7,21.1,104,22,82,las
419,ShakeITx,DIAMOND I,6,22.2,203,45,158,las
420,Batmen104,DIAMOND I,5,17.0,560,95,465,las
421,p Ø L i,DIAMOND I,5,14.1,489,69,420,las
422,fenrir1,DIAMOND I,5,23.4,124,29,95,las
423,JHlN TONIC,DIAMOND I,5,11.9,227,27,200,las
424,Tdfdiegoo,DIAMOND I,4,16.0,331,53,278,las
425,PanchoSaaJAJAJA,DIAMOND I,4,23.2,168,39,129,las
426,Fuji,DIAMOND I,4,14.2,240,34,206,las
427,Treshyy,DIAMOND I,4,21.6,116,25,91,las
428,VEJ,DIAMOND I,3,14.4,410,59,351,las
429,SanteOtero,DIAMOND I,3,15.9,358,57,301,las
430,FacuBenedetti,DIAMOND I,3,12.9,404,52,352,las
431,Sirìus,DIAMOND I,3,14.6,233,34,199,las
432,Raulvasf,DIAMOND I,2,14.2,331,47,284,las
433,Tuche,DIAMOND I,2,10.6,386,41,345,las
434,xllBorquezzzz,DIAMOND I,2,19.8,162,32,130,las
435,Joakonix,DIAMOND I,2,14.3,195,28,167,las
436,CatLourd,DIAMOND I,2,15.5,174,27,147,las
437,Athyna,DIAMOND I,1,14.3,461,66,395,las
438,LaPalomaMasSeca,DIAMOND I,1,12.1,547,66,481,las
439,Teoo01,DIAMOND I,1,18.6,334,62,272,las
440,vergilcat,DIAMOND I,1,16.7,216,36,180,las
441,GoldenKid,DIAMOND I,0,18.3,823,151,672,las
442,Mefistófelez,DIAMOND I,0,16.6,589,98,491,las
443,Kurito,DIAMOND I,0,14.9,630,94,536,las
444,Zeon06,DIAMOND I,0,14.3,616,88,528,las
445,Correator,DIAMOND I,0,17.4,384,67,317,las
446,MisterYougi,DIAMOND I,0,18.0,345,62,283,las
447,sku da cranium,DIAMOND I,0,11.8,517,61,456,las
448,flavve,DIAMOND I,0,18.8,313,59,254,las
449,Tob9,DIAMOND I,0,21.4,271,58,213,las
450,ZaKK wyldEee,DIAMOND I,0,20.4,279,57,222,las
451,elchicolinux,DIAMOND I,0,16.8,334,56,278,las
452,Bersérker 1,DIAMOND I,0,16.9,314,53,261,las
453,God of Zed,DIAMOND I,0,12.6,406,51,355,las
454,Asterister,DIAMOND I,0,18.3,268,49,219,las
455,DogeSenpai,DIAMOND I,0,12.0,409,49,360,las
456,IFrenchBaguette,DIAMOND I,0,18.8,256,48,208,las
457,Empanadadeatun,DIAMOND I,0,17.6,272,48,224,las
458,GeLoOx,DIAMOND I,0,16.7,287,48,239,las
459,maxiiq,DIAMOND I,0,18.1,259,47,212,las
460,PapáDeNelson,DIAMOND I,0,12.1,388,47,341,las
461,sebamarosses24,DIAMOND I,0,18.2,252,46,206,las
462,QUERI G4NG,DIAMOND I,0,13.4,344,46,298,las
463,Fiora y Fauna,DIAMOND I,0,15.4,286,44,242,las
464,Chedragon,DIAMOND I,0,11.9,360,43,317,las
465,Dime Kephrii,DIAMOND I,0,10.1,415,42,373,las
466,Romicop,DIAMOND I,0,18.8,213,40,173,las
467,Hukka,DIAMOND I,0,16.5,242,40,202,las
468,Tazzadar,DIAMOND I,0,16.3,245,40,205,las
469,Pablinucu5,DIAMOND I,0,17.4,212,37,175,las
470,ÞŸËKRÖÖŠ TFT,DIAMOND I,0,12.2,304,37,267,las
471,AKA Mudo,DIAMOND I,0,7.7,483,37,446,las
472,PyschoCabra,DIAMOND I,0,24.6,146,36,110,las
473,Ted,DIAMOND I,0,22.9,157,36,121,las
474,juanferquinterop,DIAMOND I,0,14.8,236,35,201,las
475,Fearl3ss,DIAMOND I,0,26.4,129,34,95,las
476,leoShiShi,DIAMOND I,0,19.5,174,34,140,las
477,uwu,DIAMOND I,0,20.1,164,33,131,las
478,OzoneX,DIAMOND I,0,19.9,166,33,133,las
479,DeathRøw,DIAMOND I,0,16.1,205,33,172,las
480,Báltica Bot,DIAMOND I,0,14.0,235,33,202,las
481,Alamvre,DIAMOND I,0,16.8,191,32,159,las
482,No es mi dia bro,DIAMOND I,0,15.4,208,32,176,las
483,Luh,DIAMOND I,0,15.9,195,31,164,las
484,Zelk,DIAMOND I,0,15.5,200,31,169,las
485,WolfsenpaiAwA,DIAMOND I,0,10.7,289,31,258,las
486,Szenfeld,DIAMOND I,0,13.3,225,30,195,las
487,Ac Comprar Am,DIAMOND I,0,14.9,194,29,165,las
488,LIl Scioli,DIAMOND I,0,13.8,210,29,181,las
489,Lil DyZite,DIAMOND I,0,17.0,165,28,137,las
490,Im Tatan,DIAMOND I,0,16.9,154,26,128,las
491,Zelowan,DIAMOND I,0,13.8,189,26,163,las
492,zash9503,DIAMOND I,0,21.6,116,25,91,las
493,KosKeD10S,DIAMOND I,0,17.4,144,25,119,las
494,Dont Ban Lee,DIAMOND I,0,14.5,172,25,147,las
495,Te Apoyo,DIAMOND I,0,17.7,130,23,107,las
496,NazGúl OP,DIAMOND I,0,12.0,183,22,161,las
497,Iee sin god,DIAMOND I,0,16.7,126,21,105,las
498,Batthory,DIAMOND I,0,20.6,92,19,73,las
499,Don Lonchera,DIAMOND I,0,14.4,111,16,95,las
500,DEPREDATORXXXX,DIAMOND II,99,13.1,557,73,484,las
1,vx s5683169,CHALLENGER I,1081,24.4,406,99,307,oce
2,Angora,CHALLENGER I,995,26.2,351,92,259,oce
3,CombatEZ,CHALLENGER I,921,25.4,169,43,126,oce
4,KirinSupreme,CHALLENGER I,727,19.4,479,93,386,oce
5,Steve Lau,CHALLENGER I,619,21.8,907,198,709,oce
6,I Want You,CHALLENGER I,547,18.8,580,109,471,oce
7,ilikeud,CHALLENGER I,545,22.3,247,55,192,oce
8,Blender Main,CHALLENGER I,503,21.4,182,39,143,oce
9,HatsuneMik,CHALLENGER I,489,25.9,166,43,123,oce
10,Chatskiiees,CHALLENGER I,470,17.9,532,95,437,oce
11,dz2,CHALLENGER I,459,13.9,452,63,389,oce
12,JimJaam,CHALLENGER I,448,19.2,480,92,388,oce
13,stealmybuild TTV,CHALLENGER I,446,17.0,435,74,361,oce
14,jiaonizuodog,CHALLENGER I,442,18.7,664,124,540,oce
15,QWERXF,CHALLENGER I,431,20.9,306,64,242,oce
16,yuzhibo777,CHALLENGER I,416,19.5,359,70,289,oce
17,Last Wh1sper,CHALLENGER I,408,23.6,165,39,126,oce
18,m2att,CHALLENGER I,396,14.8,1023,152,871,oce
19,Kïng Tryndamere,CHALLENGER I,379,18.0,428,77,351,oce
20,ˇPhoenix,CHALLENGER I,378,23.6,317,75,242,oce
21,chinaLZH,CHALLENGER I,370,22.7,247,56,191,oce
22,MYdi,CHALLENGER I,369,17.6,352,62,290,oce
23,VNLunar,CHALLENGER I,368,14.1,341,48,293,oce
24,fengyingzhong,CHALLENGER I,367,24.6,122,30,92,oce
25,Bruceissss,CHALLENGER I,363,18.1,524,95,429,oce
26,oubo,CHALLENGER I,361,19.6,332,65,267,oce
27,Son Chae Young,CHALLENGER I,359,19.6,229,45,184,oce
28,dodododododododo,CHALLENGER I,356,20.5,1270,260,1010,oce
29,Jacky Xie,CHALLENGER I,353,22.5,404,91,313,oce
30,qp9,CHALLENGER I,344,15.3,360,55,305,oce
31,smsqs,CHALLENGER I,337,22.9,319,73,246,oce
32,Jack Griffin,CHALLENGER I,336,14.0,307,43,264,oce
33,WIld Sins Main,CHALLENGER I,329,15.1,325,49,276,oce
34,NayiGOJi,CHALLENGER I,324,19.5,277,54,223,oce
35,BeaBear,CHALLENGER I,317,17.1,334,57,277,oce
36,Slayer Bo,CHALLENGER I,315,17.5,308,54,254,oce
37,Cwute Panda,CHALLENGER I,311,16.9,450,76,374,oce
38,Rng28002200,CHALLENGER I,310,20.7,179,37,142,oce
39,MakinSomeBacon,CHALLENGER I,307,14.7,382,56,326,oce
40,lloydeee,CHALLENGER I,304,20.4,357,73,284,oce
41,Cyphos,CHALLENGER I,298,18.6,388,72,316,oce
42,plplplpp,CHALLENGER I,296,22.2,284,63,221,oce
43,3uphonium,CHALLENGER I,295,20.8,288,60,228,oce
44,thedashuaibi,CHALLENGER I,293,19.1,388,74,314,oce
45,lovestarrysky,CHALLENGER I,292,17.1,533,91,442,oce
46,Damon989,CHALLENGER I,290,19.1,199,38,161,oce
47,sorryimlikethis,CHALLENGER I,287,24.0,275,66,209,oce
48,Heart1ess,CHALLENGER I,286,20.1,264,53,211,oce
49,LongYu66,CHALLENGER I,285,17.7,328,58,270,oce
50,zhuodaye,CHALLENGER I,190,17.0,371,63,308,oce
51,ihjkljg,"GRANDMASTER I
G",295,16.5,243,40,203,oce
52,Escha,"GRANDMASTER I
G",293,13.8,610,84,526,oce
53,samesame,"GRANDMASTER I
G",274,13.5,466,63,403,oce
54,Just Mango,"GRANDMASTER I
G",268,21.5,316,68,248,oce
55,xg1998,"GRANDMASTER I
G",264,16.8,197,33,164,oce
56,Haober,"GRANDMASTER I
G",262,26.2,160,42,118,oce
57,6324ii,"GRANDMASTER I
G",261,27.6,134,37,97,oce
58,Maxilees,"GRANDMASTER I
G",252,16.3,208,34,174,oce
59,Law of the few,"GRANDMASTER I
G",250,13.7,663,91,572,oce
60,zofou,"GRANDMASTER I
G",249,17.4,414,72,342,oce
61,1ydia233,"GRANDMASTER I
G",244,23.3,120,28,92,oce
62,PPAP,"GRANDMASTER I
G",242,13.4,335,45,290,oce
63,Madnsss,"GRANDMASTER I
G",225,18.6,226,42,184,oce
64,Reborn Myth,"GRANDMASTER I
G",222,12.5,449,56,393,oce
65,YILINHHH,"GRANDMASTER I
G",218,15.7,351,55,296,oce
66,ggds4y,"GRANDMASTER I
G",209,16.3,374,61,313,oce
67,jieshao211,"GRANDMASTER I
G",208,18.1,193,35,158,oce
68,Dunk xiaolu,"GRANDMASTER I
G",205,16.8,453,76,377,oce
69,zhangtao666,"GRANDMASTER I
G",204,23.2,151,35,116,oce
70,Fischball,"GRANDMASTER I
G",202,18.8,192,36,156,oce
71,1234mutouren,"GRANDMASTER I
G",198,21.3,94,20,74,oce
72,TonystarkIRON,"GRANDMASTER I
G",195,25.2,127,32,95,oce
73,Jukelord,"GRANDMASTER I
G",194,14.6,314,46,268,oce
74,guangdongfoshan,"GRANDMASTER I
G",193,20.6,160,33,127,oce
75,zhuweiran,"GRANDMASTER I
G",190,16.2,396,64,332,oce
76,Laotie Letsgo,"GRANDMASTER I
G",189,25.0,148,37,111,oce
77,Fallangle,"GRANDMASTER I
G",187,18.6,199,37,162,oce
78,jffhjjir,"GRANDMASTER I
G",186,23.7,152,36,116,oce
79,TheExpIosiveTaco,"GRANDMASTER I
G",185,15.3,228,35,193,oce
80,GiveMeGunS,"GRANDMASTER I
G",182,16.9,201,34,167,oce
81,roflwhatever,"GRANDMASTER I
G",178,26.6,128,34,94,oce
82,Yuki0720,"GRANDMASTER I
G",172,12.3,413,51,362,oce
83,dxapple,"GRANDMASTER I
G",170,15.6,237,37,200,oce
84,DonAlternate,"GRANDMASTER I
G",167,20.5,322,66,256,oce
85,vx1123913246,"GRANDMASTER I
G",163,15.8,511,81,430,oce
86,HanDaY,"GRANDMASTER I
G",163,20.0,255,51,204,oce
87,Jinsang,"GRANDMASTER I
G",163,16.9,254,43,211,oce
88,3sansansan,"GRANDMASTER I
G",158,18.3,436,80,356,oce
89,CampBishop,"GRANDMASTER I
G",154,20.8,255,53,202,oce
90,WU YAN ZZU,"GRANDMASTER I
G",153,14.1,319,45,274,oce
91,yundingle,"GRANDMASTER I
G",145,22.6,186,42,144,oce
92,Mounty,"GRANDMASTER I
G",136,12.3,579,71,508,oce
93,aa1816,"GRANDMASTER I
G",135,16.0,275,44,231,oce
94,CLMEpapa,"GRANDMASTER I
G",134,17.6,323,57,266,oce
95,Mascot,"GRANDMASTER I
G",132,12.4,275,34,241,oce
96,hjhukbt,"GRANDMASTER I
G",129,16.6,331,55,276,oce
97,xinya45,"GRANDMASTER I
G",127,18.8,452,85,367,oce
98,WayneToDieeeeeee,"GRANDMASTER I
G",125,26.8,157,42,115,oce
99,aksidhhdid,"GRANDMASTER I
G",123,16.7,510,85,425,oce
100,Maraudaur,"GRANDMASTER I
G",121,15.9,560,89,471,oce
101,cococake,"GRANDMASTER I
G",120,14.4,353,51,302,oce
102,WO DongDongDong,"GRANDMASTER I
G",120,13.0,392,51,341,oce
103,Lethal Zedstarr,"GRANDMASTER I
G",119,11.5,494,57,437,oce
104,knlght999,"GRANDMASTER I
G",119,19.0,189,36,153,oce
105,dilisiad,"GRANDMASTER I
G",117,23.3,176,41,135,oce
106,why zyh and pipi,"GRANDMASTER I
G",117,14.3,287,41,246,oce
107,SilencedbymySins,"GRANDMASTER I
G",115,17.7,147,26,121,oce
108,Fwuffy Panda,"GRANDMASTER I
G",113,23.4,201,47,154,oce
109,Age of Empires 3,"GRANDMASTER I
G",111,14.0,457,64,393,oce
110,fanfanbaby,"GRANDMASTER I
G",110,29.4,102,30,72,oce
111,Letme11,"GRANDMASTER I
G",109,14.9,316,47,269,oce
112,Rainbow Baby huh,"GRANDMASTER I
G",109,13.6,242,33,209,oce
113,ImaginaryDragons,"GRANDMASTER I
G",108,11.7,163,19,144,oce
114,AngelMuzi,"GRANDMASTER I
G",107,21.3,155,33,122,oce
115,Whisper9897,"GRANDMASTER I
G",105,16.3,141,23,118,oce
116,ding1978,"GRANDMASTER I
G",103,16.4,237,39,198,oce
117,huozhigaoxin,"GRANDMASTER I
G",102,16.8,238,40,198,oce
118,Jum,"GRANDMASTER I
G",97,16.7,215,36,179,oce
119,PVC Cai,"GRANDMASTER I
G",95,11.7,420,49,371,oce
120,ANTIQUE HEALBOT,"GRANDMASTER I
G",94,15.6,347,54,293,oce
121,TheRealDirtyDan,"GRANDMASTER I
G",92,11.0,454,50,404,oce
122,kuaileyouxi,"GRANDMASTER I
G",92,23.4,167,39,128,oce
123,free57,"GRANDMASTER I
G",92,32.3,96,31,65,oce
124,Jenry,"GRANDMASTER I
G",90,13.3,188,25,163,oce
125,Side Character,"GRANDMASTER I
G",87,12.9,363,47,316,oce
126,Mo poisoness,"GRANDMASTER I
G",86,18.3,415,76,339,oce
127,txtx233,"GRANDMASTER I
G",86,16.7,269,45,224,oce
128,TooBreezy,"GRANDMASTER I
G",83,13.6,191,26,165,oce
129,mahui521,"GRANDMASTER I
G",78,17.1,310,53,257,oce
130,aicmg11111,"GRANDMASTER I
G",74,26.4,91,24,67,oce
131,RedHawk101,"GRANDMASTER I
G",72,21.8,354,77,277,oce
132,bankaiteam,"GRANDMASTER I
G",72,17.1,281,48,233,oce
133,okhaige,"GRANDMASTER I
G",72,13.0,315,41,274,oce
134,king0247,"GRANDMASTER I
G",71,19.6,276,54,222,oce
135,qkkaannuu,"GRANDMASTER I
G",71,13.7,380,52,328,oce
136,bingmoyan,"GRANDMASTER I
G",68,16.8,411,69,342,oce
137,amazingccc,"GRANDMASTER I
G",66,19.9,156,31,125,oce
138,AiryLaMenteuse,"GRANDMASTER I
G",66,15.0,206,31,175,oce
139,DarthRoshan,"GRANDMASTER I
G",65,14.1,354,50,304,oce
140,WnLyKingKK,"GRANDMASTER I
G",64,16.0,661,106,555,oce
141,Wo Tai Nan Le,"GRANDMASTER I
G",64,14.5,606,88,518,oce
142,dier306,"GRANDMASTER I
G",63,18.5,119,22,97,oce
143,Toby,"GRANDMASTER I
G",62,11.6,251,29,222,oce
144,dnn,"GRANDMASTER I
G",61,17.1,586,100,486,oce
145,Ni Bie ZouWei le,"GRANDMASTER I
G",59,18.4,653,120,533,oce
146,huya21063703,"GRANDMASTER I
G",57,16.9,166,28,138,oce
147,sanxingcaixukun,"GRANDMASTER I
G",46,13.4,686,92,594,oce
148,01 04 1999,"GRANDMASTER I
G",34,19.4,196,38,158,oce
149,xiaozhiZP,"GRANDMASTER I
G",20,17.3,417,72,345,oce
150,liontiger,"GRANDMASTER I
G",16,24.3,136,33,103,oce
151,orymdzz,MASTER I,174,18.6,263,49,214,oce
152,zhouyinuo,MASTER I,122,17.7,243,43,200,oce
153,wuzyu123,MASTER I,108,28.9,76,22,54,oce
154,CLUBCANTHANDLEME,MASTER I,100,16.5,321,53,268,oce
155,Member,MASTER I,79,13.8,246,34,212,oce
156,zyoona,MASTER I,77,15.5,399,62,337,oce
157,CterMinh,MASTER I,73,12.4,435,54,381,oce
158,xianqishenjiangl,MASTER I,69,17.2,366,63,303,oce
159,k9night,MASTER I,68,17.5,229,40,189,oce
160,BlueRose134,MASTER I,59,14.4,402,58,344,oce
161,ASJD957,MASTER I,59,18.9,249,47,202,oce
162,Whitelight,MASTER I,59,22.5,102,23,79,oce
163,821,MASTER I,57,14.8,332,49,283,oce
164,vhugggg,MASTER I,57,10.8,380,41,339,oce
165,styllll,MASTER I,57,15.8,215,34,181,oce
166,BiscottiSwarls,MASTER I,56,13.6,346,47,299,oce
167,keljiw,MASTER I,56,18.7,155,29,126,oce
168,IllIIIll,MASTER I,55,15.9,151,24,127,oce
169,ssjfirzen,MASTER I,54,11.7,1562,183,1379,oce
170,jiushishen,MASTER I,54,20.4,167,34,133,oce
171,TFT Yurik,MASTER I,52,14.3,462,66,396,oce
172,Tactics GOD,MASTER I,52,19.9,216,43,173,oce
173,chenshaqi,MASTER I,50,17.0,165,28,137,oce
174,leiloveyang,MASTER I,49,20.1,254,51,203,oce
175,weiningyuan,MASTER I,46,20.3,148,30,118,oce
176,fapaiyuanwm,MASTER I,46,18.8,117,22,95,oce
177,Dwyan3 Wade,MASTER I,45,14.6,419,61,358,oce
178,wggrggt,MASTER I,45,23.7,114,27,87,oce
179,sunshinellll,MASTER I,44,20.7,111,23,88,oce
180,callbobo,MASTER I,44,30.6,72,22,50,oce
181,haoxintai,MASTER I,42,18.1,177,32,145,oce
182,aozhourenmeimama,MASTER I,42,25.7,101,26,75,oce
183,jaming,MASTER I,42,15.9,145,23,122,oce
184,YUKINO013,MASTER I,41,14.1,327,46,281,oce
185,Forget,MASTER I,41,18.9,185,35,150,oce
186,peppa demon,MASTER I,41,20.0,150,30,120,oce
187,Nekkiiiii,MASTER I,40,11.5,357,41,316,oce
188,eeadea,MASTER I,40,17.5,183,32,151,oce
189,shinlove311,MASTER I,39,18.1,149,27,122,oce
190,Lógic,MASTER I,38,18.2,253,46,207,oce
191,wanmgc,MASTER I,38,11.8,323,38,285,oce
192,assqbqqq,MASTER I,37,14.8,345,51,294,oce
193,wangmiss,MASTER I,36,20.3,217,44,173,oce
194,zhenyoudianshuai,MASTER I,36,20.9,191,40,151,oce
195,Mikkey,MASTER I,36,14.3,279,40,239,oce
196,RKGG,MASTER I,36,15.5,232,36,196,oce
197,hemoumouya,MASTER I,35,28.6,140,40,100,oce
198,An arurf player,MASTER I,34,10.4,374,39,335,oce
199,uwggwuwhll,MASTER I,33,16.6,302,50,252,oce
200,woshizhong,MASTER I,33,16.6,229,38,191,oce
201,uilkk925,MASTER I,33,20.1,174,35,139,oce
202,sorrybro,MASTER I,33,20.9,110,23,87,oce
203,xiaocaibiiiii,MASTER I,32,16.1,267,43,224,oce
204,Simon The Miner,MASTER I,32,10.9,367,40,327,oce
205,kaiwen521,MASTER I,32,25.0,88,22,66,oce
206,Zhiend,MASTER I,30,24.8,214,53,161,oce
207,WorstNooB,MASTER I,29,17.3,179,31,148,oce
208,ELECENG100SU,MASTER I,29,32.5,86,28,58,oce
209,RPNT,MASTER I,28,18.4,282,52,230,oce
210,WardenBenny,MASTER I,28,20.2,213,43,170,oce
211,Grayswandir,MASTER I,28,21.1,152,32,120,oce
212,babyuer,MASTER I,27,22.9,157,36,121,oce
213,Petra,MASTER I,27,22.9,153,35,118,oce
214,ItchyPenitis,MASTER I,26,13.2,523,69,454,oce
215,gaowei111,MASTER I,26,22.2,171,38,133,oce
216,I am Fzzf,MASTER I,25,18.9,302,57,245,oce
217,DegenRolling,MASTER I,25,33.8,71,24,47,oce
218,Yeddie,MASTER I,24,10.7,1346,144,1202,oce
219,livebored,MASTER I,23,12.8,296,38,258,oce
220,WYYZQQ,MASTER I,22,15.4,299,46,253,oce
221,wudichiji,MASTER I,22,19.2,172,33,139,oce
222,superzjq6,MASTER I,22,25.0,96,24,72,oce
223,Dankk,MASTER I,21,16.0,237,38,199,oce
224,tanhuanjue,MASTER I,21,33.8,80,27,53,oce
225,bbllff,MASTER I,20,16.4,292,48,244,oce
226,wanfan1999,MASTER I,19,14.4,355,51,304,oce
227,TânS2MinhTâm,MASTER I,19,13.4,269,36,233,oce
228,xiyuluochen,MASTER I,19,16.2,191,31,160,oce
229,morningPonyo,MASTER I,19,18.2,132,24,108,oce
230,zhanglan1234,MASTER I,18,13.0,300,39,261,oce
231,lubenweinib,MASTER I,18,17.7,198,35,163,oce
232,tatami,MASTER I,18,16.8,191,32,159,oce
233,FPYNMSL,MASTER I,18,23.7,114,27,87,oce
234,raelman,MASTER I,17,16.8,161,27,134,oce
235,lzlssly,MASTER I,17,17.6,136,24,112,oce
236,doindog1,MASTER I,16,20.6,287,59,228,oce
237,VainF,MASTER I,16,14.2,317,45,272,oce
238,ciwei920,MASTER I,16,19.2,146,28,118,oce
239,dashufangkaiwo,MASTER I,16,10.1,207,21,186,oce
240,zhongguoqd,MASTER I,15,15.9,220,35,185,oce
241,KeyaTFT,MASTER I,15,26.6,128,34,94,oce
242,cgnb,MASTER I,14,20.2,238,48,190,oce
243,yastin,MASTER I,14,17.1,175,30,145,oce
244,kingswenxa,MASTER I,13,9.7,424,41,383,oce
245,ganganniu,MASTER I,12,19.0,237,45,192,oce
246,peace2020,MASTER I,12,20.8,212,44,168,oce
247,SoccerSupaStar,MASTER I,12,19.9,176,35,141,oce
248,xiaosi2020,MASTER I,11,13.7,364,50,314,oce
249,LollyMan,MASTER I,11,17.6,193,34,159,oce
250,wo5172,MASTER I,11,12.0,191,23,168,oce
251,SeaBoss,MASTER I,9,13.3,382,51,331,oce
252,DD2601,MASTER I,9,16.5,206,34,172,oce
253,Zoothefuker,MASTER I,8,25.0,100,25,75,oce
254,agzmybz,MASTER I,8,18.8,117,22,95,oce
255,JesterFred,MASTER I,7,16.3,301,49,252,oce
256,buzhiming1111,MASTER I,7,20.8,144,30,114,oce
257,Legolas,MASTER I,6,17.5,308,54,254,oce
258,Sephyli,MASTER I,6,16.3,270,44,226,oce
259,IGIGIGIGIGIGIGIG,MASTER I,6,18.4,233,43,190,oce
260,251kaikai,MASTER I,6,23.7,156,37,119,oce
261,dyx0105,MASTER I,6,17.8,202,36,166,oce
262,Silon77,MASTER I,5,15.6,339,53,286,oce
263,anhaomoBB,MASTER I,5,15.7,281,44,237,oce
264,Gilgameshann,MASTER I,5,23.8,151,36,115,oce
265,coolzt,MASTER I,5,16.7,162,27,135,oce
266,Zacccccyou,MASTER I,5,19.1,131,25,106,oce
267,muasxy,MASTER I,5,28.9,83,24,59,oce
268,chanllenger4xuxu,MASTER I,5,15.5,155,24,131,oce
269,yuzihasasigei,MASTER I,5,20.7,111,23,88,oce
270,Jando,MASTER I,4,14.2,339,48,291,oce
271,lmllml,MASTER I,4,20.3,192,39,153,oce
272,Focus More,MASTER I,4,37.7,69,26,43,oce
273,henannanyang,MASTER I,3,13.9,519,72,447,oce
274,Joothefuker,MASTER I,3,25.9,116,30,86,oce
275,dearxiang,MASTER I,3,17.4,92,16,76,oce
276,Stop bite me,MASTER I,2,14.9,726,108,618,oce
277,yolonamelyandy,MASTER I,2,18.1,260,47,213,oce
278,Heart Doinb,MASTER I,2,25.4,169,43,126,oce
279,eokdkfkff,MASTER I,2,14.3,265,38,227,oce
280,TianQinSe D YanY,MASTER I,1,15.9,483,77,406,oce
281,yangduck,MASTER I,1,16.1,461,74,387,oce
282,tenseigannn,MASTER I,1,13.2,302,40,262,oce
283,betkhoc,MASTER I,1,21.1,171,36,135,oce
284,huhehe666,MASTER I,1,17.5,206,36,170,oce
285,jisos,MASTER I,0,20.4,440,90,350,oce
286,Yyangyonglin,MASTER I,0,21.5,288,62,226,oce
287,phyre49,MASTER I,0,15.6,385,60,325,oce
288,Becomingme,MASTER I,0,12.8,454,58,396,oce
289,MarioShu,MASTER I,0,15.0,381,57,324,oce
290,eatjin,MASTER I,0,12.8,384,49,335,oce
291,JackAnt,MASTER I,0,24.6,191,47,144,oce
292,BIGBiG12138,MASTER I,0,17.7,266,47,219,oce
293,Stanton96,MASTER I,0,18.9,217,41,176,oce
294,dangkeai,MASTER I,0,15.4,259,40,219,oce
295,Notle,MASTER I,0,12.7,315,40,275,oce
296,jxxyx007,MASTER I,0,18.8,176,33,143,oce
297,TayKim,MASTER I,0,16.5,194,32,162,oce
298,changgyul,MASTER I,0,13.0,246,32,214,oce
299,sexoo1,MASTER I,0,19.0,163,31,132,oce
300,1224,MASTER I,0,19.6,153,30,123,oce
301,hahhahahh,MASTER I,0,14.3,209,30,179,oce
302,the munter,MASTER I,0,11.8,254,30,224,oce
303,wljbddmz,MASTER I,0,16.4,171,28,143,oce
304,d0ttY,MASTER I,0,14.4,194,28,166,oce
305,Moon1,MASTER I,0,17.2,157,27,130,oce
306,524510785,MASTER I,0,17.2,157,27,130,oce
307,frisco,MASTER I,0,11.2,232,26,206,oce
308,King Røck,MASTER I,0,17.6,136,24,112,oce
309,iiiiiiuuuuuu,MASTER I,0,15.4,149,23,126,oce
310,Seeyaa,MASTER I,0,10.0,219,22,197,oce
311,Mo Maek xx,DIAMOND I,98,15.4,299,46,253,oce
312,liuyu333,DIAMOND I,98,20.9,167,35,132,oce
313,1943,DIAMOND I,98,23.7,97,23,74,oce
314,ChinaAlon,DIAMOND I,96,20.3,148,30,118,oce
315,THEbulll,DIAMOND I,89,18.8,223,42,181,oce
316,OwO Ke Ai Duooo,DIAMOND I,89,14.9,248,37,211,oce
317,RONSWANSON,DIAMOND I,88,12.6,151,19,132,oce
318,Janná,DIAMOND I,87,17.3,225,39,186,oce
319,HeartWept,DIAMOND I,85,20.0,260,52,208,oce
320,Bachh,DIAMOND I,85,18.1,237,43,194,oce
321,Shriic,DIAMOND I,84,10.8,204,22,182,oce
322,2Yunerya,DIAMOND I,78,15.0,401,60,341,oce
323,midtesty,DIAMOND I,78,10.9,412,45,367,oce
324,huya008,DIAMOND I,77,24.4,217,53,164,oce
325,faketuoni,DIAMOND I,77,14.7,218,32,186,oce
326,Mr Relaxed,DIAMOND I,76,16.7,408,68,340,oce
327,Soucouyant,DIAMOND I,75,19.2,1133,218,915,oce
328,GooGieMonA,DIAMOND I,75,21.1,603,127,476,oce
329,fatbug gg,DIAMOND I,75,16.3,673,110,563,oce
330,xxxPeter200xxx,DIAMOND I,75,15.0,586,88,498,oce
331,lolamar05,DIAMOND I,75,14.9,557,83,474,oce
332,cao ni ma 69,DIAMOND I,75,14.4,459,66,393,oce
333,TacticalKorean,DIAMOND I,75,12.4,531,66,465,oce
334,Ethilamwen,DIAMOND I,75,16.7,390,65,325,oce
335,Dosedtns,DIAMOND I,75,20.4,313,64,249,oce
336,Saint Seiya,DIAMOND I,75,13.8,413,57,356,oce
337,janet11corners,DIAMOND I,75,22.5,249,56,193,oce
338,WKY Zui Mei,DIAMOND I,75,16.1,347,56,291,oce
339,When,DIAMOND I,75,14.9,309,46,263,oce
340,Thoppie,DIAMOND I,75,23.5,187,44,143,oce
341,babadeba,DIAMOND I,75,26.6,154,41,113,oce
342,sivirxin,DIAMOND I,75,17.4,235,41,194,oce
343,Way Too Suave,DIAMOND I,75,17.3,237,41,196,oce
344,Nidedad,DIAMOND I,75,22.2,144,32,112,oce
345,Cuttl3fish,DIAMOND I,75,11.7,273,32,241,oce
346,ncpchina,DIAMOND I,75,25.6,117,30,87,oce
347,woodsie093,DIAMOND I,75,16.4,159,26,133,oce
348,ztddc1,DIAMOND I,75,23.5,102,24,78,oce
349,DoubleShun,DIAMOND I,75,25.0,92,23,69,oce
350,ZhuoKing,DIAMOND I,74,15.9,370,59,311,oce
351,stynb666,DIAMOND I,73,17.7,130,23,107,oce
352,Quwrof,DIAMOND I,72,15.6,398,62,336,oce
353,you122,DIAMOND I,71,17.4,403,70,333,oce
354,zzaffffff,DIAMOND I,71,20.0,290,58,232,oce
355,trunks 4,DIAMOND I,71,12.1,372,45,327,oce
356,yansuixin,DIAMOND I,70,11.4,245,28,217,oce
357,baboda,DIAMOND I,69,11.6,526,61,465,oce
358,Tsunemori Akane,DIAMOND I,69,12.7,189,24,165,oce
359,YuEBuZu,DIAMOND I,68,18.4,174,32,142,oce
360,TFBOYSBb,DIAMOND I,68,19.6,107,21,86,oce
361,lovelykog,DIAMOND I,68,16.0,131,21,110,oce
362,VVVVincent,DIAMOND I,67,15.1,299,45,254,oce
363,ShadowMing,DIAMOND I,67,18.6,215,40,175,oce
364,Luckyplanck,DIAMOND I,66,21.1,209,44,165,oce
365,jmjQAQ,DIAMOND I,66,24.8,101,25,76,oce
366,why1221,DIAMOND I,65,23.5,187,44,143,oce
367,wah fong pei ah,DIAMOND I,64,19.1,383,73,310,oce
368,MaeIstrom,DIAMOND I,64,15.9,132,21,111,oce
369,Featherknights,DIAMOND I,63,17.8,213,38,175,oce
370,IInevitable,DIAMOND I,62,16.5,400,66,334,oce
371,111iidj,DIAMOND I,61,24.4,90,22,68,oce
372,Fed mid eat sh1t,DIAMOND I,60,16.3,338,55,283,oce
373,Bma,DIAMOND I,60,17.0,194,33,161,oce
374,MirMing,DIAMOND I,59,15.9,609,97,512,oce
375,hanlu4522,DIAMOND I,59,14.2,445,63,382,oce
376,Renais,DIAMOND I,57,19.4,247,48,199,oce
377,Raichiu,DIAMOND I,56,16.4,183,30,153,oce
378,xiaosuan,DIAMOND I,56,16.2,179,29,150,oce
379,Jeonnyboy,DIAMOND I,55,15.4,397,61,336,oce
380,Camm,DIAMOND I,54,16.8,683,115,568,oce
381,GGstay,DIAMOND I,53,14.5,311,45,266,oce
382,1363082396l,DIAMOND I,51,12.5,528,66,462,oce
383,liranxin,DIAMOND I,51,10.6,282,30,252,oce
384,Meme Addiction,DIAMOND I,50,18.6,366,68,298,oce
385,Hér MANGOˇ,DIAMOND I,50,15.4,427,66,361,oce
386,widepeepoGlad,DIAMOND I,50,19.3,327,63,264,oce
387,klowly,DIAMOND I,50,16.0,388,62,326,oce
388,MrTianD,DIAMOND I,50,14.4,410,59,351,oce
389,Natural01,DIAMOND I,50,22.8,246,56,190,oce
390,yyg980422,DIAMOND I,50,15.1,344,52,292,oce
391,OldYellow3,DIAMOND I,50,14.5,304,44,260,oce
392,ccxxcc,DIAMOND I,50,20.1,214,43,171,oce
393,qq13277,DIAMOND I,50,23.1,173,40,133,oce
394,Esseker,DIAMOND I,50,29.8,121,36,85,oce
395,herdey,DIAMOND I,50,15.0,240,36,204,oce
396,Whoopss,DIAMOND I,50,13.3,263,35,228,oce
397,aoligeiiiiiii,DIAMOND I,50,17.4,172,30,142,oce
398,knippdghu,DIAMOND I,50,20.3,138,28,110,oce
399,cui086,DIAMOND I,50,23.7,114,27,87,oce
400,sRongLun,DIAMOND I,50,17.9,145,26,119,oce
401,s1y2f3,DIAMOND I,50,14.0,171,24,147,oce
402,Arend,DIAMOND I,50,16.0,106,17,89,oce
403,yuxuhui666,DIAMOND I,50,12.1,141,17,124,oce
404,dhl666,DIAMOND I,49,22.4,152,34,118,oce
405,ggoalpick,DIAMOND I,49,19.6,92,18,74,oce
406,3356su,DIAMOND I,48,12.2,147,18,129,oce
407,aero x,DIAMOND I,47,12.5,351,44,307,oce
408,Michael Draven,DIAMOND I,47,17.9,212,38,174,oce
409,newcpdown,DIAMOND I,47,16.0,194,31,163,oce
410,zhengdejiaoqi,DIAMOND I,47,16.8,131,22,109,oce
411,P pEacH QoO,DIAMOND I,46,15.1,555,84,471,oce
412,Shencha0,DIAMOND I,46,17.1,187,32,155,oce
413,030peach,DIAMOND I,46,13.1,221,29,192,oce
414,Omnî,DIAMOND I,45,26.5,894,237,657,oce
415,P goon,DIAMOND I,45,16.4,908,149,759,oce
416,lionqq,DIAMOND I,45,15.2,428,65,363,oce
417,ShinyLie,DIAMOND I,44,19.9,321,64,257,oce
418,J0J0Sh1t,DIAMOND I,44,22.1,272,60,212,oce
419,Donaldin0,DIAMOND I,44,13.2,440,58,382,oce
420,Its Cupcake,DIAMOND I,44,14.6,253,37,216,oce
421,MagicalBlond,DIAMOND I,44,17.2,209,36,173,oce
422,Mahakaal,DIAMOND I,44,10.1,199,20,179,oce
423,agree520,DIAMOND I,43,14.4,236,34,202,oce
424,Prowlore,DIAMOND I,43,12.3,236,29,207,oce
425,youngAny,DIAMOND I,43,16.3,147,24,123,oce
426,mxcjs123,DIAMOND I,42,16.3,270,44,226,oce
427,huanyingjiw,DIAMOND I,41,13.0,246,32,214,oce
428,Lssxxs,DIAMOND I,41,15.6,167,26,141,oce
429,Fxxk YOU,DIAMOND I,41,20.3,123,25,98,oce
430,Young Fizz,DIAMOND I,40,19.4,592,115,477,oce
431,LOLSakuralgoe,DIAMOND I,39,20.3,207,42,165,oce
432,xiaohanggege,DIAMOND I,39,17.3,231,40,191,oce
433,tw Kevin,DIAMOND I,39,17.5,223,39,184,oce
434,gggyou,DIAMOND I,39,19.0,184,35,149,oce
435,AZHONG00,DIAMOND I,38,16.2,394,64,330,oce
436,gggggggggggggsl,DIAMOND I,38,14.3,196,28,168,oce
437,NHawx,DIAMOND I,37,14.1,448,63,385,oce
438,zuan4fangguowo,DIAMOND I,37,17.2,197,34,163,oce
439,fyvbububu,DIAMOND I,37,16.4,146,24,122,oce
440,Ongo Gablogian,DIAMOND I,36,21.8,280,61,219,oce
441,ztc931,DIAMOND I,36,9.3,567,53,514,oce
442,Naix WifeSlayer,DIAMOND I,36,17.4,270,47,223,oce
443,RNGtlang,DIAMOND I,36,15.9,296,47,249,oce
444,FapaiyuanDemon,DIAMOND I,36,23.4,94,22,72,oce
445,QiWeiL,DIAMOND I,34,17.2,238,41,197,oce
446,S2mple1,DIAMOND I,34,17.2,238,41,197,oce
447,LovexixizzZ,DIAMOND I,34,23.9,167,40,127,oce
448,PSimmashoot,DIAMOND I,34,13.5,282,38,244,oce
449,ROKA1713,DIAMOND I,33,15.3,576,88,488,oce
450,JinGuGuGu,DIAMOND I,33,19.1,199,38,161,oce
451,sj9527,DIAMOND I,33,13.5,237,32,205,oce
452,228049,DIAMOND I,33,23.0,87,20,67,oce
453,Energy,DIAMOND I,32,14.5,207,30,177,oce
454,husihua,DIAMOND I,32,17.6,125,22,103,oce
455,fyiiiiii,DIAMOND I,31,15.3,452,69,383,oce
456,WhatULooking4,DIAMOND I,31,15.0,160,24,136,oce
457,shadewolfngo,DIAMOND I,30,12.3,260,32,228,oce
458,Aburuisi,DIAMOND I,30,22.5,102,23,79,oce
459,yyy599795,DIAMOND I,29,12.1,214,26,188,oce
460,xuqwer,DIAMOND I,28,14.4,465,67,398,oce
461,wtl20000701,DIAMOND I,28,29.0,107,31,76,oce
462,Razza,DIAMOND I,28,14.6,178,26,152,oce
463,ooo2ddbi,DIAMOND I,28,13.7,190,26,164,oce
464,qwsxggo,DIAMOND I,27,17.3,346,60,286,oce
465,Kaze Meiji,DIAMOND I,27,15.0,267,40,227,oce
466,11111dingk,DIAMOND I,27,13.9,252,35,217,oce
467,EffortIess,DIAMOND I,27,23.8,105,25,80,oce
468,1Missyou,DIAMOND I,26,22.7,185,42,143,oce
469,WalterSun,DIAMOND I,26,24.5,139,34,105,oce
470,Mads Mikkelsen,DIAMOND I,25,12.7,401,51,350,oce
471,kiyomirl,DIAMOND I,25,14.4,264,38,226,oce
472,ZacharyC,DIAMOND I,25,16.2,185,30,155,oce
473,MakeNoSence,DIAMOND I,25,10.4,278,29,249,oce
474,Kappa Khameleon,DIAMOND I,25,15.1,185,28,157,oce
475,xxxxyg,DIAMOND I,24,15.8,260,41,219,oce
476,aguangge,DIAMOND I,24,16.0,162,26,136,oce
477,BeegChonker,DIAMOND I,24,17.6,119,21,98,oce
478,heishelifu,DIAMOND I,23,24.2,186,45,141,oce
479,xw2000,DIAMOND I,23,17.0,176,30,146,oce
480,wm5986,DIAMOND I,23,23.3,103,24,79,oce
481,Usefulmoose,DIAMOND I,22,13.6,258,35,223,oce
482,qddfghvc,DIAMOND I,21,18.8,165,31,134,oce
483,UZIqsjy,DIAMOND I,21,19.1,157,30,127,oce
484,asange,DIAMOND I,20,15.2,395,60,335,oce
485,weigaosheng,DIAMOND I,20,13.2,403,53,350,oce
486,littleguy0,DIAMOND I,20,20.3,177,36,141,oce
487,TiananomenSquare,DIAMOND I,20,17.1,164,28,136,oce
488,Mssi1988,DIAMOND I,19,20.4,211,43,168,oce
489,AWAYmili,DIAMOND I,19,17.1,252,43,209,oce
490,ROG NO1 Chairman,DIAMOND I,19,18.0,111,20,91,oce
491,sudoowoodo,DIAMOND I,18,18.0,317,57,260,oce
492,chaoxige,DIAMOND I,18,19.9,206,41,165,oce
493,overwater,DIAMOND I,18,19.7,198,39,159,oce
494,Kazsaix,DIAMOND I,18,17.8,214,38,176,oce
495,playoldman,DIAMOND I,18,37.1,62,23,39,oce
496,wlzcyx,DIAMOND I,17,17.5,378,66,312,oce
497,11233a,DIAMOND I,17,13.4,247,33,214,oce
498,90077qing,DIAMOND I,17,16.9,154,26,128,oce
499,Aszhaoli,DIAMOND I,17,16.7,120,20,100,oce
500,yemingyang,DIAMOND I,17,19.6,97,19,78,oce
1,kinqmusti43,CHALLENGER I,1562,25.4,527,134,393,tr
2,Rubic,CHALLENGER I,1536,26.6,647,172,475,tr
3,speedruzlol,CHALLENGER I,1138,24.5,444,109,335,tr
4,MAD JOSEPH,CHALLENGER I,1095,19.8,648,128,520,tr
5,MAD JOSEPH 2,CHALLENGER I,962,25.0,300,75,225,tr
6,Ayenbe,CHALLENGER I,861,26.6,267,71,196,tr
7,Benedetto,CHALLENGER I,827,22.6,332,75,257,tr
8,Stay ruthless,CHALLENGER I,780,27.5,781,215,566,tr
9,jan uma,CHALLENGER I,645,21.8,252,55,197,tr
10,keLch,CHALLENGER I,631,22.6,349,79,270,tr
11,Jok3r xx,CHALLENGER I,556,22.0,304,67,237,tr
12,Perceid TFT,CHALLENGER I,556,26.2,149,39,110,tr
13,NİZİPLİİİ,CHALLENGER I,533,21.6,888,192,696,tr
14,Waiden,CHALLENGER I,502,18.4,833,153,680,tr
15,Jenerik,CHALLENGER I,495,22.3,256,57,199,tr
16,bestâ,CHALLENGER I,486,21.5,367,79,288,tr
17,Daldım Kazdım,CHALLENGER I,480,22.7,286,65,221,tr
18,Darksword02,CHALLENGER I,479,16.3,790,129,661,tr
19,lAdastra,CHALLENGER I,473,19.9,547,109,438,tr
20,Liquidzer,CHALLENGER I,472,18.4,452,83,369,tr
21,MAC MASCARA,CHALLENGER I,471,14.8,595,88,507,tr
22,SİVASLI PONÇİK,CHALLENGER I,468,16.0,337,54,283,tr
23,Jthie,CHALLENGER I,467,20.9,258,54,204,tr
24,Jonas Salk,CHALLENGER I,466,11.8,599,71,528,tr
25,GreatEagle,CHALLENGER I,456,18.7,390,73,317,tr
26,clssJaGG,CHALLENGER I,438,15.2,725,110,615,tr
27,Morte D Amour,CHALLENGER I,416,16.4,651,107,544,tr
28,SunChos,CHALLENGER I,410,14.8,985,146,839,tr
29,11 04 2004,CHALLENGER I,400,14.7,497,73,424,tr
30,TFT Colorâblê v2,CHALLENGER I,398,15.2,230,35,195,tr
31,ŁuciâN,CHALLENGER I,395,14.0,349,49,300,tr
32,FeelingTheBlanks,CHALLENGER I,393,11.9,480,57,423,tr
33,MUHENDİSBEY TFT,CHALLENGER I,391,17.4,409,71,338,tr
34,mettuzwee,CHALLENGER I,386,25.6,180,46,134,tr
35,Meglendiel,CHALLENGER I,383,17.0,712,121,591,tr
36,Shinzu,CHALLENGER I,377,10.2,502,51,451,tr
37,NEXTENAAA,CHALLENGER I,374,18.7,257,48,209,tr
38,TFT Colorâblê,CHALLENGER I,372,16.5,212,35,177,tr
39,Nîtratex,CHALLENGER I,366,10.6,407,43,364,tr
40,sefaFluxx,CHALLENGER I,365,19.1,953,182,771,tr
41,zikerr,CHALLENGER I,361,14.8,526,78,448,tr
42,Slay,CHALLENGER I,343,21.3,249,53,196,tr
43,BrushLeee,CHALLENGER I,335,15.5,174,27,147,tr
44,THE BOSS PALA,CHALLENGER I,326,13.6,360,49,311,tr
45,StahpItRito v2,CHALLENGER I,321,21.8,174,38,136,tr
46,StahpItRito,CHALLENGER I,314,25.7,183,47,136,tr
47,Discronatia,CHALLENGER I,311,16.7,323,54,269,tr
48,Rapscallion FK,CHALLENGER I,306,21.1,470,99,371,tr
49,Spanker HS,CHALLENGER I,305,20.3,552,112,440,tr
50,Top 8,CHALLENGER I,301,24.8,258,64,194,tr
51,Skinner27,"GRANDMASTER I
G",305,22.1,145,32,113,tr
52,Troll Bir Nick,"GRANDMASTER I
G",298,19.1,873,167,706,tr
53,TFT Ołrïc,"GRANDMASTER I
G",288,13.6,213,29,184,tr
54,Phoebe,"GRANDMASTER I
G",283,19.1,383,73,310,tr
55,No Life Ceset,"GRANDMASTER I
G",279,17.8,691,123,568,tr
56,Furriya,"GRANDMASTER I
G",278,18.5,254,47,207,tr
57,9x37,"GRANDMASTER I
G",260,14.5,606,88,518,tr
58,ƒallenGod,"GRANDMASTER I
G",219,20.0,310,62,248,tr
59,TEOİSTİK,"GRANDMASTER I
G",218,13.4,329,44,285,tr
60,SUQ MADİK,"GRANDMASTER I
G",216,18.9,238,45,193,tr
61,ŹéÐáñìêłš,"GRANDMASTER I
G",202,13.5,683,92,591,tr
62,Sayonara Baby,"GRANDMASTER I
G",197,11.9,902,107,795,tr
63,Kemal KS,"GRANDMASTER I
G",186,15.9,673,107,566,tr
64,ÇokTaRinTinTinV2,"GRANDMASTER I
G",178,18.5,405,75,330,tr
65,Luca Toni,"GRANDMASTER I
G",174,16.9,242,41,201,tr
66,play for a fun,"GRANDMASTER I
G",167,18.3,251,46,205,tr
67,valiumx,"GRANDMASTER I
G",166,12.0,932,112,820,tr
68,Bir Spartalı,"GRANDMASTER I
G",162,17.4,270,47,223,tr
69,ATC Bulbasaur,"GRANDMASTER I
G",161,17.1,245,42,203,tr
70,qR Kai Hiwatari,"GRANDMASTER I
G",160,11.1,343,38,305,tr
71,Prenses Irelia,"GRANDMASTER I
G",156,13.9,567,79,488,tr
72,caglar128,"GRANDMASTER I
G",153,13.3,225,30,195,tr
73,canadianturkey,"GRANDMASTER I
G",151,24.4,172,42,130,tr
74,Jâsper,"GRANDMASTER I
G",150,18.5,178,33,145,tr
75,Kral Leonidass,"GRANDMASTER I
G",148,13.6,824,112,712,tr
76,itsAƒucknComedy,"GRANDMASTER I
G",148,15.3,255,39,216,tr
77,Hyperr roll babe,"GRANDMASTER I
G",147,19.8,116,23,93,tr
78,Beramusluu TFT,"GRANDMASTER I
G",140,15.4,466,72,394,tr
79,Groove Street CJ,"GRANDMASTER I
G",140,11.3,539,61,478,tr
80,My0neSS,"GRANDMASTER I
G",137,17.5,867,152,715,tr
81,Punaise,"GRANDMASTER I
G",130,12.3,1130,139,991,tr
82,GotchaAssBoy,"GRANDMASTER I
G",129,25.8,120,31,89,tr
83,Motosho,"GRANDMASTER I
G",125,20.1,249,50,199,tr
84,Basden,"GRANDMASTER I
G",124,18.0,450,81,369,tr
85,Dr Manhattan,"GRANDMASTER I
G",124,20.8,240,50,190,tr
86,slowly sari,"GRANDMASTER I
G",124,17.1,286,49,237,tr
87,TheBigWal,"GRANDMASTER I
G",123,12.1,224,27,197,tr
88,Boxerli Arap,"GRANDMASTER I
G",121,23.3,270,63,207,tr
89,Kara Sevdalım,"GRANDMASTER I
G",117,19.1,681,130,551,tr
90,Sağtık CEBO,"GRANDMASTER I
G",115,10.9,457,50,407,tr
91,Riven İs Mine,"GRANDMASTER I
G",108,17.7,265,47,218,tr
92,Berke İnan,"GRANDMASTER I
G",106,16.6,265,44,221,tr
93,asvpxtitan,"GRANDMASTER I
G",105,14.0,673,94,579,tr
94,Ragyo,"GRANDMASTER I
G",104,17.2,835,144,691,tr
95,Plug,"GRANDMASTER I
G",104,16.4,384,63,321,tr
96,Sir BÂGÎ,"GRANDMASTER I
G",102,12.1,372,45,327,tr
97,KÜNEFE,"GRANDMASTER I
G",101,15.6,243,38,205,tr
98,T H O S U N,"GRANDMASTER I
G",93,16.8,202,34,168,tr
99,Seyfi Baba QQ,"GRANDMASTER I
G",92,18.0,644,116,528,tr
100,ForyuS,"GRANDMASTER I
G",88,10.7,919,98,821,tr
101,MrDdad,"GRANDMASTER I
G",86,20.1,377,76,301,tr
102,Pressure Fatih,"GRANDMASTER I
G",84,16.9,189,32,157,tr
103,elyêl,"GRANDMASTER I
G",83,22.1,497,110,387,tr
104,wraıth slayer,"GRANDMASTER I
G",81,16.1,224,36,188,tr
105,Castiel2897,"GRANDMASTER I
G",79,17.9,273,49,224,tr
106,ImCurly,"GRANDMASTER I
G",77,16.5,643,106,537,tr
107,Apo sen misin la,"GRANDMASTER I
G",75,17.3,330,57,273,tr
108,ReachijaX,"GRANDMASTER I
G",73,13.3,825,110,715,tr
109,CacaReyiz1907,"GRANDMASTER I
G",71,13.2,714,94,620,tr
110,MertTFT,"GRANDMASTER I
G",71,12.9,340,44,296,tr
111,DT Escanor,"GRANDMASTER I
G",71,15.1,252,38,214,tr
112,Maegi,"GRANDMASTER I
G",70,17.3,336,58,278,tr
113,Gollum TFT,"GRANDMASTER I
G",69,16.6,458,76,382,tr
114,Im Ventum,"GRANDMASTER I
G",69,10.1,396,40,356,tr
115,cropovez,"GRANDMASTER I
G",68,12.7,221,28,193,tr
116,Xaviertz,"GRANDMASTER I
G",64,17.8,400,71,329,tr
117,xTCxINFLAMES,"GRANDMASTER I
G",61,10.2,463,47,416,tr
118,BeeepbeepimaJeep,"GRANDMASTER I
G",61,15.4,214,33,181,tr
119,ISGT PeaceI,"GRANDMASTER I
G",57,15.2,145,22,123,tr
120,Ruheass,"GRANDMASTER I
G",56,17.9,448,80,368,tr
121,WestosTFT,"GRANDMASTER I
G",55,10.5,332,35,297,tr
122,THEPRAT,"GRANDMASTER I
G",53,11.7,403,47,356,tr
123,MhmtAkgl,"GRANDMASTER I
G",49,13.3,600,80,520,tr
124,xlProDRoMaLlx,"GRANDMASTER I
G",49,15.9,214,34,180,tr
125,KimbuLeyla,"GRANDMASTER I
G",49,16.8,149,25,124,tr
126,ÇopurBey,"GRANDMASTER I
G",48,11.5,858,99,759,tr
127,Thanos Pyke,"GRANDMASTER I
G",48,16.0,356,57,299,tr
128,Coria,"GRANDMASTER I
G",48,15.0,373,56,317,tr
129,N0NNstar,"GRANDMASTER I
G",47,16.7,442,74,368,tr
130,Reis Back,"GRANDMASTER I
G",47,12.3,341,42,299,tr
131,mFatality,"GRANDMASTER I
G",46,12.6,538,68,470,tr
132,Nö1 TFT,"GRANDMASTER I
G",45,13.4,357,48,309,tr
133,Rykes,"GRANDMASTER I
G",45,17.0,265,45,220,tr
134,Usta Splinterr,"GRANDMASTER I
G",40,13.6,228,31,197,tr
135,bertugrul,"GRANDMASTER I
G",39,19.9,241,48,193,tr
136,Irrepressible,"GRANDMASTER I
G",38,17.6,261,46,215,tr
137,TFT Orfane,"GRANDMASTER I
G",37,17.5,332,58,274,tr
138,Doğay,"GRANDMASTER I
G",36,18.9,249,47,202,tr
139,ll Mr Yılmâz TFT,"GRANDMASTER I
G",35,15.2,407,62,345,tr
140,ÜSTADIM,"GRANDMASTER I
G",35,12.1,281,34,247,tr
141,LordCampus,"GRANDMASTER I
G",32,18.9,307,58,249,tr
142,TRANSFOURGOT,"GRANDMASTER I
G",14,8.2,218,18,200,tr
143,AcviLion,"GRANDMASTER I
G",9,16.8,447,75,372,tr
144,Mutsuz,"GRANDMASTER I
G",3,13.6,198,27,171,tr
145,SuBA x,"GRANDMASTER I
G",0,5.7,705,40,665,tr
146,OgUzhan22,MASTER I,104,14.2,676,96,580,tr
147,EazyPz,MASTER I,97,22.6,266,60,206,tr
148,ResqueL,MASTER I,91,19.9,206,41,165,tr
149,BBang,MASTER I,63,12.6,748,94,654,tr
150,Nerva,MASTER I,60,14.0,214,30,184,tr
151,TEKSİN,MASTER I,56,15.2,400,61,339,tr
152,SSW,MASTER I,45,13.6,1192,162,1030,tr
153,hi im KeNji ea,MASTER I,43,13.3,776,103,673,tr
154,Ağlak Kebir,MASTER I,35,13.7,182,25,157,tr
155,AxiBy,MASTER I,33,14.9,583,87,496,tr
156,veifanN,MASTER I,31,24.6,244,60,184,tr
157,Boşver,MASTER I,30,18.3,459,84,375,tr
158,sads,MASTER I,30,15.7,511,80,431,tr
159,blobfısh,MASTER I,30,14.4,327,47,280,tr
160,TFT CEBO,MASTER I,30,14.6,157,23,134,tr
161,caydas,MASTER I,29,16.5,611,101,510,tr
162,CHEF CUKKA,MASTER I,29,9.8,531,52,479,tr
163,Terryfold,MASTER I,29,24.3,115,28,87,tr
164,ExeSus v1,MASTER I,28,14.2,718,102,616,tr
165,IamSonGoku,MASTER I,27,13.8,486,67,419,tr
166,SKT X,MASTER I,27,12.3,447,55,392,tr
167,John Scatt,MASTER I,26,17.0,112,19,93,tr
168,AsiTatanqa,MASTER I,23,11.8,365,43,322,tr
169,serseratx,MASTER I,23,15.0,253,38,215,tr
170,diwine fish,MASTER I,23,20.2,163,33,130,tr
171,IV Sentinel,MASTER I,22,17.6,523,92,431,tr
172,Beysal,MASTER I,19,23.1,208,48,160,tr
173,Prince Rhaegar,MASTER I,19,12.2,302,37,265,tr
174,idlemonkk,MASTER I,18,20.6,398,82,316,tr
175,hknelmsua,MASTER I,18,19.9,221,44,177,tr
176,İqos,MASTER I,17,21.5,321,69,252,tr
177,HattoriZarbo,MASTER I,17,15.7,306,48,258,tr
178,UnknownZ7,MASTER I,17,16.7,203,34,169,tr
179,ArcHaic,MASTER I,16,18.6,231,43,188,tr
180,KaanGultekin,MASTER I,16,20.4,176,36,140,tr
181,artyomdh,MASTER I,16,19.9,136,27,109,tr
182,KÓÐ ÃÐI ŻÉÐ,MASTER I,15,16.5,339,56,283,tr
183,BABALARIN AHMET,MASTER I,14,13.8,470,65,405,tr
184,No Pasaran1917,MASTER I,13,19.6,179,35,144,tr
185,Ratom,MASTER I,12,19.9,332,66,266,tr
186,SauirasSalviaa,MASTER I,11,13.6,936,127,809,tr
187,Necessarium,MASTER I,11,13.9,237,33,204,tr
188,BEN THRESH NABER,MASTER I,9,12.3,220,27,193,tr
189,Srcnym,MASTER I,8,18.2,285,52,233,tr
190,AdnantalhaV,MASTER I,8,20.2,233,47,186,tr
191,Peredhil,MASTER I,7,12.8,305,39,266,tr
192,Swarles Barkley,MASTER I,7,27.7,101,28,73,tr
193,IIIMeA CuLpAIII,MASTER I,7,15.9,176,28,148,tr
194,Fenrîr,MASTER I,6,14.1,474,67,407,tr
195,AçılnBenDokturm,MASTER I,6,16.5,261,43,218,tr
196,PARA,MASTER I,6,17.4,224,39,185,tr
197,Qyrieq,MASTER I,6,9.1,242,22,220,tr
198,BarRraK,MASTER I,5,16.5,218,36,182,tr
199,Simurg TFT,MASTER I,5,21.6,162,35,127,tr
200,Bihter ZiyagiI,MASTER I,3,13.3,622,83,539,tr
201,ecivecivokkemj,MASTER I,3,21.2,165,35,130,tr
202,WhackyLuck,MASTER I,2,16.1,477,77,400,tr
203,AshleyG,MASTER I,2,12.3,551,68,483,tr
204,COKKOTUOLDUBU,MASTER I,2,23.9,205,49,156,tr
205,Eless3r,MASTER I,2,16.9,260,44,216,tr
206,Rydec,MASTER I,2,15.5,194,30,164,tr
207,menaSUVARi,MASTER I,1,15.6,212,33,179,tr
208,Night Train,MASTER I,0,14.6,540,79,461,tr
209,ÜzeyirBey,MASTER I,0,18.0,423,76,347,tr
210,GrevenLosT,MASTER I,0,12.5,608,76,532,tr
211,CNS Undomiel,MASTER I,0,14.1,460,65,395,tr
212,MhRayleiphosor,MASTER I,0,20.5,297,61,236,tr
213,WymehcKo,MASTER I,0,16.8,333,56,277,tr
214,Xantherâ,MASTER I,0,14.2,338,48,290,tr
215,LeqacyOfKaiN,MASTER I,0,14.6,322,47,275,tr
216,chessplayer752,MASTER I,0,12.8,343,44,299,tr
217,ZaD,MASTER I,0,15.6,250,39,211,tr
218,KELTOŞ İRFAN xD,MASTER I,0,16.6,229,38,191,tr
219,Plug v2,MASTER I,0,20.4,157,32,125,tr
220,The Ârt of Zed,MASTER I,0,19.2,161,31,130,tr
221,Durp,MASTER I,0,18.8,160,30,130,tr
222,Oscar Bey,MASTER I,0,10.0,299,30,269,tr
223,Xenopa,MASTER I,0,14.2,197,28,169,tr
224,bigballsman,MASTER I,0,31.8,85,27,58,tr
225,bunupthedance,MASTER I,0,30.7,88,27,61,tr
226,JoeHart35,MASTER I,0,18.6,145,27,118,tr
227,ADAMLJAJİC,MASTER I,0,30.9,68,21,47,tr
228,HardcCcore XL,MASTER I,0,10.1,139,14,125,tr
229,Sinjeog Jonjae,DIAMOND I,99,21.0,229,48,181,tr
230,Rüzgâr TFT,DIAMOND I,95,22.9,153,35,118,tr
231,Mahluk,DIAMOND I,94,25.2,341,86,255,tr
232,turkuazv2,DIAMOND I,94,18.8,272,51,221,tr
233,Useless Shaco,DIAMOND I,93,15.4,566,87,479,tr
234,Dodgerın Eltisi,DIAMOND I,90,16.9,326,55,271,tr
235,MurUgi,DIAMOND I,85,13.4,171,23,148,tr
236,YaşaMustafaKemal,DIAMOND I,84,10.4,586,61,525,tr
237,Alzerrax,DIAMOND I,84,22.6,208,47,161,tr
238,SÊßØ,DIAMOND I,83,17.1,304,52,252,tr
239,Hatır Huturoğlu,DIAMOND I,80,14.6,151,22,129,tr
240,mertnag,DIAMOND I,78,18.5,535,99,436,tr
241,Drdilatory,DIAMOND I,76,18.2,417,76,341,tr
242,ExTaCy xL,DIAMOND I,75,16.5,834,138,696,tr
243,MIVAC,DIAMOND I,75,28.3,389,110,279,tr
244,Electus1,DIAMOND I,75,20.4,506,103,403,tr
245,KissKissBangBang,DIAMOND I,75,13.9,695,97,598,tr
246,JesterB,DIAMOND I,75,18.0,532,96,436,tr
247,Justin FoIey,DIAMOND I,75,21.4,317,68,249,tr
248,Blodreina TFT,DIAMOND I,75,16.2,408,66,342,tr
249,jesica xd,DIAMOND I,75,15.9,414,66,348,tr
250,No come turkey,DIAMOND I,75,29.7,219,65,154,tr
251,Zoe the Gypsy,DIAMOND I,75,12.8,484,62,422,tr
252,Lynter,DIAMOND I,75,16.6,331,55,276,tr
253,Taş,DIAMOND I,75,26.1,207,54,153,tr
254,Mythug,DIAMOND I,75,14.1,375,53,322,tr
255,yaegan,DIAMOND I,75,16.5,285,47,238,tr
256,tobiwan cannabis,DIAMOND I,75,21.1,213,45,168,tr
257,YVSKUTSAMACI,DIAMOND I,75,16.0,275,44,231,tr
258,Mindutio,DIAMOND I,75,15.8,221,35,186,tr
259,Skadia,DIAMOND I,75,27.0,126,34,92,tr
260,TFT Mastèr,DIAMOND I,75,19.3,176,34,142,tr
261,Aproxima,DIAMOND I,75,16.8,202,34,168,tr
262,lYouMustDiel,DIAMOND I,75,19.5,164,32,132,tr
263,endiska,DIAMOND I,75,26.4,110,29,81,tr
264,selo sama hd,DIAMOND I,75,16.1,149,24,125,tr
265,Hugiin,DIAMOND I,75,13.6,177,24,153,tr
266,FedaMaster,DIAMOND I,75,21.0,100,21,79,tr
267,Miller Urey X,DIAMOND I,74,16.8,280,47,233,tr
268,Archelaus,DIAMOND I,74,31.0,100,31,69,tr
269,Phenomenal213,DIAMOND I,74,13.8,166,23,143,tr
270,Tavuklara aşığım,DIAMOND I,73,17.8,309,55,254,tr
271,Akaki Akakiyeviç,DIAMOND I,73,12.9,348,45,303,tr
272,idlemonkk 2,DIAMOND I,73,26.3,95,25,70,tr
273,Polîce,DIAMOND I,72,13.7,549,75,474,tr
274,Slvers Rayleigh,DIAMOND I,71,16.9,290,49,241,tr
275,Veichi,DIAMOND I,70,21.6,347,75,272,tr
276,CaptainFBII,DIAMOND I,68,10.3,251,26,225,tr
277,Club America,DIAMOND I,67,25.9,108,28,80,tr
278,LORD OF SAVAŞ,DIAMOND I,66,10.9,631,69,562,tr
279,Sans égal,DIAMOND I,65,19.0,205,39,166,tr
280,Garou26,DIAMOND I,65,15.0,240,36,204,tr
281,SCARFÆCE,DIAMOND I,65,16.2,203,33,170,tr
282,Lilith Sahl,DIAMOND I,65,10.6,301,32,269,tr
283,Against Life,DIAMOND I,64,12.3,616,76,540,tr
284,Negabrione,DIAMOND I,63,20.4,216,44,172,tr
285,HaunteD TFT,DIAMOND I,62,14.2,388,55,333,tr
286,Mavix,DIAMOND I,62,18.3,164,30,134,tr
287,Flaixy,DIAMOND I,60,12.4,153,19,134,tr
288,hakes27,DIAMOND I,59,12.2,359,44,315,tr
289,Speraktif v2,DIAMOND I,58,19.6,163,32,131,tr
290,Itachi Uchiha,DIAMOND I,57,12.0,707,85,622,tr
291,Ildeniz,DIAMOND I,57,17.5,388,68,320,tr
292,Sendoh7,DIAMOND I,56,18.4,320,59,261,tr
293,TheRoseKnight,DIAMOND I,56,19.7,208,41,167,tr
294,FiendStyLe,DIAMOND I,56,26.4,91,24,67,tr
295,AKHİSAR CİNGENİ,DIAMOND I,54,18.8,202,38,164,tr
296,AsSaSINTURK,DIAMOND I,54,13.0,253,33,220,tr
297,Marijuaña,DIAMOND I,52,11.8,831,98,733,tr
298,ÃŁÞhÃ,DIAMOND I,52,20.4,201,41,160,tr
299,PengueNNN2,DIAMOND I,52,13.3,158,21,137,tr
300,Pegnex,DIAMOND I,51,12.4,499,62,437,tr
301,ChefCef,DIAMOND I,51,15.0,367,55,312,tr
302,SoundOfSiIence,DIAMOND I,50,18.1,507,92,415,tr
303,emre kınacı,DIAMOND I,50,17.4,529,92,437,tr
304,lateux,DIAMOND I,50,13.2,606,80,526,tr
305,Rescue 5,DIAMOND I,50,20.2,347,70,277,tr
306,Bunkaya,DIAMOND I,50,12.2,524,64,460,tr
307,Sh1vâ,DIAMOND I,50,17.9,312,56,256,tr
308,GameoweR61,DIAMOND I,50,12.8,406,52,354,tr
309,Kokarca Haydar,DIAMOND I,50,14.6,328,48,280,tr
310,Haccii,DIAMOND I,50,12.9,373,48,325,tr
311,PSG CAT,DIAMOND I,50,17.0,276,47,229,tr
312,Bosch Aldım,DIAMOND I,50,13.8,332,46,286,tr
313,Yağız,DIAMOND I,50,26.9,167,45,122,tr
314,Por8,DIAMOND I,50,21.8,188,41,147,tr
315,The Gurthang,DIAMOND I,50,19.3,197,38,159,tr
316,Sumo deadlift,DIAMOND I,50,16.8,220,37,183,tr
317,serdext,DIAMOND I,50,12.2,302,37,265,tr
318,yüksel812,DIAMOND I,50,16.7,215,36,179,tr
319,SeismicWave,DIAMOND I,50,20.4,162,33,129,tr
320,Colgard 2,DIAMOND I,50,21.6,134,29,105,tr
321,nasty rabbit,DIAMOND I,50,29.3,92,27,65,tr
322,Kubilata,DIAMOND I,50,18.0,150,27,123,tr
323,HassickdiR,DIAMOND I,50,14.1,156,22,134,tr
324,Perceid,DIAMOND I,49,18.3,487,89,398,tr
325,Rota420,DIAMOND I,47,16.5,164,27,137,tr
326,MjoInir,DIAMOND I,46,18.4,353,65,288,tr
327,Ralphan,DIAMOND I,45,15.6,755,118,637,tr
328,âllen,DIAMOND I,45,18.6,145,27,118,tr
329,Ormancı Kız,DIAMOND I,44,15.1,783,118,665,tr
330,Pepee16,DIAMOND I,44,13.6,855,116,739,tr
331,drogbaa37,DIAMOND I,44,9.8,379,37,342,tr
332,WL Poew,DIAMOND I,44,17.9,195,35,160,tr
333,IBRAHIMOVICYUS,DIAMOND I,43,16.3,306,50,256,tr
334,3sok,DIAMOND I,43,21.5,181,39,142,tr
335,Iyilik YaraKI,DIAMOND I,43,16.3,233,38,195,tr
336,Vexillary,DIAMOND I,42,11.6,751,87,664,tr
337,Marcus Blake,DIAMOND I,42,14.0,385,54,331,tr
338,Heisenberg CP,DIAMOND I,42,14.6,349,51,298,tr
339,MertColak,DIAMOND I,41,26.6,233,62,171,tr
340,Techila,DIAMOND I,41,16.7,257,43,214,tr
341,İyi Kalpli Aley,DIAMOND I,41,14.0,250,35,215,tr
342,llumyos,DIAMOND I,41,15.2,223,34,189,tr
343,Endokarditt,DIAMOND I,40,14.5,393,57,336,tr
344,M Ê R T J O H N,DIAMOND I,40,15.2,230,35,195,tr
345,ROBERTO FİRMİNO,DIAMOND I,40,12.8,140,18,122,tr
346,Móoncake,DIAMOND I,39,20.7,357,74,283,tr
347,lave242,DIAMOND I,39,12.8,506,65,441,tr
348,TIFITCI,DIAMOND I,39,17.8,146,26,120,tr
349,LordOguzKagan,DIAMOND I,39,29.3,82,24,58,tr
350,MAFEDERİN MAF,DIAMOND I,38,22.3,641,143,498,tr
351,MaSuaé,DIAMOND I,37,13.1,1509,198,1311,tr
352,w0lverinee,DIAMOND I,37,15.2,1059,161,898,tr
353,Roswell v1,DIAMOND I,37,16.5,346,57,289,tr
354,ˆ G7 ˆ,DIAMOND I,37,17.5,315,55,260,tr
355,lmPerfect,DIAMOND I,37,23.1,186,43,143,tr
356,TeoJii,DIAMOND I,37,15.4,272,42,230,tr
357,Hısımus,DIAMOND I,37,17.6,204,36,168,tr
358,karpuz çilek,DIAMOND I,37,13.4,119,16,103,tr
359,Limon ve Kimyon,DIAMOND I,36,10.5,210,22,188,tr
360,675115,DIAMOND I,35,14.2,512,73,439,tr
361,VouLDead,DIAMOND I,35,15.7,338,53,285,tr
362,TR Ryzê,DIAMOND I,34,15.9,364,58,306,tr
363,Milli Güç,DIAMOND I,34,22.9,214,49,165,tr
364,Twiqqy,DIAMOND I,34,16.5,260,43,217,tr
365,Zerone,DIAMOND I,34,15.9,232,37,195,tr
366,Cleveyton,DIAMOND I,34,19.6,168,33,135,tr
367,N3squiKk,DIAMOND I,33,15.7,127,20,107,tr
368,JB Cloudy,DIAMOND I,32,13.8,671,93,578,tr
369,HaydiBusteR,DIAMOND I,32,14.9,428,64,364,tr
370,Alpha  Yozgyur,DIAMOND I,32,12.4,420,52,368,tr
371,ertgskrcii,DIAMOND I,32,17.4,264,46,218,tr
372,sirchadol,DIAMOND I,32,14.4,215,31,184,tr
373,yanıyomsöndür,DIAMOND I,31,16.7,275,46,229,tr
374,Kıvırcık Pompa,DIAMOND I,31,12.2,221,27,194,tr
375,IIKRGZII,DIAMOND I,30,18.6,413,77,336,tr
376,UMP,DIAMOND I,30,24.1,191,46,145,tr
377,Machope,DIAMOND I,30,15.1,218,33,185,tr
378,iHTiYaR,DIAMOND I,29,8.3,516,43,473,tr
379,Ceminson,DIAMOND I,29,13.5,303,41,262,tr
380,Alanyalı Efe,DIAMOND I,29,25.4,142,36,106,tr
381,Goku,DIAMOND I,29,11.7,239,28,211,tr
382,sosyolog95,DIAMOND I,28,17.1,445,76,369,tr
383,guido05,DIAMOND I,28,14.1,313,44,269,tr
384,gahpe GİRAY,DIAMOND I,27,13.8,463,64,399,tr
385,mustafa1t,DIAMOND I,27,9.8,612,60,552,tr
386,CLL,DIAMOND I,27,17.1,204,35,169,tr
387,Gj MRX,DIAMOND I,27,9.0,200,18,182,tr
388,Neuveorix,DIAMOND I,26,16.4,766,126,640,tr
389,Laportee,DIAMOND I,25,16.0,493,79,414,tr
390,Seras Viktoria,DIAMOND I,25,24.2,298,72,226,tr
391,Asetaa,DIAMOND I,25,18.6,312,58,254,tr
392,KartoncuSevo,DIAMOND I,25,23.1,173,40,133,tr
393,Gelfling,DIAMOND I,25,23.8,164,39,125,tr
394,Eldjötnar,DIAMOND I,25,16.1,242,39,203,tr
395,MinionBlock,DIAMOND I,25,17.8,174,31,143,tr
396,020420160758,DIAMOND I,25,13.4,142,19,123,tr
397,unforgiving,DIAMOND I,24,15.4,332,51,281,tr
398,KERZO,DIAMOND I,24,20.4,235,48,187,tr
399,Honey Messalina,DIAMOND I,24,14.7,293,43,250,tr
400,SoRuNumVar,DIAMOND I,24,18.5,135,25,110,tr
401,madckins2,DIAMOND I,23,10.6,717,76,641,tr
402,Maybe One Dayˆ,DIAMOND I,23,18.0,322,58,264,tr
403,XecutioneRiven,DIAMOND I,23,12.8,297,38,259,tr
404,sabonohiken,DIAMOND I,23,15.7,121,19,102,tr
405,Double Helix,DIAMOND I,22,13.4,149,20,129,tr
406,GoyGoyyCu,DIAMOND I,21,13.1,382,50,332,tr
407,Papaz Riçhırt,DIAMOND I,21,16.4,298,49,249,tr
408,Dorçe,DIAMOND I,21,20.0,210,42,168,tr
409,frambuazll,DIAMOND I,20,15.2,289,44,245,tr
410,PatoShiq,DIAMOND I,20,12.9,256,33,223,tr
411,FanFinFon,DIAMOND I,19,15.3,334,51,283,tr
412,U WOT MVIII,DIAMOND I,19,25.4,177,45,132,tr
413,Hazârdous,DIAMOND I,19,20.5,161,33,128,tr
414,bunnycery,DIAMOND I,19,8.0,327,26,301,tr
415,Alper,DIAMOND I,18,16.5,272,45,227,tr
416,twnku,DIAMOND I,18,23.5,179,42,137,tr
417,GM Jaqen,DIAMOND I,17,14.7,991,146,845,tr
418,slm ben aspirin,DIAMOND I,17,18.3,431,79,352,tr
419,GhostRider01,DIAMOND I,17,14.9,321,48,273,tr
420,Phenomenal214,DIAMOND I,17,18.9,111,21,90,tr
421,Ömércan,DIAMOND I,16,21.7,152,33,119,tr
422,DuDa TFT,DIAMOND I,16,16.5,139,23,116,tr
423,HolyMan34,DIAMOND I,14,11.1,642,71,571,tr
424,JuJuFiFi,DIAMOND I,14,13.3,337,45,292,tr
425,CLOUDS GOD,DIAMOND I,13,18.8,165,31,134,tr
426,Tasty,DIAMOND I,13,16.8,155,26,129,tr
427,Sıgmund Freud,DIAMOND I,12,19.2,338,65,273,tr
428,Swagger94,DIAMOND I,12,19.5,241,47,194,tr
429,programlama123,DIAMOND I,12,18.5,216,40,176,tr
430,AshCrimson,DIAMOND I,12,9.9,332,33,299,tr
431,Şürkü,DIAMOND I,11,13.5,557,75,482,tr
432,BlindBruceLee,DIAMOND I,11,22.4,250,56,194,tr
433,HolyTheLost,DIAMOND I,11,16.9,326,55,271,tr
434,kemalesme,DIAMOND I,11,18.9,254,48,206,tr
435,DaricK,DIAMOND I,11,13.3,346,46,300,tr
436,avienex,DIAMOND I,11,10.8,426,46,380,tr
437,4Absinth,DIAMOND I,10,18.6,237,44,193,tr
438,UnutkanAdam,DIAMOND I,10,29.8,124,37,87,tr
439,Yukokano,DIAMOND I,9,20.3,236,48,188,tr
440,Xiphos,DIAMOND I,9,21.9,187,41,146,tr
441,Janiabin,DIAMOND I,8,20.5,205,42,163,tr
442,Minik Efsanem,DIAMOND I,8,12.5,327,41,286,tr
443,xElessaRx,DIAMOND I,8,7.5,536,40,496,tr
444,Mâîn Hêsâbîm TFT,DIAMOND I,7,14.2,141,20,121,tr
445,Berladriojon,DIAMOND I,6,15.7,248,39,209,tr
446,Z1AN,DIAMOND I,6,16.2,228,37,191,tr
447,Teemoş,DIAMOND I,6,11.5,321,37,284,tr
448,Jov is Back,DIAMOND I,6,13.8,188,26,162,tr
449,SebastiaN1,DIAMOND I,5,13.0,347,45,302,tr
450,melikacet,DIAMOND I,3,11.9,369,44,325,tr
451,lolisking1,DIAMOND I,3,24.1,170,41,129,tr
452,BADFATHER,DIAMOND I,3,12.2,336,41,295,tr
453,ORMAN MESUT V2,DIAMOND I,3,11.6,318,37,281,tr
454,KarpotasiN,DIAMOND I,3,13.3,256,34,222,tr
455,Th3ng3s1z,DIAMOND I,3,17.5,177,31,146,tr
456,KİLLA ONUR,DIAMOND I,2,20.9,368,77,291,tr
457,Mustoyevski TFT,DIAMOND I,2,19.8,293,58,235,tr
458,ineffableHK,DIAMOND I,2,21.3,183,39,144,tr
459,lllIIIIllIlIlI,DIAMOND I,2,23.3,103,24,79,tr
460,VEXES,DIAMOND I,1,14.4,667,96,571,tr
461,TEKLEYEN ÇAR,DIAMOND I,1,18.4,201,37,164,tr
462,Âmethyst,DIAMOND I,1,15.5,142,22,120,tr
463,MBURAKLOL TWiTCH,DIAMOND I,0,16.6,997,166,831,tr
464,OneTruth Aimless,DIAMOND I,0,22.3,476,106,370,tr
465,babekizm,DIAMOND I,0,12.5,842,105,737,tr
466,Wondabitte JR,DIAMOND I,0,17.2,564,97,467,tr
467,PrequaL,DIAMOND I,0,15.7,618,97,521,tr
468,QTAĞ,DIAMOND I,0,13.0,691,90,601,tr
469,DIZDIZ EKREM,DIAMOND I,0,15.3,522,80,442,tr
470,sikkke,DIAMOND I,0,17.1,420,72,348,tr
471,bibakipcikcam2,DIAMOND I,0,19.3,357,69,288,tr
472,Reaper oƒ Souls,DIAMOND I,0,16.0,430,69,361,tr
473,O F L U  R E Î S,DIAMOND I,0,12.2,547,67,480,tr
474,TFT Lynch,DIAMOND I,0,12.1,531,64,467,tr
475,Itachi the God,DIAMOND I,0,20.3,310,63,247,tr
476,CBF Pscho,DIAMOND I,0,9.4,671,63,608,tr
477,Gannicius,DIAMOND I,0,19.8,308,61,247,tr
478,Herun,DIAMOND I,0,18.3,334,61,273,tr
479,XXLeonardoX,DIAMOND I,0,14.0,436,61,375,tr
480,TFT SAYGO,DIAMOND I,0,13.2,463,61,402,tr
481,Prograsiva,DIAMOND I,0,15.1,392,59,333,tr
482,M xDharma,DIAMOND I,0,11.0,536,59,477,tr
483,enjoy90,DIAMOND I,0,15.7,369,58,311,tr
484,Rachel,DIAMOND I,0,15.3,379,58,321,tr
485,fztenginyildirim,DIAMOND I,0,15.2,362,55,307,tr
486,Radyum,DIAMOND I,0,14.4,361,52,309,tr
487,WORST SUPPORT,DIAMOND I,0,13.6,383,52,331,tr
488,Smøøthie,DIAMOND I,0,20.2,243,49,194,tr
489,aylakayyaş,DIAMOND I,0,15.5,316,49,267,tr
490,lSkyBanel,DIAMOND I,0,16.0,294,47,247,tr
491,xeâ,DIAMOND I,0,11.5,401,46,355,tr
492,IBaşKaNIRuling,DIAMOND I,0,16.1,274,44,230,tr
493,I WOLFGANG I,DIAMOND I,0,15.5,284,44,240,tr
494,TaTux,DIAMOND I,0,10.7,410,44,366,tr
495,ShittyName,DIAMOND I,0,18.4,233,43,190,tr
496,musulsezar,DIAMOND I,0,10.8,398,43,355,tr
497,erdogankarakus,DIAMOND I,0,15.6,270,42,228,tr
498,The Memo,DIAMOND I,0,15.4,272,42,230,tr
499,Zugaşi Bere,DIAMOND I,0,21.0,195,41,154,tr
500,Ðèstèk,DIAMOND I,0,16.3,252,41,211,tr
1,KroniiinepTFT,CHALLENGER I,908,27.9,355,99,256,ru
2,aLeProfane,CHALLENGER I,882,26.4,375,99,276,ru
3,HORNIE MY BABY,CHALLENGER I,772,33.5,260,87,173,ru
4,Dyachello,CHALLENGER I,747,20.6,398,82,316,ru
5,chmochma,CHALLENGER I,704,24.5,302,74,228,ru
6,Nycteus,CHALLENGER I,647,22.8,215,49,166,ru
7,LMS trojancbkui,CHALLENGER I,575,14.7,592,87,505,ru
8,kobeyang,CHALLENGER I,570,28.7,544,156,388,ru
9,WuHan jiayou,CHALLENGER I,569,28.1,224,63,161,ru
10,МRAZIverniteNICK,CHALLENGER I,440,26.5,355,94,261,ru
11,Yablo4niy,CHALLENGER I,395,24.9,185,46,139,ru
12,DespicabIe,CHALLENGER I,369,25.2,294,74,220,ru
13,L9 Rengy,CHALLENGER I,367,17.6,541,95,446,ru
14,superworldRU,CHALLENGER I,360,19.6,373,73,300,ru
15,kiiller,CHALLENGER I,337,18.6,210,39,171,ru
16,Marijuanamama,CHALLENGER I,322,15.7,351,55,296,ru
17,Тяньци,CHALLENGER I,322,21.5,186,40,146,ru
18,Hardrinnz,CHALLENGER I,308,30.0,150,45,105,ru
19,DrKaktys,CHALLENGER I,297,17.4,195,34,161,ru
20,Theblueboy,CHALLENGER I,293,30.1,199,60,139,ru
21,KENGBI,CHALLENGER I,291,20.0,509,102,407,ru
22,NMЯ NO ИМЯ,CHALLENGER I,268,20.2,312,63,249,ru
23,CNGOOD,CHALLENGER I,247,24.5,257,63,194,ru
24,NeverTrustSoloQ,CHALLENGER I,232,24.4,197,48,149,ru
25,Авиатор Платонов,CHALLENGER I,221,24.9,333,83,250,ru
26,Zauberbiest,CHALLENGER I,219,17.9,262,47,215,ru
27,VN iRabity,CHALLENGER I,199,19.8,645,128,517,ru
28,Không Có Link,CHALLENGER I,198,17.4,596,104,492,ru
29,Светофорчик,CHALLENGER I,196,26.4,250,66,184,ru
30,JoSmog,CHALLENGER I,195,15.9,615,98,517,ru
31,FIMA,CHALLENGER I,195,21.9,246,54,192,ru
32,CNGOOD1,CHALLENGER I,195,21.6,232,50,182,ru
33,Sacred Nоrris,CHALLENGER I,182,14.2,1356,192,1164,ru
34,Sоul Reaver,CHALLENGER I,165,20.8,183,38,145,ru
35,Programmer,CHALLENGER I,161,16.5,212,35,177,ru
36,ENDEAVOUR,CHALLENGER I,156,18.6,307,57,250,ru
37,ìnsane,CHALLENGER I,151,20.3,300,61,239,ru
38,e 1,CHALLENGER I,149,17.8,353,63,290,ru
39,Legenda of LOL,CHALLENGER I,145,13.2,340,45,295,ru
40,Iggi 1TrickPferd,CHALLENGER I,136,27.4,168,46,122,ru
41,Mark of uroboros,CHALLENGER I,132,21.7,968,210,758,ru
42,Torianos,CHALLENGER I,132,11.9,594,71,523,ru
43,Kahzoo is KING,CHALLENGER I,127,32.4,102,33,69,ru
44,Кисюня,CHALLENGER I,125,27.8,108,30,78,ru
45,Long live China,CHALLENGER I,120,18.1,276,50,226,ru
46,fantik999,CHALLENGER I,119,16.2,173,28,145,ru
47,Paprika,CHALLENGER I,118,20.9,172,36,136,ru
48,Bingo123456,CHALLENGER I,107,17.7,373,66,307,ru
49,BEASTMXDE,CHALLENGER I,99,18.7,375,70,305,ru
50,Rocket MaRin,CHALLENGER I,49,23.6,233,55,178,ru
51,Kapibaro,"GRANDMASTER I
G",101,23.5,344,81,263,ru
52,yurchiv,"GRANDMASTER I
G",97,10.1,716,72,644,ru
53,Sebastian7,"GRANDMASTER I
G",84,21.8,239,52,187,ru
54,СерёгаСПб,"GRANDMASTER I
G",75,19.1,430,82,348,ru
55,PeiPei,"GRANDMASTER I
G",71,13.0,478,62,416,ru
56,lza,"GRANDMASTER I
G",69,21.4,201,43,158,ru
57,Sapfer,"GRANDMASTER I
G",68,17.3,496,86,410,ru
58,NikeIII,"GRANDMASTER I
G",63,29.1,182,53,129,ru
59,CuPofCrAcK,"GRANDMASTER I
G",61,11.0,399,44,355,ru
60,LegendsNeverDIE0,"GRANDMASTER I
G",58,23.5,277,65,212,ru
61,BomBibomXD,"GRANDMASTER I
G",58,12.6,515,65,450,ru
62,Rukashi,"GRANDMASTER I
G",50,31.5,108,34,74,ru
63,Arclight Panda,"GRANDMASTER I
G",48,19.4,381,74,307,ru
64,Silent Sona,"GRANDMASTER I
G",38,19.6,383,75,308,ru
65,dontlookatmepls,"GRANDMASTER I
G",36,32.2,90,29,61,ru
66,Youbanyouto,"GRANDMASTER I
G",34,18.6,194,36,158,ru
67,im famous,"GRANDMASTER I
G",34,15.7,229,36,193,ru
68,Hoang,"GRANDMASTER I
G",33,20.9,201,42,159,ru
69,ZiGZaG08,"GRANDMASTER I
G",32,16.4,262,43,219,ru
70,zhangqiling,"GRANDMASTER I
G",32,16.3,264,43,221,ru
71,The Inspired One,"GRANDMASTER I
G",30,20.3,148,30,118,ru
72,Spring North,"GRANDMASTER I
G",29,18.0,233,42,191,ru
73,Arcade bÔÔbs,"GRANDMASTER I
G",25,21.1,512,108,404,ru
74,K R I P S I,"GRANDMASTER I
G",25,23.9,264,63,201,ru
75,Shinkulirion,"GRANDMASTER I
G",21,21.7,378,82,296,ru
76,Ветра Севера,"GRANDMASTER I
G",17,9.0,565,51,514,ru
77,bingo666fly,"GRANDMASTER I
G",17,21.6,167,36,131,ru
78,hornie,"GRANDMASTER I
G",15,27.2,136,37,99,ru
79,Ice Ivern,"GRANDMASTER I
G",13,15.2,236,36,200,ru
80,ПаГа,"GRANDMASTER I
G",12,13.9,431,60,371,ru
81,Tâm Luct,"GRANDMASTER I
G",7,16.1,224,36,188,ru
82,Крада,"GRANDMASTER I
G",6,12.8,602,77,525,ru
83,inspekt0r,"GRANDMASTER I
G",5,18.6,333,62,271,ru
84,Генерал Docta,"GRANDMASTER I
G",5,29.7,155,46,109,ru
85,AlloC,"GRANDMASTER I
G",3,21.1,199,42,157,ru
86,ropo4ka,"GRANDMASTER I
G",0,17.6,449,79,370,ru
87,TFT tsm,"GRANDMASTER I
G",0,16.2,431,70,361,ru
88,Hand off 3,"GRANDMASTER I
G",0,20.6,334,69,265,ru
89,Hen predator,"GRANDMASTER I
G",0,19.8,338,67,271,ru
90,Kiss my fizz,"GRANDMASTER I
G",0,21.3,301,64,237,ru
91,Джим Рейнор,"GRANDMASTER I
G",0,17.7,311,55,256,ru
92,Morozilkin,"GRANDMASTER I
G",0,21.8,220,48,172,ru
93,ruComix,"GRANDMASTER I
G",0,23.4,201,47,154,ru
94,Hail of Blades,"GRANDMASTER I
G",0,24.2,161,39,122,ru
95,Killl Lov3,"GRANDMASTER I
G",0,24.2,120,29,91,ru
96,iQuestions,"GRANDMASTER I
G",0,18.9,132,25,107,ru
97,Леди Меламори,MASTER I,16,14.7,211,31,180,ru
98,Th3Gambl3r,MASTER I,13,19.2,603,116,487,ru
99,Воруй94,DIAMOND I,86,26.2,141,37,104,ru
100,Anurion89,DIAMOND I,83,20.2,312,63,249,ru
101,Wuaneon,DIAMOND I,82,19.2,161,31,130,ru
102,BrotherFrank,DIAMOND I,77,26.2,126,33,93,ru
103,thanh169,DIAMOND I,75,22.8,552,126,426,ru
104,TOMSK7777,DIAMOND I,75,23.1,399,92,307,ru
105,ChinaNirvana,DIAMOND I,75,22.3,399,89,310,ru
106,Крушитель001,DIAMOND I,75,19.2,369,71,298,ru
107,EmperorCHN,DIAMOND I,75,25.4,264,67,197,ru
108,SUSUWE,DIAMOND I,75,17.0,383,65,318,ru
109,Lorraine,DIAMOND I,75,27.0,233,63,170,ru
110,DuongLan,DIAMOND I,75,16.1,367,59,308,ru
111,Eldrax,DIAMOND I,75,13.4,441,59,382,ru
112,lºˆºl,DIAMOND I,75,23.0,248,57,191,ru
113,1348319349,DIAMOND I,75,21.1,270,57,213,ru
114,Saitaf,DIAMOND I,75,23.0,226,52,174,ru
115,qsoso,DIAMOND I,75,17.2,302,52,250,ru
116,dyboщит,DIAMOND I,75,18.5,276,51,225,ru
117,blvckboy,DIAMOND I,75,15.3,320,49,271,ru
118,Dunngarm,DIAMOND I,75,26.3,171,45,126,ru
119,CR0WNZ,DIAMOND I,75,16.0,269,43,226,ru
120,Make me Purr,DIAMOND I,75,20.0,200,40,160,ru
121,RaNdoOoMuK,DIAMOND I,75,20.5,190,39,151,ru
122,Just Cancer,DIAMOND I,75,18.4,207,38,169,ru
123,vulcaner,DIAMOND I,66,21.1,185,39,146,ru
124,sketcheer,DIAMOND I,59,17.0,306,52,254,ru
125,Trang4438,DIAMOND I,55,19.8,393,78,315,ru
126,Remilia Scarlet,DIAMOND I,55,21.8,211,46,165,ru
127,Малолетка,DIAMOND I,54,33.3,75,25,50,ru
128,NikolayDjan,DIAMOND I,53,18.4,451,83,368,ru
129,Callsign Kindred,DIAMOND I,52,33.0,88,29,59,ru
130,AKJSDs,DIAMOND I,49,24.9,201,50,151,ru
131,Дрeeейвен,DIAMOND I,48,11.0,662,73,589,ru
132,УРОД,DIAMOND I,48,40.1,177,71,106,ru
133,HMTuanRu,DIAMOND I,48,19.3,342,66,276,ru
134,NorMe,DIAMOND I,46,18.4,152,28,124,ru
135,KissTheStar,DIAMOND I,44,9.2,413,38,375,ru
136,TG Rot Stillness,DIAMOND I,42,11.9,393,47,346,ru
137,Жабка Лиска,DIAMOND I,41,23.7,287,68,219,ru
138,junestone,DIAMOND I,41,30.4,214,65,149,ru
139,sasha1OOO,DIAMOND I,39,19.1,178,34,144,ru
140,royál beggar,DIAMOND I,38,23.6,186,44,142,ru
141,Snowman322,DIAMOND I,37,14.7,470,69,401,ru
142,ReMiXoN007,DIAMOND I,33,22.7,141,32,109,ru
143,8xm12a,DIAMOND I,32,11.6,276,32,244,ru
144,PistolMaravich,DIAMOND I,25,36.1,263,95,168,ru
145,SUPRAAAA,DIAMOND I,25,26.3,99,26,73,ru
146,Ayumiclq313,DIAMOND I,23,23.0,126,29,97,ru
147,CapsuleZZZ,DIAMOND I,20,17.0,212,36,176,ru
148,Kimchi wang,DIAMOND I,17,34.6,127,44,83,ru
149,Arclight JinBey,DIAMOND I,16,18.5,319,59,260,ru
150,StaverOk,DIAMOND I,14,21.2,231,49,182,ru
151,beznika2,DIAMOND I,14,14.6,213,31,182,ru
152,kecodon9x,DIAMOND I,12,18.0,205,37,168,ru
153,Ignotas,DIAMOND I,12,23.6,89,21,68,ru
154,Лапки Юми,DIAMOND I,11,16.1,328,53,275,ru
155,Ji Yong,DIAMOND I,11,13.3,279,37,242,ru
156,Ksorn,DIAMOND I,11,12.4,202,25,177,ru
157,ПоНосик в Одеяле,DIAMOND I,10,28.3,191,54,137,ru
158,лесk urself jgl,DIAMOND I,9,20.2,203,41,162,ru
159,SorrNyak,DIAMOND I,9,18.3,197,36,161,ru
160,Takanashi Hikka,DIAMOND I,9,18.6,167,31,136,ru
161,Юрa,DIAMOND I,5,15.0,207,31,176,ru
162,Cоming Down,DIAMOND I,4,17.1,216,37,179,ru
163,Tot,DIAMOND I,4,19.2,135,26,109,ru
164,Evildeaad,DIAMOND I,4,27.8,90,25,65,ru
165,ktotamnukogonet,DIAMOND I,3,25.8,128,33,95,ru
166,royál beggar,DIAMOND I,3,20.7,150,31,119,ru
167,angelys,DIAMOND I,3,10.4,288,30,258,ru
168,AeCorah,DIAMOND I,0,25.0,572,143,429,ru
169,SadSlipperS,DIAMOND I,0,12.1,546,66,480,ru
170,LHYloveLWJ,DIAMOND I,0,14.5,435,63,372,ru
171,Janelicher,DIAMOND I,0,28.8,208,60,148,ru
172,Лёшкина игра,DIAMOND I,0,24.2,231,56,175,ru
173,Вика Клубника,DIAMOND I,0,21.3,249,53,196,ru
174,GGJIANG,DIAMOND I,0,18.9,281,53,228,ru
175,LooKDKc,DIAMOND I,0,19.5,267,52,215,ru
176,LPL dynasty,DIAMOND I,0,21.7,212,46,166,ru
177,Фабио,DIAMOND I,0,21.1,199,42,157,ru
178,Мёртвый принц,DIAMOND I,0,18.1,221,40,181,ru
179,taibox,DIAMOND I,0,12.0,316,38,278,ru
180,EleemY,DIAMOND I,0,33.0,112,37,75,ru
181,clown syndrome,DIAMOND I,0,22.1,154,34,120,ru
182,PINCER,DIAMOND I,0,25.6,125,32,93,ru
183,JusticeNari,DIAMOND I,0,15.2,210,32,178,ru
184,Дым из трубы,DIAMOND I,0,27.2,103,28,75,ru
185,Vladimir Syusin,DIAMOND I,0,11.0,246,27,219,ru
186,Russiabang,DIAMOND I,0,11.5,200,23,177,ru
187,Kalabaka,DIAMOND II,96,27.2,872,237,635,ru
188,MuTuZ,DIAMOND II,88,15.5,213,33,180,ru
189,mTxFaT,DIAMOND II,85,18.3,881,161,720,ru
190,liuzhuni,DIAMOND II,84,14.4,1032,149,883,ru
191,Emma Hix,DIAMOND II,82,27.4,117,32,85,ru
192,Desperateing,DIAMOND II,76,30.8,78,24,54,ru
193,CN liang,DIAMOND II,75,16.3,423,69,354,ru
194,laojiazuishuai,DIAMOND II,75,18.6,334,62,272,ru
195,WO S LAOMAOZI,DIAMOND II,75,21.6,268,58,210,ru
196,lanyuheissl55555,DIAMOND II,75,19.9,276,55,221,ru
197,Bushuwotoudehong,DIAMOND II,75,19.9,276,55,221,ru
198,Lord Ochinchin,DIAMOND II,75,54.1,98,53,45,ru
199,RngUziJianZihao,DIAMOND II,75,18.4,266,49,217,ru
200,sitius1986,DIAMOND II,75,17.6,279,49,230,ru
201,Мерцание,DIAMOND II,75,9.7,462,45,417,ru
202,CK Guard,DIAMOND II,75,24.7,178,44,134,ru
203,xcvwdst,DIAMOND II,75,41.2,102,42,60,ru
204,Mofu mofu,DIAMOND II,75,55.4,65,36,29,ru
205,Zhenya29,DIAMOND II,75,13.3,270,36,234,ru
206,БистФромЗеИст,DIAMOND II,75,18.6,183,34,149,ru
207,AkitoHunter,DIAMOND II,75,11.1,297,33,264,ru
208,Futaba Sakura,DIAMOND II,75,24.8,129,32,97,ru
209,AileenWuornos,DIAMOND II,75,7.2,250,18,232,ru
210,PewDiePew,DIAMOND II,70,22.6,221,50,171,ru
211,daozige,DIAMOND II,69,16.4,195,32,163,ru
212,Jidaykin,DIAMOND II,68,16.2,283,46,237,ru
213,ASREN,DIAMOND II,66,18.8,138,26,112,ru
214,Sizif,DIAMOND II,64,11.7,180,21,159,ru
215,VN Error RoLL,DIAMOND II,62,13.7,622,85,537,ru
216,DianaEatme,DIAMOND II,62,14.7,136,20,116,ru
217,DeadKedbl,DIAMOND II,61,29.8,188,56,132,ru
218,bone,DIAMOND II,56,13.7,278,38,240,ru
219,TheRedDevils,DIAMOND II,55,17.4,507,88,419,ru
220,STRMASTER,DIAMOND II,55,23.8,210,50,160,ru
221,DuKeH,DIAMOND II,49,17.6,295,52,243,ru
222,nn21,DIAMOND II,48,45.0,60,27,33,ru
223,Cho Em Mãnh Thú,DIAMOND II,46,16.4,269,44,225,ru
224,Disnaix Kh,DIAMOND II,43,19.5,318,62,256,ru
225,Donelly,DIAMOND II,40,14.3,175,25,150,ru
226,DEDASHAVAL,DIAMOND II,36,16.0,131,21,110,ru
227,bpbogdan,DIAMOND II,34,14.5,738,107,631,ru
228,mallaby,DIAMOND II,33,22.7,278,63,215,ru
229,Таксидермист1980,DIAMOND II,32,11.2,509,57,452,ru
230,Black Swift,DIAMOND II,31,19.7,228,45,183,ru
231,СЛЕСАРЬ СБОРЩИК,DIAMOND II,31,11.9,202,24,178,ru
232,Coca Cola,DIAMOND II,29,15.6,377,59,318,ru
233,ТРУСИКИ АНДРЕАСА,DIAMOND II,29,17.4,184,32,152,ru
234,CHNFan,DIAMOND II,28,20.9,206,43,163,ru
235,ЛУЧШИЙ ИГРОК РУ,DIAMOND II,28,17.9,229,41,188,ru
236,E11iks,DIAMOND II,28,15.0,206,31,175,ru
237,NickDeko,DIAMOND II,26,18.3,416,76,340,ru
238,MashironIII,DIAMOND II,26,8.1,408,33,375,ru
239,cepl4,DIAMOND II,25,17.7,355,63,292,ru
240,Manode,DIAMOND II,25,18.4,261,48,213,ru
241,N0SkillZz,DIAMOND II,25,36.5,126,46,80,ru
242,Леон Надо,DIAMOND II,25,30.3,122,37,85,ru
243,MyPABEu13,DIAMOND II,25,14.2,240,34,206,ru
244,Сижу чешу колоду,DIAMOND II,25,17.2,186,32,154,ru
245,John  McClane 1,DIAMOND II,25,5.2,400,21,379,ru
246,Concubine,DIAMOND II,25,11.8,153,18,135,ru
247,Napyyyy,DIAMOND II,23,14.3,280,40,240,ru
248,ˆЛëësïnˆVNˆ,DIAMOND II,22,16.2,389,63,326,ru
249,bloodgammy,DIAMOND II,22,8.2,427,35,392,ru
250,Ruff85,DIAMOND II,21,23.9,251,60,191,ru
251,Одинсан,DIAMOND II,21,16.0,307,49,258,ru
252,Фезам,DIAMOND II,21,14.1,277,39,238,ru
253,StrongestMalice,DIAMOND II,21,24.6,138,34,104,ru
254,BONDJik,DIAMOND II,17,10.2,441,45,396,ru
255,EbokvakXXL,DIAMOND II,15,15.3,373,57,316,ru
256,LASTURN,DIAMOND II,15,20.5,259,53,206,ru
257,ljx001,DIAMOND II,15,20.6,204,42,162,ru
258,oi SEREGA io,DIAMOND II,13,12.1,994,120,874,ru
259,PieMaker,DIAMOND II,13,14.3,342,49,293,ru
260,olanva,DIAMOND II,12,19.9,407,81,326,ru
261,Britney Shears,DIAMOND II,10,12.5,313,39,274,ru
262,GEOtiger,DIAMOND II,9,15.8,292,46,246,ru
263,новый год ios,DIAMOND II,7,16.5,194,32,162,ru
264,SERHIOVIP,DIAMOND II,7,13.3,211,28,183,ru
265,PuddleOfChange,DIAMOND II,5,13.2,228,30,198,ru
266,kalan44,DIAMOND II,4,9.8,518,51,467,ru
267,China Mortal,DIAMOND II,1,24.4,156,38,118,ru
268,Matt,DIAMOND II,1,30.0,90,27,63,ru
269,KURISU ТИНА,DIAMOND II,0,19.3,969,187,782,ru
270,LoveTrucks,DIAMOND II,0,16.6,604,100,504,ru
271,SУKA,DIAMOND II,0,16.5,550,91,459,ru
272,LurDOOM,DIAMOND II,0,18.0,483,87,396,ru
273,Garru poterr bl9,DIAMOND II,0,11.7,622,73,549,ru
274,iamaha,DIAMOND II,0,19.3,363,70,293,ru
275,basist0s,DIAMOND II,0,14.1,489,69,420,ru
276,JVevermind,DIAMOND II,0,14.8,412,61,351,ru
277,Reyzy Ligh,DIAMOND II,0,14.6,403,59,344,ru
278,Kissler99,DIAMOND II,0,17.7,283,50,233,ru
279,Лирен,DIAMOND II,0,18.1,270,49,221,ru
280,4evernightmare,DIAMOND II,0,24.7,190,47,143,ru
281,Бионикл,DIAMOND II,0,12.6,374,47,327,ru
282,notnakeD,DIAMOND II,0,14.3,322,46,276,ru
283,Darkwake,DIAMOND II,0,17.7,254,45,209,ru
284,кýсь,DIAMOND II,0,11.0,382,42,340,ru
285,GODLuck,DIAMOND II,0,18.6,221,41,180,ru
286,Dong XIao yu,DIAMOND II,0,20.1,189,38,151,ru
287,Weev,DIAMOND II,0,20.0,180,36,144,ru
288,zonapot,DIAMOND II,0,9.2,369,34,335,ru
289,Gelindjer,DIAMOND II,0,17.1,193,33,160,ru
290,GMLovelyBoy,DIAMOND II,0,27.5,109,30,79,ru
291,Shanoa,DIAMOND II,0,11.4,228,26,202,ru
292,DMH1996,DIAMOND II,0,15.3,163,25,138,ru
293,minhplekhanovne,DIAMOND II,0,16.7,120,20,100,ru
294,Popcorn,DIAMOND II,0,17.5,97,17,80,ru
295,Alvarado,DIAMOND III,98,18.1,276,50,226,ru
296,VN Troll,DIAMOND III,93,8.9,681,61,620,ru
297,lolstars,DIAMOND III,90,7.0,287,20,267,ru
298,Afei,DIAMOND III,86,20.6,388,80,308,ru
299,Darak,DIAMOND III,85,17.8,180,32,148,ru
300,Vla Until You,DIAMOND III,84,20.4,181,37,144,ru
301,FlorDaX,DIAMOND III,83,16.1,492,79,413,ru
302,ChinhChinh,DIAMOND III,81,18.0,205,37,168,ru
303,titanin,DIAMOND III,79,11.9,824,98,726,ru
304,leidianfawang,DIAMOND III,79,18.8,133,25,108,ru
305,Tima444,DIAMOND III,78,21.8,174,38,136,ru
306,ЗабулдыгаНовичёк,DIAMOND III,75,10.5,1280,134,1146,ru
307,RikQu,DIAMOND III,75,15.1,643,97,546,ru
308,BlackBURN,DIAMOND III,75,14.1,510,72,438,ru
309,ID RANGO,DIAMOND III,75,15.9,397,63,334,ru
310,justmax95,DIAMOND III,75,23.0,252,58,194,ru
311,ShroudOfMystery,DIAMOND III,75,18.3,289,53,236,ru
312,GunnerMSK,DIAMOND III,75,19.7,254,50,204,ru
313,Мистер Кусь,DIAMOND III,75,18.2,274,50,224,ru
314,прекрасное свет,DIAMOND III,75,18.2,269,49,220,ru
315,JustSx,DIAMOND III,75,22.1,208,46,162,ru
316,Loyoish,DIAMOND III,75,23.3,189,44,145,ru
317,MJ Su Da Qiang,DIAMOND III,75,17.2,238,41,197,ru
318,rozeva,DIAMOND III,75,20.5,185,38,147,ru
319,Dragon Chess,DIAMOND III,75,18.9,196,37,159,ru
320,Админ Кaзахстана,DIAMOND III,75,11.0,336,37,299,ru
321,wushengsimeng,DIAMOND III,75,26.8,127,34,93,ru
322,ZelibobaUnited,DIAMOND III,75,27.7,119,33,86,ru
323,bloodlook,DIAMOND III,75,13.2,234,31,203,ru
324,10843701,DIAMOND III,75,34.9,86,30,56,ru
325,Crazyyeyeye,DIAMOND III,75,20.9,134,28,106,ru
326,Toveldo,DIAMOND III,75,20.9,134,28,106,ru
327,Holy Nightroad,DIAMOND III,75,9.6,251,24,227,ru
328,qqqe,DIAMOND III,75,13.8,160,22,138,ru
329,twitch tv guffee,DIAMOND III,75,41.2,51,21,30,ru
330,PoisonPotion,DIAMOND III,75,11.1,135,15,120,ru
331,UmroN,DIAMOND III,73,18.9,243,46,197,ru
332,diegoMorales,DIAMOND III,72,14.3,203,29,174,ru
333,РОЗБИЙНЫК,DIAMOND III,71,14.0,515,72,443,ru
334,XPEHOPE33KA,DIAMOND III,71,21.9,164,36,128,ru
335,Havir,DIAMOND III,71,14.8,244,36,208,ru
336,nlinhsv21,DIAMOND III,70,20.2,163,33,130,ru
337,Shankly,DIAMOND III,68,16.9,278,47,231,ru
338,mAv,DIAMOND III,68,30.9,149,46,103,ru
339,одичалый мастер,DIAMOND III,68,11.7,299,35,264,ru
340,подражание,DIAMOND III,66,14.6,425,62,363,ru
341,squeDzilla,DIAMOND III,66,16.2,333,54,279,ru
342,IsaakFrost,DIAMOND III,66,11.2,437,49,388,ru
343,Прохиндей,DIAMOND III,66,18.2,198,36,162,ru
344,fckingay,DIAMOND III,66,21.8,101,22,79,ru
345,Вялый Перчик,DIAMOND III,64,13.2,433,57,376,ru
346,VNM Curly,DIAMOND III,64,17.5,251,44,207,ru
347,strikeGL,DIAMOND III,64,20.0,175,35,140,ru
348,Georgekubi,DIAMOND III,64,27.8,90,25,65,ru
349,gupobiluo,DIAMOND III,63,17.6,437,77,360,ru
350,REFLY,DIAMOND III,63,19.0,357,68,289,ru
351,SARUMAN,DIAMOND III,63,10.3,515,53,462,ru
352,TDK TheDikiY,DIAMOND III,63,28.8,118,34,84,ru
353,kRAKEN,DIAMOND III,63,9.5,304,29,275,ru
354,Lovelykira,DIAMOND III,61,16.5,278,46,232,ru
355,Beeeeeeee,DIAMOND III,60,19.3,456,88,368,ru
356,менталэхо,DIAMOND III,59,24.2,165,40,125,ru
357,Wind of Change,DIAMOND III,55,16.2,117,19,98,ru
358,EnergyDashClarko,DIAMOND III,54,14.2,268,38,230,ru
359,Monitor97,DIAMOND III,53,15.1,185,28,157,ru
360,Akerasin,DIAMOND III,53,23.6,89,21,68,ru
361,Kosma,DIAMOND III,51,22.0,268,59,209,ru
362,Хаоса,DIAMOND III,51,15.5,200,31,169,ru
363,Ksan Leon,DIAMOND III,49,19.4,268,52,216,ru
364,Глубже Некуда,DIAMOND III,49,6.9,522,36,486,ru
365,Bùm Bùm,DIAMOND III,48,20.5,551,113,438,ru
366,MIT811,DIAMOND III,48,16.0,592,95,497,ru
367,NZИ,DIAMOND III,47,15.1,238,36,202,ru
368,SM2LR,DIAMOND III,47,18.2,192,35,157,ru
369,Collide,DIAMOND III,47,18.4,179,33,146,ru
370,NinjaTips,DIAMOND III,47,21.8,101,22,79,ru
371,Amethyst,DIAMOND III,46,23.4,124,29,95,ru
372,The Shark Dog,DIAMOND III,45,16.1,378,61,317,ru
373,burunduk13,DIAMOND III,45,12.6,247,31,216,ru
374,Ungraved,DIAMOND III,44,16.4,342,56,286,ru
375,kOpets,DIAMOND III,43,16.4,646,106,540,ru
376,10 12 1997,DIAMOND III,43,16.1,485,78,407,ru
377,Justnеss,DIAMOND III,43,16.5,242,40,202,ru
378,LeBron James 23,DIAMOND III,41,15.5,316,49,267,ru
379,BaJlyxa,DIAMOND III,41,21.4,140,30,110,ru
380,ТФТ не для меня,DIAMOND III,40,14.2,325,46,279,ru
381,rip lil feel,DIAMOND III,40,21.9,105,23,82,ru
382,великая река,DIAMOND III,39,16.7,174,29,145,ru
383,OsKvErNiTeLь,DIAMOND III,37,14.6,417,61,356,ru
384,iNLоve,DIAMOND III,37,12.2,353,43,310,ru
385,0SemeChka0,DIAMOND III,37,22.5,173,39,134,ru
386,DOROFEEVA NASTYA,DIAMOND III,37,13.4,171,23,148,ru
387,AnimeDeadAngel,DIAMOND III,35,15.1,212,32,180,ru
388,Aglibol,DIAMOND III,34,13.0,568,74,494,ru
389,Hybas,DIAMOND III,34,16.6,326,54,272,ru
390,nook3r,DIAMOND III,34,16.1,254,41,213,ru
391,Onemelo,DIAMOND III,33,15.3,281,43,238,ru
392,Darkrayed,DIAMOND III,33,9.2,240,22,218,ru
393,NeBeriLopatu,DIAMOND III,32,12.6,712,90,622,ru
394,barkit,DIAMOND III,32,23.9,373,89,284,ru
395,Brentaal,DIAMOND III,32,22.7,198,45,153,ru
396,Francis FU96785,DIAMOND III,32,26.8,112,30,82,ru
397,haizhou,DIAMOND III,32,19.0,147,28,119,ru
398,Trollpik666,DIAMOND III,32,4.5,379,17,362,ru
399,LikeU,DIAMOND III,31,13.6,398,54,344,ru
400,miner666,DIAMOND III,31,12.9,311,40,271,ru
401,Panchess,DIAMOND III,31,25.0,120,30,90,ru
402,ХхX,DIAMOND III,30,11.0,164,18,146,ru
403,Antananarivu,DIAMOND III,29,16.3,430,70,360,ru
404,DIGAZAR,DIAMOND III,29,13.8,174,24,150,ru
405,Dengziqiwang,DIAMOND III,25,26.3,171,45,126,ru
406,ZuliuSs,DIAMOND III,25,27.5,142,39,103,ru
407,Aha1burn,DIAMOND III,25,21.9,137,30,107,ru
408,Мид это война,DIAMOND III,25,12.7,237,30,207,ru
409,Arclight SnoopCi,DIAMOND III,25,14.2,204,29,175,ru
410,chenghaowu,DIAMOND III,25,34.2,79,27,52,ru
411,Третийглаз,DIAMOND III,25,18.9,143,27,116,ru
412,ManyFaced God,DIAMOND III,24,20.3,360,73,287,ru
413,StarburstStream,DIAMOND III,24,12.2,385,47,338,ru
414,SS best teacherr,DIAMOND III,24,8.8,170,15,155,ru
415,Ajbarra,DIAMOND III,23,19.1,298,57,241,ru
416,Xopycwar,DIAMOND III,23,16.8,167,28,139,ru
417,Неоли,DIAMOND III,22,13.3,585,78,507,ru
418,Alyonkaa,DIAMOND III,22,12.3,423,52,371,ru
419,Эль Дамирио,DIAMOND III,22,16.6,271,45,226,ru
420,GreshnikDevil,DIAMOND III,22,11.7,206,24,182,ru
421,Teax,DIAMOND III,20,17.6,170,30,140,ru
422,GinGL,DIAMOND III,18,17.5,200,35,165,ru
423,Igrid1,DIAMOND III,18,11.7,120,14,106,ru
424,IDreamDiamond,DIAMOND III,18,7.6,158,12,146,ru
425,Afоnjja,DIAMOND III,17,13.0,285,37,248,ru
426,GanjaFourWay,DIAMOND III,17,9.8,194,19,175,ru
427,Stavron,DIAMOND III,16,21.0,357,75,282,ru
428,Orbit17,DIAMOND III,16,8.0,415,33,382,ru
429,GG Habib,DIAMOND III,15,15.3,254,39,215,ru
430,Xameleon Arzamas,DIAMOND III,15,10.5,351,37,314,ru
431,Zelosin,DIAMOND III,15,15.9,138,22,116,ru
432,Позор Джунглей,DIAMOND III,15,12.3,146,18,128,ru
433,ªºЯ Ç 4 ДуракÅºª,DIAMOND III,13,16.9,332,56,276,ru
434,Kostanayskiy,DIAMOND III,13,19.4,227,44,183,ru
435,ikorostilev,DIAMOND III,13,16.7,150,25,125,ru
436,Dev1l Ykt,DIAMOND III,11,13.5,416,56,360,ru
437,Kotleteus,DIAMOND III,11,12.3,381,47,334,ru
438,NOMADEKB,DIAMOND III,11,14.9,148,22,126,ru
439,AzureDn,DIAMOND III,10,17.5,206,36,170,ru
440,Винча,DIAMOND III,10,17.6,188,33,155,ru
441,Xelnagastr,DIAMOND III,10,33.3,57,19,38,ru
442,married isSHIT,DIAMOND III,9,22.2,203,45,158,ru
443,ЛоуСкил,DIAMOND III,8,12.8,406,52,354,ru
444,lywh,DIAMOND III,8,13.2,68,9,59,ru
445,VERENGUE UA,DIAMOND III,7,15.3,242,37,205,ru
446,отправь ню,DIAMOND III,7,22.2,90,20,70,ru
447,lukoshko,DIAMOND III,6,7.7,443,34,409,ru
448,Xitoriki,DIAMOND III,6,12.4,153,19,134,ru
449,КОРОЛЬ БОГ КОСМО,DIAMOND III,5,17.5,618,108,510,ru
450,Benedetta Love,DIAMOND III,5,10.8,185,20,165,ru
451,Binkan Ichiro,DIAMOND III,3,15.6,333,52,281,ru
452,Raome,DIAMOND III,3,14.6,253,37,216,ru
453,Fastshott,DIAMOND III,3,12.4,226,28,198,ru
454,conruanhanhnhen,DIAMOND III,2,18.8,804,151,653,ru
455,Dragonall,DIAMOND III,2,22.7,225,51,174,ru
456,Ной,DIAMOND III,2,10.0,249,25,224,ru
457,zergoood,DIAMOND III,2,16.1,137,22,115,ru
458,Fack you girl,DIAMOND III,1,16.1,354,57,297,ru
459,Сальери,DIAMOND III,1,9.9,506,50,456,ru
460,zhangyi111,DIAMOND III,1,21.6,111,24,87,ru
461,LlosDi,DIAMOND III,0,20.8,538,112,426,ru
462,EviL Holy,DIAMOND III,0,10.7,683,73,610,ru
463,Azu,DIAMOND III,0,11.6,611,71,540,ru
464,Гриндамир,DIAMOND III,0,21.5,288,62,226,ru
465,Alive4ever,DIAMOND III,0,18.1,343,62,281,ru
466,Черника,DIAMOND III,0,19.4,294,57,237,ru
467,motakyji,DIAMOND III,0,18.1,299,54,245,ru
468,3610bashmak,DIAMOND III,0,15.7,299,47,252,ru
469,DonJuanHS,DIAMOND III,0,15.9,289,46,243,ru
470,FG KING rank1,DIAMOND III,0,19.6,230,45,185,ru
471,GothMercer,DIAMOND III,0,16.0,281,45,236,ru
472,ToxIIcTEN,DIAMOND III,0,17.1,251,43,208,ru
473,Luuthienan,DIAMOND III,0,26.9,141,38,103,ru
474,XХXTENTAСION,DIAMOND III,0,11.8,322,38,284,ru
475,westerin,DIAMOND III,0,9.5,400,38,362,ru
476,China BaoBao,DIAMOND III,0,26.3,133,35,98,ru
477,HolyTRVP,DIAMOND III,0,17.4,195,34,161,ru
478,DeathWeeng,DIAMOND III,0,9.7,352,34,318,ru
479,spaNe,DIAMOND III,0,31.4,102,32,70,ru
480,EA7 AshpAreniJ,DIAMOND III,0,19.8,162,32,130,ru
481,Die Young,DIAMOND III,0,26.5,113,30,83,ru
482,Чики Бoмбини,DIAMOND III,0,12.4,241,30,211,ru
483,55dd,DIAMOND III,0,13.3,218,29,189,ru
484,DutchAngle,DIAMOND III,0,16.9,166,28,138,ru
485,little ma,DIAMOND III,0,32.5,83,27,56,ru
486,Xлeбушeк,DIAMOND III,0,16.3,166,27,139,ru
487,Tiasik,DIAMOND III,0,17.5,143,25,118,ru
488,Smokeee,DIAMOND III,0,12.5,192,24,168,ru
489,Ласточка,DIAMOND III,0,13.8,166,23,143,ru
490,FaraonApple,DIAMOND III,0,9.2,240,22,218,ru
491,Angostura,DIAMOND III,0,21.6,97,21,76,ru
492,Kaitouz,DIAMOND III,0,18.4,114,21,93,ru
493,TiltMasta,DIAMOND III,0,13.8,152,21,131,ru
494,MaMa Я Не РаК,DIAMOND III,0,11.9,176,21,155,ru
495,АНГЕЛСМЕРТИ2009,DIAMOND III,0,16.9,118,20,98,ru
496,White BloodAngel,DIAMOND III,0,16.0,119,19,100,ru
497,Stan Truman,DIAMOND III,0,11.2,170,19,151,ru
498,Jedis2C2S,DIAMOND III,0,15.3,111,17,94,ru
499,MANNЯK,DIAMOND IV,94,20.4,367,75,292,ru
500,Юраa,DIAMOND IV,94,60.5,43,26,17,ru
