rank,name,tier,lp,win rate,played,wins,losses,region
1,Mismatched Socks,CHALLENGER I,1580,21.6,496,107,389,na
2,Ms MatchedSocks,CHALLENGER I,1457,21.6,463,100,363,na
3,Salvyyy,CHALLENGER I,1435,26.5,283,75,208,na
4,gv8,CHALLENGER I,1385,21.1,554,117,437,na
5,FluffyHS,CHALLENGER I,1354,18.3,453,83,370,na
6,Kurumx,CHALLENGER I,1270,20.4,608,124,484,na
7,GrandVice8,CHALLENGER I,1257,19.5,754,147,607,na
8,bertasaurus,CHALLENGER I,1241,17.7,943,167,776,na
9,ajmonsta,CHALLENGER I,1105,16.5,533,88,445,na
10,Naturesbf,CHALLENGER I,1086,15.4,946,146,800,na
11,JIGEJIUWO,CHALLENGER I,1076,16.8,524,88,436,na
12,Krmx,CHALLENGER I,1066,20.4,636,130,506,na
13,Hiraino,CHALLENGER I,1040,15.9,912,145,767,na
14,Old Lodo,CHALLENGER I,1038,16.8,410,69,341,na
15,Cottontail,CHALLENGER I,1026,15.4,689,106,583,na
16,Silliest,CHALLENGER I,1021,25.6,360,92,268,na
17,lLykus,CHALLENGER I,962,16.3,881,144,737,na
18,Gunmay,CHALLENGER I,961,11.0,509,56,453,na
19,111094 R,CHALLENGER I,942,13.7,1697,233,1464,na
20,HiROKKKKJP,CHALLENGER I,916,16.4,602,99,503,na
21,M35S,CHALLENGER I,915,15.4,941,145,796,na
22,The Cxk,CHALLENGER I,868,16.3,442,72,370,na
23,EAOST,CHALLENGER I,858,14.9,564,84,480,na
24,Inphinit3,CHALLENGER I,853,16.2,494,80,414,na
25,ttv KitingisHard,CHALLENGER I,843,17.2,956,165,791,na
26,Grillsyy,CHALLENGER I,838,15.7,737,116,621,na
27,Agon,CHALLENGER I,829,18.0,812,146,666,na
28,Kiyoon,CHALLENGER I,827,18.6,1005,187,818,na
29,GoyoTV,CHALLENGER I,820,15.6,855,133,722,na
30,v Köi v,CHALLENGER I,817,21.9,366,80,286,na
31,dowfu ph,CHALLENGER I,817,20.6,267,55,212,na
32,ItzYaBoyBeasty,CHALLENGER I,813,17.1,1014,173,841,na
33,Ripple Overdrive,CHALLENGER I,806,15.3,307,47,260,na
34,enchabi,CHALLENGER I,799,16.1,299,48,251,na
35,BIuePrincess,CHALLENGER I,799,18.6,247,46,201,na
36,TempestLife,CHALLENGER I,793,20.1,283,57,226,na
37,Kled Bundy,CHALLENGER I,782,13.7,1367,187,1180,na
38,Flandre Bot,CHALLENGER I,764,16.9,243,41,202,na
39,Live for the Day,CHALLENGER I,760,19.4,846,164,682,na
40,C9 k3soju,CHALLENGER I,754,20.6,1035,213,822,na
41,Turn1Delver,CHALLENGER I,752,14.6,1634,239,1395,na
42,WhySofaKing,CHALLENGER I,747,14.7,511,75,436,na
43,Ol Lodo,CHALLENGER I,744,15.8,469,74,395,na
44,TwitchTV Odyceuz,CHALLENGER I,739,17.9,485,87,398,na
45,themackerel,CHALLENGER I,732,13.3,751,100,651,na
46,Nice Mister Kien,CHALLENGER I,722,16.7,491,82,409,na
47,NO MORE WINTRADE,CHALLENGER I,722,16.4,299,49,250,na
48,inay,CHALLENGER I,720,15.9,984,157,827,na
49,Ex Railgun,CHALLENGER I,720,16.8,788,132,656,na
50,Fxxx Yaaa,CHALLENGER I,710,18.1,414,75,339,na
51,Wrackle,CHALLENGER I,710,14.0,393,55,338,na
52,theMaskedPatel,CHALLENGER I,704,16.6,326,54,272,na
53,wx qq258790278,CHALLENGER I,692,19.3,430,83,347,na
54,pastafartianist,CHALLENGER I,687,22.4,236,53,183,na
55,NA SMURF KEKW,CHALLENGER I,684,17.0,224,38,186,na
56,qieqie,CHALLENGER I,679,19.0,542,103,439,na
57,TheMagykal,CHALLENGER I,678,16.5,932,154,778,na
58,McDull,CHALLENGER I,676,14.6,830,121,709,na
59,Zadust TFT,CHALLENGER I,670,15.7,586,92,494,na
60,wo chi bu pang,CHALLENGER I,670,17.9,296,53,243,na
61,Broccóli,CHALLENGER I,669,14.7,518,76,442,na
62,Xerluk,CHALLENGER I,664,13.8,676,93,583,na
63,PockyGom,CHALLENGER I,662,15.8,736,116,620,na
64,Stompalittle,CHALLENGER I,657,14.6,1277,187,1090,na
65,Eason with U,CHALLENGER I,655,20.6,301,62,239,na
66,WANG SHUO ZHE,CHALLENGER I,654,18.3,289,53,236,na
67,MaskedPatel,CHALLENGER I,653,15.3,242,37,205,na
68,slippinbug,CHALLENGER I,647,17.4,305,53,252,na
69,paulhnlee,CHALLENGER I,645,22.7,216,49,167,na
70,ChrisKillsX,CHALLENGER I,644,19.5,164,32,132,na
71,Xeno,CHALLENGER I,643,19.9,301,60,241,na
72,influrrier,CHALLENGER I,642,16.1,953,153,800,na
73,Sphinx,CHALLENGER I,642,9.8,755,74,681,na
74,brofael,CHALLENGER I,640,12.9,1208,156,1052,na
75,Akurai,CHALLENGER I,640,18.1,349,63,286,na
76,Sun Astronaut,CHALLENGER I,640,13.9,331,46,285,na
77,BeIiever,CHALLENGER I,635,21.0,629,132,497,na
78,JayGeBee,CHALLENGER I,634,14.5,656,95,561,na
79,PureAlohaa,CHALLENGER I,634,16.7,383,64,319,na
80,FroSteeMate,CHALLENGER I,633,15.0,1192,179,1013,na
81,ogapmaler cuck,CHALLENGER I,633,24.2,149,36,113,na
82,Jangsterang,CHALLENGER I,632,15.4,397,61,336,na
83,TFTbigJB,CHALLENGER I,624,17.2,460,79,381,na
84,morellos,CHALLENGER I,618,17.9,268,48,220,na
85,Simple Plan,CHALLENGER I,617,14.3,630,90,540,na
86,TFT Parval,CHALLENGER I,612,14.0,536,75,461,na
87,Cris,CHALLENGER I,609,14.2,1502,213,1289,na
88,FinaldF,CHALLENGER I,609,13.0,1393,181,1212,na
89,Mango TheHun,CHALLENGER I,608,17.2,250,43,207,na
90,ME EIGHTH,CHALLENGER I,605,16.5,242,40,202,na
91,H2211,CHALLENGER I,604,19.8,1202,238,964,na
92,firest0ne,CHALLENGER I,604,7.5,1637,123,1514,na
93,Doublezzzz,CHALLENGER I,604,13.5,695,94,601,na
94,tran98huy,CHALLENGER I,604,18.6,456,85,371,na
95,Me Predator,CHALLENGER I,604,18.1,321,58,263,na
96,Ashe The Frost,CHALLENGER I,602,11.3,689,78,611,na
97,DoraAmon,CHALLENGER I,600,27.4,124,34,90,na
98,Elvisbeback,CHALLENGER I,599,11.1,325,36,289,na
99,DeadlyCO2,CHALLENGER I,598,11.9,537,64,473,na
100,Coleman TFT,CHALLENGER I,596,19.1,220,42,178,na
101,TTV Kenya1,CHALLENGER I,595,15.3,705,108,597,na
102,birdwings,CHALLENGER I,594,13.3,352,47,305,na
103,P1KACHuuuuuuu,CHALLENGER I,593,31.1,103,32,71,na
104,Aesah,CHALLENGER I,591,19.1,632,121,511,na
105,Humilis,CHALLENGER I,585,13.1,291,38,253,na
106,Souless,CHALLENGER I,584,23.1,190,44,146,na
107,Twitch RayditzFN,CHALLENGER I,583,15.8,1236,195,1041,na
108,Moggy Mako,CHALLENGER I,583,9.0,666,60,606,na
109,Eunwilf,CHALLENGER I,579,18.0,316,57,259,na
110,Agaze,CHALLENGER I,576,17.2,232,40,192,na
111,TTV OmniPieTV,CHALLENGER I,571,16.2,974,158,816,na
112,Sojin,CHALLENGER I,570,15.6,853,133,720,na
113,OrAnGe JuIc3,CHALLENGER I,568,13.2,408,54,354,na
114,Nhân tâm TFT,CHALLENGER I,565,18.4,282,52,230,na
115,lnaban,CHALLENGER I,561,15.5,676,105,571,na
116,thomas tft,CHALLENGER I,561,13.2,574,76,498,na
117,Jaekun2maX,CHALLENGER I,561,18.1,265,48,217,na
118,Sin 94 ToFu,CHALLENGER I,559,15.1,371,56,315,na
119,A shadowy figure,CHALLENGER I,558,15.8,593,94,499,na
120,Oonnii,CHALLENGER I,558,21.0,353,74,279,na
121,Catybear,CHALLENGER I,557,15.3,491,75,416,na
122,TTV iantyler,CHALLENGER I,555,17.2,349,60,289,na
123,Muffinn TFT,CHALLENGER I,555,18.7,225,42,183,na
124,Mean Mister Kien,CHALLENGER I,554,14.4,735,106,629,na
125,Kalsuo,CHALLENGER I,553,16.6,889,148,741,na
126,Kira,CHALLENGER I,553,16.6,580,96,484,na
127,RIOT thatsPRIMAL,CHALLENGER I,552,11.2,953,107,846,na
128,ttvGooGieGaminG,CHALLENGER I,552,13.9,404,56,348,na
129,Lab Member 001,CHALLENGER I,543,15.8,354,56,298,na
130,Reigncat,CHALLENGER I,543,15.2,303,46,257,na
131,Terde,CHALLENGER I,542,17.6,624,110,514,na
132,17º C,CHALLENGER I,542,18.4,452,83,369,na
133,Blaim,CHALLENGER I,539,16.2,711,115,596,na
134,enchaB,CHALLENGER I,538,18.2,280,51,229,na
135,RippleOverdrive2,CHALLENGER I,538,21.6,176,38,138,na
136,robinsongz,CHALLENGER I,536,15.3,412,63,349,na
137,Scoped32,CHALLENGER I,534,16.1,410,66,344,na
138,birdy511,CHALLENGER I,534,15.4,369,57,312,na
139,HappyMuffinn,CHALLENGER I,532,18.8,260,49,211,na
140,VX15152242663,CHALLENGER I,530,19.1,593,113,480,na
141,NicholasLy6,CHALLENGER I,529,19.8,293,58,235,na
142,DxnTFT,CHALLENGER I,528,15.9,813,129,684,na
143,BlackBigBig,CHALLENGER I,525,18.0,510,92,418,na
144,Visual,CHALLENGER I,525,16.8,493,83,410,na
145,Kłaytøn,CHALLENGER I,525,15.1,509,77,432,na
146,ttv influrrier,CHALLENGER I,522,14.2,614,87,527,na
147,Dairon TFT,CHALLENGER I,522,16.8,298,50,248,na
148,BentoBot,CHALLENGER I,520,15.5,690,107,583,na
149,lilsteppy,CHALLENGER I,518,20.6,388,80,308,na
150,Eunsol    K,CHALLENGER I,518,14.4,381,55,326,na
151,TheHentaiGod,CHALLENGER I,517,15.8,741,117,624,na
152,douyuTV980762,CHALLENGER I,516,15.2,512,78,434,na
153,Keane fans,CHALLENGER I,515,17.1,1266,216,1050,na
154,Tinkady,CHALLENGER I,515,18.2,592,108,484,na
155,kavan,CHALLENGER I,514,16.1,372,60,312,na
156,buscusu,CHALLENGER I,512,18.6,806,150,656,na
157,iCopyKeane,CHALLENGER I,511,12.2,353,43,310,na
158,RamKev,CHALLENGER I,508,14.8,832,123,709,na
159,tomrocks,CHALLENGER I,508,16.5,363,60,303,na
160,chitosechitose,CHALLENGER I,507,14.2,650,92,558,na
161,Midrash,CHALLENGER I,507,16.0,394,63,331,na
162,JinxedJKK,CHALLENGER I,505,16.1,341,55,286,na
163,piglet2448,CHALLENGER I,505,22.6,181,41,140,na
164,KomradeKush,CHALLENGER I,504,12.0,816,98,718,na
165,Bulls0717,CHALLENGER I,504,11.9,503,60,443,na
166,xplitcit,CHALLENGER I,503,14.7,941,138,803,na
167,Jaekun3maX,CHALLENGER I,502,28.6,112,32,80,na
168,felice,CHALLENGER I,500,15.1,185,28,157,na
169,qie77777mimi,CHALLENGER I,498,17.7,288,51,237,na
170,You MDZZ,CHALLENGER I,498,16.4,310,51,259,na
171,Wolves Save Me,CHALLENGER I,497,13.0,1030,134,896,na
172,21 Zsy,CHALLENGER I,497,21.4,495,106,389,na
173,George Brown TFT,CHALLENGER I,496,14.4,492,71,421,na
174,piggy2448,CHALLENGER I,493,18.7,374,70,304,na
175,Lemon IceCream,CHALLENGER I,492,12.7,754,96,658,na
176,Fountaiin,CHALLENGER I,491,15.3,254,39,215,na
177,Liquid Saint,CHALLENGER I,490,19.2,359,69,290,na
178,TacticalLukarina,CHALLENGER I,488,15.0,840,126,714,na
179,enaek,CHALLENGER I,485,20.4,406,83,323,na
180,MikeP,CHALLENGER I,484,17.2,151,26,125,na
181,Yondai,CHALLENGER I,483,16.4,481,79,402,na
182,sugasugasofly,CHALLENGER I,483,18.1,387,70,317,na
183,Gurt Games,CHALLENGER I,483,9.1,517,47,470,na
184,AndyofSmurf,CHALLENGER I,483,19.4,180,35,145,na
185,kpopfan7,CHALLENGER I,482,14.1,163,23,140,na
186,the OCE special,CHALLENGER I,478,11.4,844,96,748,na
187,Jaekun4maX,CHALLENGER I,476,22.2,180,40,140,na
188,chainpullz,CHALLENGER I,475,13.7,315,43,272,na
189,Mister Lau,CHALLENGER I,474,16.2,808,131,677,na
190,TurboARAM,CHALLENGER I,472,14.6,542,79,463,na
191,WafWafWaffle,CHALLENGER I,472,15.6,392,61,331,na
192,FayeBae,CHALLENGER I,469,14.1,440,62,378,na
193,chickensaveme,CHALLENGER I,469,14.8,277,41,236,na
194,yyasuooo,CHALLENGER I,469,22.2,144,32,112,na
195,Decisivewayy,CHALLENGER I,468,13.5,733,99,634,na
196,DreamErica,CHALLENGER I,464,14.5,1011,147,864,na
197,LGD Wet1less,CHALLENGER I,410,14.6,309,45,264,na
198,Incite,CHALLENGER I,395,15.6,762,119,643,na
199,Partnerkiller 02,CHALLENGER I,368,16.1,461,74,387,na
200,eue,CHALLENGER I,356,11.0,871,96,775,na
1,bruninho sl,CHALLENGER I,1784,21.3,592,126,466,br
2,cuckmyblade,CHALLENGER I,1609,24.4,492,120,372,br
3,Zadust,CHALLENGER I,1567,33.2,340,113,227,br
4,inc mplete,CHALLENGER I,1401,17.3,761,132,629,br
5,techzz,CHALLENGER I,1352,23.7,590,140,450,br
6,Odyceuz,CHALLENGER I,1352,23.8,501,119,382,br
7,eusouolucas,CHALLENGER I,1326,18.0,701,126,575,br
8,Slooper,CHALLENGER I,1278,24.7,368,91,277,br
9,FabledDofus,CHALLENGER I,1233,19.6,485,95,390,br
10,Serask,CHALLENGER I,1196,21.8,542,118,424,br
11,Higuree,CHALLENGER I,1119,21.2,548,116,432,br
12,Paralelepipo,CHALLENGER I,1093,26.0,254,66,188,br
13,ftdrain,CHALLENGER I,1086,30.1,279,84,195,br
14,BarksdaIe,CHALLENGER I,1086,29.0,241,70,171,br
15,Gúne,CHALLENGER I,1085,23.3,386,90,296,br
16,Medico do SUS22,CHALLENGER I,1034,18.3,589,108,481,br
17,Archway,CHALLENGER I,1028,17.2,442,76,366,br
18,Dairon,CHALLENGER I,981,21.4,322,69,253,br
19,tartaruguinhas2,CHALLENGER I,977,20.8,558,116,442,br
20,Koala Esbelto,CHALLENGER I,973,20.0,721,144,577,br
21,TG Wed,CHALLENGER I,905,16.9,721,122,599,br
22,m3rdapequena,CHALLENGER I,898,26.1,257,67,190,br
23,Past,CHALLENGER I,836,24.9,473,118,355,br
24,Mierdagrande,CHALLENGER I,816,29.6,213,63,150,br
25,escolinha do inc,CHALLENGER I,806,21.4,420,90,330,br
26,Twitch NickTFT,CHALLENGER I,777,21.4,537,115,422,br
27,OOO,CHALLENGER I,776,18.4,516,95,421,br
28,odyceuZEDeletric,CHALLENGER I,769,44.2,95,42,53,br
29,CD ERICK,CHALLENGER I,759,18.5,260,48,212,br
30,Jael TFT,CHALLENGER I,751,20.5,410,84,326,br
31,Lünna,CHALLENGER I,723,20.1,814,164,650,br
32,ViT4O xD,CHALLENGER I,722,18.4,423,78,345,br
33,Miss Queen,CHALLENGER I,712,12.9,388,50,338,br
34,Haxwei,CHALLENGER I,706,19.1,215,41,174,br
35,mDobZ,CHALLENGER I,700,18.6,253,47,206,br
36,Vowtz,CHALLENGER I,690,16.6,362,60,302,br
37,Neves,CHALLENGER I,684,18.1,371,67,304,br
38,TFT Azura,CHALLENGER I,684,23.5,234,55,179,br
39,RFK Azura,CHALLENGER I,676,26.1,468,122,346,br
40,Royal Kvasterr,CHALLENGER I,652,14.3,440,63,377,br
41,Nescau Insolúvel,CHALLENGER I,647,19.8,339,67,272,br
42,B Lara,CHALLENGER I,644,22.3,323,72,251,br
43,Levi,CHALLENGER I,643,22.9,440,101,339,br
44,O HIPER CARRY,CHALLENGER I,643,15.8,507,80,427,br
45,DEZZlN,CHALLENGER I,638,16.7,491,82,409,br
46,Lula Livrão TFT,CHALLENGER I,633,15.8,430,68,362,br
47,TwitchTV Patr0ci,CHALLENGER I,631,15.6,764,119,645,br
48,Yvissaur,CHALLENGER I,628,22.1,308,68,240,br
49,MATEUS DO SUS DF,CHALLENGER I,617,16.8,481,81,400,br
50,AdrianoK,CHALLENGER I,612,17.9,340,61,279,br
51,T F Toddy,"GRANDMASTER I
G",644,26.3,152,40,112,br
52,the ego illusion,"GRANDMASTER I
G",635,26.7,225,60,165,br
53,CD CFCDuuuuds,"GRANDMASTER I
G",605,14.2,723,103,620,br
54,O HIPER CRIME,"GRANDMASTER I
G",602,14.6,419,61,358,br
55,faker indiano,"GRANDMASTER I
G",601,14.9,470,70,400,br
56,Felipolv000,"GRANDMASTER I
G",592,20.8,202,42,160,br
57,Tsuuzaki,"GRANDMASTER I
G",567,20.3,468,95,373,br
58,Billy Bait,"GRANDMASTER I
G",564,16.3,712,116,596,br
59,Bioosfera,"GRANDMASTER I
G",557,15.5,483,75,408,br
60,Kirbyzin,"GRANDMASTER I
G",552,16.1,645,104,541,br
61,BlasHelldder,"GRANDMASTER I
G",534,19.7,406,80,326,br
62,Allahu TK,"GRANDMASTER I
G",525,12.0,885,106,779,br
63,SÄNT hyun,"GRANDMASTER I
G",510,13.3,803,107,696,br
64,Garras of Rivia,"GRANDMASTER I
G",507,23.0,243,56,187,br
65,Irisdescent,"GRANDMASTER I
G",501,20.2,247,50,197,br
66,kirinde,"GRANDMASTER I
G",498,14.9,656,98,558,br
67,É o tal do Lula,"GRANDMASTER I
G",490,27.2,320,87,233,br
68,Nihonjin,"GRANDMASTER I
G",487,18.0,383,69,314,br
69,TFT Médico,"GRANDMASTER I
G",480,21.1,175,37,138,br
70,Titos,"GRANDMASTER I
G",477,17.6,408,72,336,br
71,Jvão,"GRANDMASTER I
G",470,19.2,526,101,425,br
72,Encatroll é trix,"GRANDMASTER I
G",467,16.5,285,47,238,br
73,HawkEyeCs7,"GRANDMASTER I
G",461,16.9,679,115,564,br
74,Mon Nom,"GRANDMASTER I
G",453,15.6,662,103,559,br
75,ego illusions,"GRANDMASTER I
G",453,20.9,253,53,200,br
76,Bandu,"GRANDMASTER I
G",446,17.9,521,93,428,br
77,Ezo,"GRANDMASTER I
G",442,16.8,517,87,430,br
78,R Angra,"GRANDMASTER I
G",442,17.4,281,49,232,br
79,tft igor18,"GRANDMASTER I
G",379,22.4,183,41,142,br
80,xCyborg,"GRANDMASTER I
G",373,19.5,328,64,264,br
81,Tallis Sauro,"GRANDMASTER I
G",361,18.2,346,63,283,br
82,haveaboavida,"GRANDMASTER I
G",354,25.6,164,42,122,br
83,Shinobu300,"GRANDMASTER I
G",353,19.0,358,68,290,br
84,TWITCHTV Stykr,"GRANDMASTER I
G",352,21.0,338,71,267,br
85,Duest,"GRANDMASTER I
G",352,18.4,212,39,173,br
86,Goiano,"GRANDMASTER I
G",351,15.2,368,56,312,br
87,twitch narkesh1,"GRANDMASTER I
G",350,19.8,328,65,263,br
88,Eu só jogo TFT,"GRANDMASTER I
G",336,17.5,578,101,477,br
89,l Hyper Carry,"GRANDMASTER I
G",333,16.9,1024,173,851,br
90,Melança,"GRANDMASTER I
G",330,16.2,661,107,554,br
91,dG Fuhrmann,"GRANDMASTER I
G",330,25.6,262,67,195,br
92,MonteiroLombrado,"GRANDMASTER I
G",328,14.4,445,64,381,br
93,ttvSidekool,"GRANDMASTER I
G",316,13.7,532,73,459,br
94,Doutor Wily,"GRANDMASTER I
G",316,24.3,296,72,224,br
95,itzzLara,"GRANDMASTER I
G",308,16.7,222,37,185,br
96,Royalzito,"GRANDMASTER I
G",305,17.6,450,79,371,br
97,Batata Rufles,"GRANDMASTER I
G",305,18.1,282,51,231,br
98,SannTFT,"GRANDMASTER I
G",297,18.8,373,70,303,br
99,y Satsue,"GRANDMASTER I
G",294,13.6,140,19,121,br
100,RafaStark,"GRANDMASTER I
G",292,18.1,281,51,230,br
101,MominhoGameplays,"GRANDMASTER I
G",289,17.8,400,71,329,br
102,LosAngelesLakers,"GRANDMASTER I
G",288,20.5,156,32,124,br
103,Smurf divino Jax,"GRANDMASTER I
G",284,20.8,240,50,190,br
104,Siilent,"GRANDMASTER I
G",280,14.4,664,96,568,br
105,maça docinha,"GRANDMASTER I
G",279,16.5,266,44,222,br
106,NeeverGiveUp,"GRANDMASTER I
G",276,14.0,477,67,410,br
107,Hisekken,"GRANDMASTER I
G",276,16.4,389,64,325,br
108,CD Noah Hunter,"GRANDMASTER I
G",271,15.4,351,54,297,br
109,Sènna,"GRANDMASTER I
G",266,10.3,416,43,373,br
110,Ovas de Peixe,"GRANDMASTER I
G",262,14.9,584,87,497,br
111,Flangonator,"GRANDMASTER I
G",254,16.3,522,85,437,br
112,Edinaldo Safadão,"GRANDMASTER I
G",252,14.7,292,43,249,br
113,Vampyrus,"GRANDMASTER I
G",251,17.4,877,153,724,br
114,divino Jax JG,"GRANDMASTER I
G",250,11.0,1038,114,924,br
115,vcs sao pateta,"GRANDMASTER I
G",249,12.7,646,82,564,br
116,jelly roll blues,"GRANDMASTER I
G",247,15.2,475,72,403,br
117,twí,"GRANDMASTER I
G",245,15.3,313,48,265,br
118,huggz,"GRANDMASTER I
G",243,17.9,896,160,736,br
119,BARbahh,"GRANDMASTER I
G",241,15.1,324,49,275,br
120,Warrior Lulis,"GRANDMASTER I
G",241,20.7,222,46,176,br
121,Beastar,"GRANDMASTER I
G",240,17.4,305,53,252,br
122,Walladi,"GRANDMASTER I
G",240,16.0,194,31,163,br
123,Daníela,"GRANDMASTER I
G",238,17.3,225,39,186,br
124,SKT1 RyuZUU,"GRANDMASTER I
G",238,14.0,243,34,209,br
125,HeathClyff,"GRANDMASTER I
G",237,19.0,247,47,200,br
126,MittCrowen,"GRANDMASTER I
G",237,17.8,230,41,189,br
127,SKEPET,"GRANDMASTER I
G",235,12.0,559,67,492,br
128,LOVER 97,"GRANDMASTER I
G",234,16.6,163,27,136,br
129,GarrastaClean,"GRANDMASTER I
G",233,19.8,248,49,199,br
130,Don Batatone,"GRANDMASTER I
G",230,12.2,222,27,195,br
131,Paciente67,"GRANDMASTER I
G",229,24.4,127,31,96,br
132,Zamora Lindão,"GRANDMASTER I
G",228,11.4,422,48,374,br
133,Greafen,"GRANDMASTER I
G",226,17.7,571,101,470,br
134,DonCrazy,"GRANDMASTER I
G",224,12.2,825,101,724,br
135,Numb3r2,"GRANDMASTER I
G",223,17.8,366,65,301,br
136,CD Koiti,"GRANDMASTER I
G",223,17.0,265,45,220,br
137,ZaionShow,"GRANDMASTER I
G",217,14.5,296,43,253,br
138,JhoyLow,"GRANDMASTER I
G",217,21.2,193,41,152,br
139,killua do rj,"GRANDMASTER I
G",216,12.1,688,83,605,br
140,gazzsinhoxD,"GRANDMASTER I
G",216,16.6,253,42,211,br
141,TAKOKUCHEIROSO,"GRANDMASTER I
G",216,17.0,235,40,195,br
142,Djcaveira TFT,"GRANDMASTER I
G",215,17.4,637,111,526,br
143,Arckie,"GRANDMASTER I
G",214,19.6,362,71,291,br
144,ViroseMata,"GRANDMASTER I
G",213,21.1,265,56,209,br
145,xXperrsonXx,"GRANDMASTER I
G",212,19.1,278,53,225,br
146,RyüZU,"GRANDMASTER I
G",209,12.1,480,58,422,br
147,StrongAndFlowers,"GRANDMASTER I
G",209,14.4,292,42,250,br
148,Yuu Better,"GRANDMASTER I
G",206,13.2,1419,187,1232,br
149,anuib,"GRANDMASTER I
G",202,9.1,916,83,833,br
150,San Smurf,"GRANDMASTER I
G",0,17.7,299,53,246,br
151,RoronoaVinny,MASTER I,293,19.0,726,138,588,br
152,RESIDENT DA ESCS,MASTER I,204,13.9,793,110,683,br
153,Ruivão,MASTER I,203,21.0,224,47,177,br
154,maçãcomcanela,MASTER I,201,13.1,472,62,410,br
155,l HaX l,MASTER I,198,11.6,541,63,478,br
156,X Yudi,MASTER I,185,14.5,420,61,359,br
157,Noé Mechanics,MASTER I,185,12.2,368,45,323,br
158,Ahri FIiperama,MASTER I,184,16.0,568,91,477,br
159,Crackudo Pistola,MASTER I,179,15.6,295,46,249,br
160,Rubimhood 2,MASTER I,179,18.6,161,30,131,br
161,Batooré,MASTER I,176,21.9,219,48,171,br
162,JUJU DO TFT,MASTER I,170,8.1,1073,87,986,br
163,NgMartins,MASTER I,167,13.3,557,74,483,br
164,Gerson bombeiro,MASTER I,167,16.0,343,55,288,br
165,FrostxD1,MASTER I,164,12.5,1033,129,904,br
166,Adboy,MASTER I,160,19.2,270,52,218,br
167,Jokerrx,MASTER I,159,15.9,208,33,175,br
168,Deyrot,MASTER I,150,21.9,196,43,153,br
169,Guizi16,MASTER I,147,23.1,199,46,153,br
170,bom coração,MASTER I,146,15.0,300,45,255,br
171,Fã da Gal Gadot,MASTER I,144,14.7,470,69,401,br
172,JahBullOn,MASTER I,139,12.6,358,45,313,br
173,xOgunx,MASTER I,138,21.9,242,53,189,br
174,BieuL,MASTER I,138,18.2,291,53,238,br
175,ivelthin2,MASTER I,138,14.5,221,32,189,br
176,XebeckX3,MASTER I,136,17.2,314,54,260,br
177,Gorila Quevoa,MASTER I,133,15.5,827,128,699,br
178,King Vinon,MASTER I,132,17.0,153,26,127,br
179,Tarky,MASTER I,131,22.0,558,123,435,br
180,Terror16,MASTER I,129,14.0,729,102,627,br
181,xShanks,MASTER I,129,13.0,253,33,220,br
182,War Lambari,MASTER I,127,16.6,367,61,306,br
183,brnztz,MASTER I,125,15.1,364,55,309,br
184,Cheleia,MASTER I,124,13.5,260,35,225,br
185,Mino Th,MASTER I,124,19.5,154,30,124,br
186,Interplanetário,MASTER I,124,13.9,201,28,173,br
187,Park Ro Jin,MASTER I,121,13.7,291,40,251,br
188,Allpale,MASTER I,119,19.6,347,68,279,br
189,CD Bruel,MASTER I,116,13.7,423,58,365,br
190,GlaucondE,MASTER I,116,12.3,171,21,150,br
191,dedinho do lula,MASTER I,115,12.6,285,36,249,br
192,pedinshow,MASTER I,113,14.6,342,50,292,br
193,Kovah,MASTER I,110,13.3,195,26,169,br
194,HIGOR HIGOR TFT,MASTER I,106,18.9,344,65,279,br
195,guuih7,MASTER I,106,17.6,205,36,169,br
196,MarkLinv,MASTER I,104,19.5,220,43,177,br
197,zMysto,MASTER I,104,12.1,190,23,167,br
198,Dani Dani TFT,MASTER I,103,16.6,308,51,257,br
199,TFT Ryok,MASTER I,102,21.3,136,29,107,br
200,xOnlyx,MASTER I,101,17.9,425,76,349,br
1,DaSaEbaVMo6niq,CHALLENGER I,1811,25.6,441,113,328,eune
2,TFT Hadaf,CHALLENGER I,1510,26.4,443,117,326,eune
3,Chinese Superbot,CHALLENGER I,1176,25.0,711,178,533,eune
4,Deepityy,CHALLENGER I,1171,26.6,282,75,207,eune
5,Hi Im Hadaf,CHALLENGER I,1116,21.6,282,61,221,eune
6,Deepityyy,CHALLENGER I,1115,29.4,282,83,199,eune
7,Barbalofono,CHALLENGER I,1009,14.1,545,77,468,eune
8,nuenueyouyuegou,CHALLENGER I,1009,31.0,229,71,158,eune
9,qqqwwweeerrrttt,CHALLENGER I,942,27.5,309,85,224,eune
10,ShayonZ,CHALLENGER I,923,24.1,398,96,302,eune
11,Spatula Rasa,CHALLENGER I,903,12.6,1017,128,889,eune
12,yingyi,CHALLENGER I,871,24.9,189,47,142,eune
13,Kier0n,CHALLENGER I,818,24.7,247,61,186,eune
14,BBit,CHALLENGER I,790,26.5,162,43,119,eune
15,kocham michasia,CHALLENGER I,789,33.0,215,71,144,eune
16,Ambitious Noob,CHALLENGER I,779,21.7,355,77,278,eune
17,Quevash,CHALLENGER I,779,21.4,243,52,191,eune
18,Abo Sreee3,CHALLENGER I,766,25.7,323,83,240,eune
19,Kumihowo,CHALLENGER I,763,26.9,186,50,136,eune
20,End of The Line,CHALLENGER I,752,15.5,1086,168,918,eune
21,Fadder,CHALLENGER I,678,18.1,486,88,398,eune
22,Cebo v9,CHALLENGER I,665,23.1,182,42,140,eune
23,Sting Youclif,CHALLENGER I,660,19.3,218,42,176,eune
24,Maro0N,CHALLENGER I,650,25.8,155,40,115,eune
25,longlive,CHALLENGER I,642,13.9,346,48,298,eune
26,shonun,CHALLENGER I,641,27.4,135,37,98,eune
27,Freak Simba,CHALLENGER I,638,13.1,426,56,370,eune
28,Tokuchi Toua,CHALLENGER I,616,18.5,249,46,203,eune
29,Bardton Senna,CHALLENGER I,612,17.6,330,58,272,eune
30,Sesard,CHALLENGER I,599,16.6,296,49,247,eune
31,Strikerko,CHALLENGER I,591,19.5,620,121,499,eune
32,Endø,CHALLENGER I,591,17.0,300,51,249,eune
33,Daniels sagor,CHALLENGER I,586,19.4,222,43,179,eune
34,WP Szati,CHALLENGER I,584,20.1,319,64,255,eune
35,Brynool,CHALLENGER I,582,22.3,242,54,188,eune
36,DIV Fortanu,CHALLENGER I,572,17.8,342,61,281,eune
37,Tryndabeard TTV,CHALLENGER I,565,21.6,190,41,149,eune
38,pjsaig,CHALLENGER I,565,31.2,125,39,86,eune
39,SnailDaddy,CHALLENGER I,556,15.5,592,92,500,eune
40,BillKong,CHALLENGER I,554,20.4,285,58,227,eune
41,Im Sneaky,CHALLENGER I,548,16.8,596,100,496,eune
42,Άνεργος,CHALLENGER I,535,14.5,366,53,313,eune
43,rngshinyruo,CHALLENGER I,535,25.1,183,46,137,eune
44,SaintBlacky,CHALLENGER I,534,13.2,627,83,544,eune
45,acoj,CHALLENGER I,526,16.3,252,41,211,eune
46,Swimmable Toast,CHALLENGER I,526,27.2,136,37,99,eune
47,No Ragrets,CHALLENGER I,518,20.1,304,61,243,eune
48,SB CCisMyCounter,CHALLENGER I,509,18.3,301,55,246,eune
49,Tw1stedFate1,CHALLENGER I,492,27.3,165,45,120,eune
50,jakecn,CHALLENGER I,424,18.4,207,38,169,eune
51,tokkila,"GRANDMASTER I
G",600,17.9,346,62,284,eune
52,LuQ876,"GRANDMASTER I
G",590,14.4,752,108,644,eune
53,Redundancia,"GRANDMASTER I
G",584,25.6,308,79,229,eune
54,masterboi,"GRANDMASTER I
G",567,13.1,467,61,406,eune
55,earlyheart,"GRANDMASTER I
G",522,26.4,148,39,109,eune
56,MosPeΙeush,"GRANDMASTER I
G",498,17.1,210,36,174,eune
57,Cuudi,"GRANDMASTER I
G",482,17.3,398,69,329,eune
58,ŹZ ZZ ZZ ZZ ZZ,"GRANDMASTER I
G",463,15.2,989,150,839,eune
59,deqiang,"GRANDMASTER I
G",454,20.4,265,54,211,eune
60,Brixilolzsk,"GRANDMASTER I
G",449,16.9,445,75,370,eune
61,RaVen v1,"GRANDMASTER I
G",446,21.6,217,47,170,eune
62,kEEN v7,"GRANDMASTER I
G",446,19.2,151,29,122,eune
63,malac1,"GRANDMASTER I
G",434,14.5,338,49,289,eune
64,JointBongo,"GRANDMASTER I
G",430,25.7,136,35,101,eune
65,abe the savior,"GRANDMASTER I
G",427,15.8,632,100,532,eune
66,lBigossl,"GRANDMASTER I
G",412,11.8,355,42,313,eune
67,4NDI,"GRANDMASTER I
G",403,20.0,696,139,557,eune
68,Electrolyze,"GRANDMASTER I
G",391,20.3,256,52,204,eune
69,Nevilter,"GRANDMASTER I
G",391,14.0,321,45,276,eune
70,MLxDDD,"GRANDMASTER I
G",374,18.1,381,69,312,eune
71,RNGuziuziuzi,"GRANDMASTER I
G",373,30.1,126,38,88,eune
72,Epitheoritiς,"GRANDMASTER I
G",371,15.6,307,48,259,eune
73,Slanof,"GRANDMASTER I
G",369,15.4,389,60,329,eune
74,hemourenya,"GRANDMASTER I
G",364,20.4,264,54,210,eune
75,aal233,"GRANDMASTER I
G",363,16.2,414,67,347,eune
76,ARNOLD,"GRANDMASTER I
G",358,15.7,766,120,646,eune
77,tftsoftexe,"GRANDMASTER I
G",357,19.2,318,61,257,eune
78,forever52,"GRANDMASTER I
G",356,23.9,167,40,127,eune
79,tousinimab,"GRANDMASTER I
G",352,18.1,299,54,245,eune
80,qiqi277,"GRANDMASTER I
G",350,27.6,123,34,89,eune
81,wangweichuizi,"GRANDMASTER I
G",350,14.9,222,33,189,eune
82,citrusZZ,"GRANDMASTER I
G",331,16.7,305,51,254,eune
83,wenfan,"GRANDMASTER I
G",327,22.0,159,35,124,eune
84,dendek,"GRANDMASTER I
G",325,20.8,317,66,251,eune
85,Id sex me,"GRANDMASTER I
G",325,36.8,117,43,74,eune
86,victor victoris,"GRANDMASTER I
G",323,13.2,509,67,442,eune
87,OFC Cute,"GRANDMASTER I
G",314,14.5,448,65,383,eune
88,xiaozhuhuijie,"GRANDMASTER I
G",313,19.8,187,37,150,eune
89,Cerebel22,"GRANDMASTER I
G",311,14.8,244,36,208,eune
90,MaKharg JG,"GRANDMASTER I
G",307,17.8,427,76,351,eune
91,KREATOPITA,"GRANDMASTER I
G",307,16.6,235,39,196,eune
92,Pana2525,"GRANDMASTER I
G",305,20.9,268,56,212,eune
93,Chieftan Nessus,"GRANDMASTER I
G",304,14.3,202,29,173,eune
94,Riku Na,"GRANDMASTER I
G",299,30.8,117,36,81,eune
95,Laamakuiskaaja,"GRANDMASTER I
G",298,11.7,633,74,559,eune
96,Nickon,"GRANDMASTER I
G",296,16.8,381,64,317,eune
97,Fine11,"GRANDMASTER I
G",295,15.4,519,80,439,eune
98,jiaozhiaini,"GRANDMASTER I
G",290,17.8,247,44,203,eune
99,yuquan,"GRANDMASTER I
G",276,22.6,350,79,271,eune
100,huyabinzi,"GRANDMASTER I
G",276,18.7,225,42,183,eune
101,mozhili,"GRANDMASTER I
G",274,17.6,443,78,365,eune
102,MARStoiAN,"GRANDMASTER I
G",271,11.1,559,62,497,eune
103,Kőrean Jungler,"GRANDMASTER I
G",270,16.4,819,134,685,eune
104,For chr1st sake,"GRANDMASTER I
G",268,11.1,721,80,641,eune
105,FENG13144,"GRANDMASTER I
G",267,25.3,249,63,186,eune
106,Baschtian,"GRANDMASTER I
G",262,26.5,151,40,111,eune
107,Ih8java,"GRANDMASTER I
G",260,18.5,552,102,450,eune
108,K3NNY1337,"GRANDMASTER I
G",260,14.1,348,49,299,eune
109,Challenger Heart,"GRANDMASTER I
G",258,20.1,179,36,143,eune
110,xiaofeng998,"GRANDMASTER I
G",256,24.1,137,33,104,eune
111,SeekN7eak,"GRANDMASTER I
G",255,18.1,1190,215,975,eune
112,youzaifanfu,"GRANDMASTER I
G",255,19.7,436,86,350,eune
113,drma330,"GRANDMASTER I
G",255,16.3,294,48,246,eune
114,DcStarz,"GRANDMASTER I
G",254,19.7,254,50,204,eune
115,yyyyyye,"GRANDMASTER I
G",253,19.7,411,81,330,eune
116,SKT Mexes,"GRANDMASTER I
G",252,15.3,229,35,194,eune
117,VERONICA RUN RUN,"GRANDMASTER I
G",246,25.2,242,61,181,eune
118,Boudist,"GRANDMASTER I
G",245,16.8,285,48,237,eune
119,Ćelestial,"GRANDMASTER I
G",242,15.2,415,63,352,eune
120,Wykonc,"GRANDMASTER I
G",242,17.2,244,42,202,eune
121,Efrebee,"GRANDMASTER I
G",242,22.7,132,30,102,eune
122,Ο Β Ε Υ,"GRANDMASTER I
G",241,17.3,307,53,254,eune
123,Darosch,"GRANDMASTER I
G",241,13.4,276,37,239,eune
124,Cynamon TFT,"GRANDMASTER I
G",240,13.9,653,91,562,eune
125,CHINCZYQ,"GRANDMASTER I
G",240,16.2,136,22,114,eune
126,sfedis,"GRANDMASTER I
G",238,15.0,367,55,312,eune
127,LyAmAm,"GRANDMASTER I
G",238,22.1,154,34,120,eune
128,božský tureto,"GRANDMASTER I
G",235,13.5,245,33,212,eune
129,ETSIDETHABENEIS,"GRANDMASTER I
G",234,16.6,337,56,281,eune
130,duange666,"GRANDMASTER I
G",232,24.3,136,33,103,eune
131,onik1997,"GRANDMASTER I
G",227,40.0,100,40,60,eune
132,Cebanthon,"GRANDMASTER I
G",226,26.0,177,46,131,eune
133,nayemnau,"GRANDMASTER I
G",224,19.9,306,61,245,eune
134,kuaileFN666,"GRANDMASTER I
G",224,29.6,189,56,133,eune
135,kecsketej5,"GRANDMASTER I
G",223,19.3,398,77,321,eune
136,Donger Bonger,"GRANDMASTER I
G",223,31.0,113,35,78,eune
137,Tiro X Eqt,"GRANDMASTER I
G",221,13.8,267,37,230,eune
138,Žiks,"GRANDMASTER I
G",220,19.8,212,42,170,eune
139,gyybtomorrow,"GRANDMASTER I
G",220,18.2,198,36,162,eune
140,qaqqqqq,"GRANDMASTER I
G",216,17.3,214,37,177,eune
141,ZBlang,"GRANDMASTER I
G",207,28.7,101,29,72,eune
142,Th3 Mask,"GRANDMASTER I
G",199,19.1,540,103,437,eune
143,qwbctyz,"GRANDMASTER I
G",195,29.2,137,40,97,eune
144,klausrofl twitch,"GRANDMASTER I
G",180,13.4,358,48,310,eune
145,tinmar,"GRANDMASTER I
G",166,16.5,327,54,273,eune
146,DarkSynapse,"GRANDMASTER I
G",145,11.5,1017,117,900,eune
147,TheLazyBastard,"GRANDMASTER I
G",142,22.2,162,36,126,eune
148,maurhapilhGR,"GRANDMASTER I
G",102,16.3,258,42,216,eune
149,aosjsjz,"GRANDMASTER I
G",99,20.6,194,40,154,eune
150,JaguarKWT,MASTER I,410,14.2,176,25,151,eune
151,YhongL,MASTER I,298,12.3,259,32,227,eune
152,tiaotiao111,MASTER I,257,15.8,222,35,187,eune
153,jijn3rj4j,MASTER I,245,24.1,141,34,107,eune
154,LeBronze Jàmes,MASTER I,232,19.7,493,97,396,eune
155,sdR,MASTER I,228,18.6,441,82,359,eune
156,islam alghoul,MASTER I,226,15.2,269,41,228,eune
157,rekklescranetail,MASTER I,225,27.2,147,40,107,eune
158,Lucifer Junior,MASTER I,219,18.5,400,74,326,eune
159,NBDandan,MASTER I,218,17.1,170,29,141,eune
160,Lil Vayne J7,MASTER I,217,19.0,716,136,580,eune
161,Chinese0008,MASTER I,216,25.4,110,28,82,eune
162,Caramyx,MASTER I,214,14.2,452,64,388,eune
163,lordpepigz,MASTER I,212,15.1,312,47,265,eune
164,harimania,MASTER I,210,24.2,153,37,116,eune
165,TFT Poulaki,MASTER I,208,14.6,707,103,604,eune
166,BarneyStinsonGG,MASTER I,203,16.8,493,83,410,eune
167,ziyoumowang,MASTER I,200,28.9,142,41,101,eune
168,baobaowo,MASTER I,185,13.5,251,34,217,eune
169,D1e With Me,MASTER I,184,14.4,443,64,379,eune
170,KarnageTheCrane,MASTER I,183,13.3,286,38,248,eune
171,FuriatZ,MASTER I,182,19.8,247,49,198,eune
172,Unlucky Team,MASTER I,179,15.9,188,30,158,eune
173,IceButcher,MASTER I,178,14.2,260,37,223,eune
174,Petrusxa030,MASTER I,177,16.9,313,53,260,eune
175,asd110,MASTER I,176,15.8,596,94,502,eune
176,l StreamR l,MASTER I,175,17.4,478,83,395,eune
177,tego typu,MASTER I,174,21.5,149,32,117,eune
178,0rchide,MASTER I,169,13.9,446,62,384,eune
179,fangshen,MASTER I,168,17.7,220,39,181,eune
180,Hari,MASTER I,167,16.9,136,23,113,eune
181,OSG Legend,MASTER I,165,16.2,228,37,191,eune
182,SS Srpska Mafija,MASTER I,163,6.5,891,58,833,eune
183,gvfgrh4,MASTER I,163,17.9,234,42,192,eune
184,lidayea,MASTER I,163,14.8,277,41,236,eune
185,shenchao1,MASTER I,157,21.3,230,49,181,eune
186,Razyo,MASTER I,157,16.5,273,45,228,eune
187,chaojisaiyaren,MASTER I,156,24.1,166,40,126,eune
188,LTUGAMER,MASTER I,154,15.9,226,36,190,eune
189,jg díff,MASTER I,152,20.3,261,53,208,eune
190,shalockkrie,MASTER I,152,19.0,179,34,145,eune
191,huawuyan,MASTER I,150,16.0,169,27,142,eune
192,Mattinyehedarhed,MASTER I,149,24.2,157,38,119,eune
193,ismeNVT,MASTER I,148,11.8,304,36,268,eune
194,plotak,MASTER I,147,20.5,185,38,147,eune
195,1Hadez2,MASTER I,147,16.1,205,33,172,eune
196,sixoutofsix,MASTER I,147,15.7,198,31,167,eune
197,LetoMallory7,MASTER I,144,13.0,632,82,550,eune
198,dlskssss,MASTER I,143,24.4,135,33,102,eune
199,ALEXPOTTERZ,MASTER I,143,15.2,197,30,167,eune
200,songtongyu,MASTER I,142,19.4,144,28,116,eune
1,Deis1k,CHALLENGER I,1710,21.4,639,137,502,euw
2,Salvyyy,CHALLENGER I,1672,23.8,282,67,215,euw
3,Salvyyy TFT,CHALLENGER I,1659,24.7,384,95,289,euw
4,DarkHighroll,CHALLENGER I,1569,22.8,430,98,332,euw
5,l2yKo,CHALLENGER I,1428,21.6,1250,270,980,euw
6,DarkHydra,CHALLENGER I,1378,21.3,582,124,458,euw
7,SwellerTiger,CHALLENGER I,1327,19.1,387,74,313,euw
8,Gìngg,CHALLENGER I,1322,25.1,327,82,245,euw
9,Leon Trotskij,CHALLENGER I,1269,24.0,338,81,257,euw
10,Voltariusx,CHALLENGER I,1259,18.5,432,80,352,euw
11,GingGG,CHALLENGER I,1232,22.1,742,164,578,euw
12,SwellerTigerTFT,CHALLENGER I,1230,13.3,647,86,561,euw
13,ImSøFresh,CHALLENGER I,1191,17.7,879,156,723,euw
14,Lallana,CHALLENGER I,1179,18.7,369,69,300,euw
15,Hotline ming,CHALLENGER I,1165,16.0,782,125,657,euw
16,Kagerou OwO,CHALLENGER I,1148,21.2,430,91,339,euw
17,fan2Kstagne,CHALLENGER I,1137,22.6,195,44,151,euw
18,Tcejer,CHALLENGER I,1134,21.0,353,74,279,euw
19,Voltariux,CHALLENGER I,1131,17.6,516,91,425,euw
20,Luque,CHALLENGER I,1083,17.4,818,142,676,euw
21,Un33d,CHALLENGER I,1070,17.4,674,117,557,euw
22,Sunny Lu,CHALLENGER I,1068,17.7,955,169,786,euw
23,FluffyHS,CHALLENGER I,1032,17.2,407,70,337,euw
24,Qetzer,CHALLENGER I,1025,15.5,670,104,566,euw
25,Liquid Tabzz,CHALLENGER I,1012,22.0,558,123,435,euw
26,SmileyCereal,CHALLENGER I,1010,17.9,1108,198,910,euw
27,Lipo Razak,CHALLENGER I,1010,16.6,547,91,456,euw
28,Wet Jungler,CHALLENGER I,1009,14.9,689,103,586,euw
29,Phbl,CHALLENGER I,1007,14.1,679,96,583,euw
30,Sologesang,CHALLENGER I,988,14.9,583,87,496,euw
31,Sñus,CHALLENGER I,985,18.6,1185,221,964,euw
32,Phabal,CHALLENGER I,955,14.3,657,94,563,euw
33,Pazi4S,CHALLENGER I,949,12.1,487,59,428,euw
34,Sbstn TFT,CHALLENGER I,932,14.5,538,78,460,euw
35,RyKo v2,CHALLENGER I,929,25.4,323,82,241,euw
36,BozzBrain v2,CHALLENGER I,896,14.7,340,50,290,euw
37,AceofSpadesITA,CHALLENGER I,886,19.0,348,66,282,euw
38,Deisik,CHALLENGER I,870,18.9,364,69,295,euw
39,BenVK,CHALLENGER I,869,16.3,619,101,518,euw
40,Lev D Trotskij,CHALLENGER I,866,17.6,521,92,429,euw
41,outplayingmyself,CHALLENGER I,865,17.9,458,82,376,euw
42,Raizuken,CHALLENGER I,863,18.3,372,68,304,euw
43,Magarky,CHALLENGER I,859,16.5,509,84,425,euw
44,ll TFT KEKW ll,CHALLENGER I,855,14.5,440,64,376,euw
45,iHG Tuttek,CHALLENGER I,841,16.3,738,120,618,euw
46,kassellen,CHALLENGER I,839,13.4,958,128,830,euw
47,TSM Guillosko,CHALLENGER I,828,15.6,868,135,733,euw
48,sayvallahbru,CHALLENGER I,819,14.7,389,57,332,euw
49,Iunci,CHALLENGER I,817,17.7,215,38,177,euw
50,slime03,CHALLENGER I,804,17.4,536,93,443,euw
51,IBRAHIMOVIĆ777,CHALLENGER I,788,26.1,211,55,156,euw
52,lsochan,CHALLENGER I,787,16.7,281,47,234,euw
53,Monphis,CHALLENGER I,785,16.4,1208,198,1010,euw
54,Sizm,CHALLENGER I,781,19.5,727,142,585,euw
55,lucky smile boy,CHALLENGER I,771,15.7,1192,187,1005,euw
56,TFT ArKoK,CHALLENGER I,769,15.7,890,140,750,euw
57,Sparakay TFT,CHALLENGER I,766,15.6,262,41,221,euw
58,ahuia,CHALLENGER I,762,20.1,219,44,175,euw
59,Zididi,CHALLENGER I,761,15.8,1495,237,1258,euw
60,PonRoo,CHALLENGER I,761,12.5,1025,128,897,euw
61,Palaloa,CHALLENGER I,758,16.4,244,40,204,euw
62,JdnTagNovoline,CHALLENGER I,755,21.0,195,41,154,euw
63,RICH H0MIE QUAN,CHALLENGER I,753,15.0,286,43,243,euw
64,TFT Buttons,CHALLENGER I,744,16.0,581,93,488,euw
65,Just so xi so,CHALLENGER I,738,18.8,313,59,254,euw
66,BeasTFT2,CHALLENGER I,736,19.6,204,40,164,euw
67,Bèst Heca EUW,CHALLENGER I,733,17.9,1346,241,1105,euw
68,Kezman,CHALLENGER I,731,19.7,340,67,273,euw
69,Doud78,CHALLENGER I,728,17.8,325,58,267,euw
70,Zyriosly,CHALLENGER I,725,16.7,902,151,751,euw
71,TehSilli,CHALLENGER I,721,19.6,404,79,325,euw
72,Tits,CHALLENGER I,719,24.3,230,56,174,euw
73,ajoe1231,CHALLENGER I,718,17.5,810,142,668,euw
74,Khristor,CHALLENGER I,716,14.9,397,59,338,euw
75,Lorus,CHALLENGER I,715,9.1,737,67,670,euw
76,Cachual,CHALLENGER I,715,25.6,219,56,163,euw
77,RazakTFT,CHALLENGER I,713,15.0,1067,160,907,euw
78,Banisher95,CHALLENGER I,711,13.5,488,66,422,euw
79,Palaloa TFT,CHALLENGER I,710,12.9,471,61,410,euw
80,dknsbs,CHALLENGER I,708,15.9,552,88,464,euw
81,Göl D Roger,CHALLENGER I,704,12.7,805,102,703,euw
82,Némaïdès,CHALLENGER I,695,14.2,613,87,526,euw
83,Sayorï best girl,CHALLENGER I,695,17.4,242,42,200,euw
84,rare not nice,CHALLENGER I,689,15.4,579,89,490,euw
85,BALOTELLI777,CHALLENGER I,687,18.6,531,99,432,euw
86,Ev4ngelion,CHALLENGER I,680,16.5,701,116,585,euw
87,Rïft,CHALLENGER I,680,16.0,225,36,189,euw
88,Can I mock you,CHALLENGER I,679,29.6,135,40,95,euw
89,Freezzette,CHALLENGER I,677,12.1,638,77,561,euw
90,o0OLyReO0o,CHALLENGER I,675,20.1,288,58,230,euw
91,Can I trust you,CHALLENGER I,674,20.4,280,57,223,euw
92,MogamboDTB,CHALLENGER I,673,12.4,289,36,253,euw
93,TarteMan TFT,CHALLENGER I,667,14.9,455,68,387,euw
94,Xeno TFTx,CHALLENGER I,666,10.3,778,80,698,euw
95,TFT Enzosexe,CHALLENGER I,662,12.2,879,107,772,euw
96,Un11d,CHALLENGER I,657,17.9,340,61,279,euw
97,AmuuMuu,CHALLENGER I,656,12.0,1055,127,928,euw
98,Drunkiris,CHALLENGER I,651,20.0,300,60,240,euw
99,Oooouuiiiiiiii,CHALLENGER I,650,16.5,532,88,444,euw
100,Drünkiris,CHALLENGER I,646,19.4,427,83,344,euw
101,5454,CHALLENGER I,645,14.9,510,76,434,euw
102,Gôn Freeçss,CHALLENGER I,645,20.9,273,57,216,euw
103,AKA magic,CHALLENGER I,644,12.9,761,98,663,euw
104,BALOTELLI777 TFT,CHALLENGER I,641,15.8,448,71,377,euw
105,Waazabii,CHALLENGER I,641,19.9,191,38,153,euw
106,LeDuck TFT,CHALLENGER I,640,16.9,1138,193,945,euw
107,NinjaPavels,CHALLENGER I,640,17.3,300,52,248,euw
108,Adonis17,CHALLENGER I,638,16.7,774,129,645,euw
109,OnlyBetter,CHALLENGER I,638,10.0,411,41,370,euw
110,iPoPz v2,CHALLENGER I,637,19.0,210,40,170,euw
111,Yanís,CHALLENGER I,635,16.1,409,66,343,euw
112,iamTLT,CHALLENGER I,631,12.4,323,40,283,euw
113,Doud TFT,CHALLENGER I,629,20.7,232,48,184,euw
114,IceLoom,CHALLENGER I,625,17.8,241,43,198,euw
115,Miiouw,CHALLENGER I,621,14.5,518,75,443,euw
116,JedenTagNovoline,CHALLENGER I,617,23.4,192,45,147,euw
117,Suisaiga 2,CHALLENGER I,615,17.3,417,72,345,euw
118,Itario,CHALLENGER I,613,12.8,447,57,390,euw
119,kacpersky191TFT,CHALLENGER I,611,14.2,857,122,735,euw
120,YowiTFT,CHALLENGER I,611,20.6,247,51,196,euw
121,PUNISH1nG,CHALLENGER I,610,17.8,287,51,236,euw
122,Jedi Master AK,CHALLENGER I,606,16.4,939,154,785,euw
123,WINZEEER,CHALLENGER I,606,14.8,725,107,618,euw
124,Kjekken123,CHALLENGER I,606,19.9,508,101,407,euw
125,Zebra TFT,CHALLENGER I,604,17.8,163,29,134,euw
126,always be hape,CHALLENGER I,602,17.5,378,66,312,euw
127,Vicer v2,CHALLENGER I,600,15.0,306,46,260,euw
128,MCMCinITALY,CHALLENGER I,599,18.5,491,91,400,euw
129,Xerxan,CHALLENGER I,598,15.0,673,101,572,euw
130,Skiizield,CHALLENGER I,596,13.4,982,132,850,euw
131,Nutscrackeros,CHALLENGER I,594,15.3,229,35,194,euw
132,HASHIDA,CHALLENGER I,592,14.0,722,101,621,euw
133,Kÿu,CHALLENGER I,591,17.3,405,70,335,euw
134,LeDuck v2,CHALLENGER I,589,15.3,437,67,370,euw
135,ABEL748,CHALLENGER I,587,12.9,418,54,364,euw
136,Nescro,CHALLENGER I,586,15.7,407,64,343,euw
137,Liber8 Hong Kong,CHALLENGER I,585,17.5,486,85,401,euw
138,idlemonk TFT,CHALLENGER I,583,10.8,618,67,551,euw
139,Warmeur le vrai,CHALLENGER I,582,22.9,223,51,172,euw
140,LIPO Absykos,CHALLENGER I,581,14.7,401,59,342,euw
141,Racklure,CHALLENGER I,580,14.4,909,131,778,euw
142,Tatufo,CHALLENGER I,577,14.1,582,82,500,euw
143,Subahibi,CHALLENGER I,577,14.7,434,64,370,euw
144,I R INVINC1BLE,CHALLENGER I,575,15.1,736,111,625,euw
145,Nyan Zebra,CHALLENGER I,575,16.3,252,41,211,euw
146,stayl23,CHALLENGER I,573,13.8,478,66,412,euw
147,dirtyspear,CHALLENGER I,566,15.3,482,74,408,euw
148,Kenopsia,CHALLENGER I,565,10.1,883,89,794,euw
149,KAD Mason,CHALLENGER I,563,16.5,284,47,237,euw
150,hongmorongguang,CHALLENGER I,561,18.1,353,64,289,euw
151,zomgowy,CHALLENGER I,561,17.5,234,41,193,euw
152,NouLTerass,CHALLENGER I,561,16.8,232,39,193,euw
153,TeemoDaSlayer420,CHALLENGER I,560,20.9,177,37,140,euw
154,Summuner Name,CHALLENGER I,556,19.4,289,56,233,euw
155,Sløt,CHALLENGER I,556,17.4,316,55,261,euw
156,VicerTFT,CHALLENGER I,554,15.6,443,69,374,euw
157,5454XD,CHALLENGER I,552,16.9,544,92,452,euw
158,Zaratuska,CHALLENGER I,552,16.1,448,72,376,euw
159,G2 ReventXz,CHALLENGER I,552,20.8,303,63,240,euw
160,Lonnen,CHALLENGER I,550,14.2,536,76,460,euw
161,męntal,CHALLENGER I,549,13.4,543,73,470,euw
162,Esel51,CHALLENGER I,549,11.7,386,45,341,euw
163,TNG Lucy Chan,CHALLENGER I,547,11.2,916,103,813,euw
164,The Gay Minion,CHALLENGER I,547,13.5,636,86,550,euw
165,Gilozinho,CHALLENGER I,546,13.4,907,122,785,euw
166,Kirbes,CHALLENGER I,545,14.9,435,65,370,euw
167,FengXiaoQiLing,CHALLENGER I,544,23.3,262,61,201,euw
168,TFT Emperador,CHALLENGER I,537,13.4,893,120,773,euw
169,Whiteyeas,CHALLENGER I,536,14.7,339,50,289,euw
170,Sirfetchd,CHALLENGER I,535,10.4,297,31,266,euw
171,JollyFaker777,CHALLENGER I,534,16.1,355,57,298,euw
172,ziro1997,CHALLENGER I,531,16.7,347,58,289,euw
173,Shσtgun,CHALLENGER I,530,15.6,778,121,657,euw
174,Bersa TFT,CHALLENGER I,530,15.9,517,82,435,euw
175,A French Rat,CHALLENGER I,530,15.9,472,75,397,euw
176,At The Gates,CHALLENGER I,529,20.7,300,62,238,euw
177,UnbornYordle,CHALLENGER I,528,17.8,493,88,405,euw
178,Gunmay,CHALLENGER I,525,9.7,784,76,708,euw
179,Bränk,CHALLENGER I,523,15.4,467,72,395,euw
180,Pray to RNG god,CHALLENGER I,523,12.8,297,38,259,euw
181,TFTits,CHALLENGER I,522,19.9,181,36,145,euw
182,Tschabading,CHALLENGER I,519,13.5,865,117,748,euw
183,Bersalis,CHALLENGER I,519,15.9,327,52,275,euw
184,R1CH HOM1E QUAN,CHALLENGER I,518,18.1,215,39,176,euw
185,YowiTFT2,CHALLENGER I,516,20.7,222,46,176,euw
186,iPoPz,CHALLENGER I,513,16.4,549,90,459,euw
187,Lornyk,CHALLENGER I,512,14.1,914,129,785,euw
188,yooog,CHALLENGER I,511,14.1,547,77,470,euw
189,TheUnbornYordle,CHALLENGER I,511,13.5,348,47,301,euw
190,WawaTatata,CHALLENGER I,509,13.7,554,76,478,euw
191,Sτοrm,CHALLENGER I,507,14.9,740,110,630,euw
192,birdyrrr,CHALLENGER I,506,18.6,242,45,197,euw
193,zoomgowy,CHALLENGER I,504,19.2,224,43,181,euw
194,Cry M0re Plz,CHALLENGER I,503,17.8,647,115,532,euw
195,San Jomian,CHALLENGER I,502,13.1,733,96,637,euw
196,Funkfreed,CHALLENGER I,501,16.1,336,54,282,euw
197,EnlèveTesMoufles,CHALLENGER I,498,17.3,294,51,243,euw
198,RaveeOnTFT,CHALLENGER I,497,12.6,547,69,478,euw
199,KlimA,CHALLENGER I,496,15.9,470,75,395,euw
200,Lelouuch,CHALLENGER I,496,16.5,315,52,263,euw
1,Hiraino,CHALLENGER I,742,22.0,440,97,343,jp
2,KKQ,CHALLENGER I,653,21.2,335,71,264,jp
3,HiROKKtft,CHALLENGER I,584,19.6,311,61,250,jp
4,思い出の昼下がり,CHALLENGER I,544,26.3,209,55,154,jp
5,chocotto,CHALLENGER I,530,21.6,472,102,370,jp
6,dayona,CHALLENGER I,494,17.6,1113,196,917,jp
7,hakutou,CHALLENGER I,491,23.9,669,160,509,jp
8,Best 佐藤 JP,CHALLENGER I,479,24.2,244,59,185,jp
9,Age 21,CHALLENGER I,450,22.5,200,45,155,jp
10,煩いマン,CHALLENGER I,450,18.0,233,42,191,jp
11,じーく,CHALLENGER I,446,19.0,326,62,264,jp
12,害獣あらいぐま,CHALLENGER I,430,13.4,410,55,355,jp
13,むむっ,CHALLENGER I,429,22.3,314,70,244,jp
14,シャドウバース,CHALLENGER I,407,18.9,628,119,509,jp
15,Shroud Fanboy,CHALLENGER I,387,15.8,1084,171,913,jp
16,ajun,CHALLENGER I,373,17.9,739,132,607,jp
17,ひまわり準決勝,CHALLENGER I,372,24.9,193,48,145,jp
18,trotv,CHALLENGER I,364,15.9,516,82,434,jp
19,Best太郎JP,CHALLENGER I,350,21.8,331,72,259,jp
20,kes,CHALLENGER I,341,19.3,368,71,297,jp
21,God Fukuoka,CHALLENGER I,337,19.4,365,71,294,jp
22,etsuya0505,CHALLENGER I,332,16.7,564,94,470,jp
23,えっっ,CHALLENGER I,274,17.8,208,37,171,jp
24,ap top mom die,CHALLENGER I,270,23.6,229,54,175,jp
25,Tぽいんと,CHALLENGER I,249,21.6,278,60,218,jp
26,Adrenaline,CHALLENGER I,243,18.8,501,94,407,jp
27,大門未知子,CHALLENGER I,234,18.9,196,37,159,jp
28,dozepk,CHALLENGER I,227,15.2,440,67,373,jp
29,りーり,CHALLENGER I,220,13.0,972,126,846,jp
30,だよな,CHALLENGER I,211,21.9,169,37,132,jp
31,喚くマン,CHALLENGER I,197,18.2,429,78,351,jp
32,Hechima777,CHALLENGER I,187,14.8,674,100,574,jp
33,秋水宴,CHALLENGER I,178,16.4,268,44,224,jp
34,まくらi,CHALLENGER I,175,23.2,129,30,99,jp
35,さとるくん,CHALLENGER I,171,11.2,445,50,395,jp
36,山田周人,CHALLENGER I,166,16.5,467,77,390,jp
37,sueno09,CHALLENGER I,165,13.8,283,39,244,jp
38,お前のレベル笑,CHALLENGER I,162,21.0,381,80,301,jp
39,賃砲丸出侍,CHALLENGER I,157,23.6,212,50,162,jp
40,るきにゃん,CHALLENGER I,155,17.9,470,84,386,jp
41,沼の大破神,CHALLENGER I,153,19.9,267,53,214,jp
42,nagatoevol,CHALLENGER I,149,17.1,381,65,316,jp
43,ますにゃ,CHALLENGER I,146,13.6,691,94,597,jp
44,loraplayer,CHALLENGER I,123,17.4,809,141,668,jp
45,mikan0x0,CHALLENGER I,122,12.4,719,89,630,jp
46,Piyochan76,CHALLENGER I,122,16.2,265,43,222,jp
47,KR blonde lov,CHALLENGER I,119,21.4,210,45,165,jp
48,xtc,CHALLENGER I,115,18.1,430,78,352,jp
49,かふす,CHALLENGER I,106,18.2,767,140,627,jp
50,rionest,CHALLENGER I,55,17.3,1016,176,840,jp
51,pureheart player,"GRANDMASTER I
G",140,16.6,350,58,292,jp
52,しかめまどか2,"GRANDMASTER I
G",129,23.5,221,52,169,jp
53,Twisted Fate Bot,"GRANDMASTER I
G",119,16.6,343,57,286,jp
54,Waterfox,"GRANDMASTER I
G",117,12.9,301,39,262,jp
55,おしっこちゃん,"GRANDMASTER I
G",113,12.1,630,76,554,jp
56,FoT DazzingDog,"GRANDMASTER I
G",99,21.2,274,58,216,jp
57,macro11,"GRANDMASTER I
G",98,16.7,288,48,240,jp
58,ぼんちょび,"GRANDMASTER I
G",89,26.8,157,42,115,jp
59,Yaruo,"GRANDMASTER I
G",82,16.8,280,47,233,jp
60,elfiny,"GRANDMASTER I
G",78,18.1,166,30,136,jp
61,モルディ貝,"GRANDMASTER I
G",72,16.1,317,51,266,jp
62,えんどほーぷ,"GRANDMASTER I
G",67,8.7,588,51,537,jp
63,Worst Takashi JP,"GRANDMASTER I
G",65,13.1,436,57,379,jp
64,URUUUU,"GRANDMASTER I
G",64,20.0,445,89,356,jp
65,Jackn,"GRANDMASTER I
G",63,20.5,224,46,178,jp
66,pveman,"GRANDMASTER I
G",59,18.6,311,58,253,jp
67,Count Mak,"GRANDMASTER I
G",58,19.9,437,87,350,jp
68,Satolis,"GRANDMASTER I
G",55,10.1,427,43,384,jp
69,ekollon,"GRANDMASTER I
G",53,18.0,422,76,346,jp
70,hohe,"GRANDMASTER I
G",36,16.4,617,101,516,jp
71,ロルから逃げるな,"GRANDMASTER I
G",36,19.6,163,32,131,jp
72,Jethro Cyrus,"GRANDMASTER I
G",33,14.1,595,84,511,jp
73,Ponty,"GRANDMASTER I
G",32,15.6,780,122,658,jp
74,nijimuraact2,"GRANDMASTER I
G",28,15.4,428,66,362,jp
75,bappy,"GRANDMASTER I
G",27,18.0,782,141,641,jp
76,ポッチャマ,"GRANDMASTER I
G",26,11.9,318,38,280,jp
77,kotogane411,"GRANDMASTER I
G",26,17.6,204,36,168,jp
78,Raias,"GRANDMASTER I
G",25,16.3,522,85,437,jp
79,foxbaby123b,"GRANDMASTER I
G",24,13.7,505,69,436,jp
80,名取ざや,"GRANDMASTER I
G",23,23.6,229,54,175,jp
81,マグロマート,"GRANDMASTER I
G",23,19.4,144,28,116,jp
82,MELODY FLAG,"GRANDMASTER I
G",22,20.1,199,40,159,jp
83,millepiedi,"GRANDMASTER I
G",21,14.0,272,38,234,jp
84,ZmLFs2z,"GRANDMASTER I
G",21,21.8,156,34,122,jp
85,pccc,"GRANDMASTER I
G",21,31.1,90,28,62,jp
86,misomega,"GRANDMASTER I
G",18,16.0,405,65,340,jp
87,たなってぃ,"GRANDMASTER I
G",17,16.8,434,73,361,jp
88,曖昧心,"GRANDMASTER I
G",16,14.7,238,35,203,jp
89,夜空丶,"GRANDMASTER I
G",15,19.6,189,37,152,jp
90,vvvvvvvvvipp,"GRANDMASTER I
G",14,17.9,529,95,434,jp
91,丸の内LOLレイナ,"GRANDMASTER I
G",13,16.1,429,69,360,jp
92,Why So Serious,"GRANDMASTER I
G",11,14.8,311,46,265,jp
93,contrail,"GRANDMASTER I
G",11,18.1,149,27,122,jp
94,夏目純夏,"GRANDMASTER I
G",7,25.1,167,42,125,jp
95,dozeqk,"GRANDMASTER I
G",6,18.5,200,37,163,jp
96,tola,"GRANDMASTER I
G",4,14.3,231,33,198,jp
97,ぬこ丸,"GRANDMASTER I
G",1,18.7,476,89,387,jp
98,ぜろななにーいち,"GRANDMASTER I
G",1,22.1,167,37,130,jp
99,Ugokeru Debu Bot,"GRANDMASTER I
G",1,16.2,222,36,186,jp
100,7zigeN,"GRANDMASTER I
G",0,17.7,1001,177,824,jp
101,bonchobi,"GRANDMASTER I
G",0,14.7,462,68,394,jp
102,じょん炊いたー,"GRANDMASTER I
G",0,21.8,308,67,241,jp
103,GoodMannerU5,"GRANDMASTER I
G",0,14.1,439,62,377,jp
104,CosplayGirl,"GRANDMASTER I
G",0,23.7,224,53,171,jp
105,tinko irelia,"GRANDMASTER I
G",0,17.4,247,43,204,jp
106,karakuti,"GRANDMASTER I
G",0,19.8,212,42,170,jp
107,クックパッド歩美,"GRANDMASTER I
G",0,21.1,147,31,116,jp
108,ゲッティスパ美,"GRANDMASTER I
G",0,18.4,163,30,133,jp
109,チャイコフスキー,MASTER I,3,14.2,1032,147,885,jp
110,日高愛,DIAMOND I,96,15.5,420,65,355,jp
111,いまのん,DIAMOND I,92,17.8,353,63,290,jp
112,Eidechse,DIAMOND I,91,16.4,220,36,184,jp
113,shuraha3,DIAMOND I,87,16.3,380,62,318,jp
114,ゆっちー,DIAMOND I,80,12.2,368,45,323,jp
115,askrp,DIAMOND I,75,17.0,569,97,472,jp
116,Sukizofureni,DIAMOND I,75,13.3,548,73,475,jp
117,lalabybyby,DIAMOND I,75,15.6,461,72,389,jp
118,MichaelChan,DIAMOND I,75,17.7,317,56,261,jp
119,てっくてっく,DIAMOND I,75,19.0,273,52,221,jp
120,ききちま,DIAMOND I,75,18.2,285,52,233,jp
121,福山はさまるJP,DIAMOND I,75,16.3,307,50,257,jp
122,ABEKANZOU,DIAMOND I,75,19.5,210,41,169,jp
123,ButaDaJoe,DIAMOND I,75,19.5,190,37,153,jp
124,スルギすき,DIAMOND I,75,16.7,204,34,170,jp
125,オーシャン増永,DIAMOND I,75,18.8,176,33,143,jp
126,IKUTOMIE,DIAMOND I,75,11.4,228,26,202,jp
127,AikaS,DIAMOND I,74,16.3,728,119,609,jp
128,くりちゃん大好き,DIAMOND I,69,21.4,159,34,125,jp
129,XionNoi,DIAMOND I,61,18.4,386,71,315,jp
130,NAGATSUNE,DIAMOND I,60,14.9,562,84,478,jp
131,1515225,DIAMOND I,59,14.9,376,56,320,jp
132,汝何着品如衣,DIAMOND I,57,16.1,230,37,193,jp
133,Bad Takahashi,DIAMOND I,45,19.0,200,38,162,jp
134,ぽこくま,DIAMOND I,42,18.8,138,26,112,jp
135,young4u,DIAMOND I,41,16.6,326,54,272,jp
136,koogie,DIAMOND I,39,14.3,343,49,294,jp
137,dngr,DIAMOND I,38,16.2,271,44,227,jp
138,shinano,DIAMOND I,37,15.9,157,25,132,jp
139,low roller,DIAMOND I,36,18.1,177,32,145,jp
140,Remixi,DIAMOND I,35,11.7,196,23,173,jp
141,snatcher,DIAMOND I,34,15.1,538,81,457,jp
142,Kuririman,DIAMOND I,31,14.7,265,39,226,jp
143,imymind,DIAMOND I,31,15.9,239,38,201,jp
144,涼風あおば,DIAMOND I,30,18.8,101,19,82,jp
145,犬走椛,DIAMOND I,29,19.4,103,20,83,jp
146,にじむら,DIAMOND I,28,12.6,709,89,620,jp
147,濃厚鶏白湯拉麺,DIAMOND I,28,17.0,159,27,132,jp
148,shuraha4,DIAMOND I,27,13.5,303,41,262,jp
149,Nochita,DIAMOND I,27,12.4,273,34,239,jp
150,orange7premium,DIAMOND I,25,17.1,461,79,382,jp
151,スタフィー,DIAMOND I,25,23.8,172,41,131,jp
152,世界詞のキア,DIAMOND I,24,16.7,126,21,105,jp
153,うるるる,DIAMOND I,21,21.2,137,29,108,jp
154,いけなる,DIAMOND I,19,17.3,734,127,607,jp
155,ーAkiraー,DIAMOND I,19,14.3,370,53,317,jp
156,NewmetaTrollking,DIAMOND I,19,12.6,374,47,327,jp
157,IlllIlllIlllI,DIAMOND I,18,20.3,177,36,141,jp
158,halkeye,DIAMOND I,16,14.0,608,85,523,jp
159,neetneo,DIAMOND I,16,20.9,210,44,166,jp
160,副頭取,DIAMOND I,14,13.2,220,29,191,jp
161,HitujiDaJoe,DIAMOND I,13,16.4,195,32,163,jp
162,ヨンジン,DIAMOND I,12,10.0,391,39,352,jp
163,ダンボ君,DIAMOND I,11,17.4,161,28,133,jp
164,にぶさき,DIAMOND I,9,15.2,975,148,827,jp
165,ランダムそうち,DIAMOND I,8,12.8,678,87,591,jp
166,InventusGaming,DIAMOND I,5,10.6,350,37,313,jp
167,福山はさまるNA,DIAMOND I,5,19.7,147,29,118,jp
168,Gafu,DIAMOND I,4,13.5,813,110,703,jp
169,エミュー,DIAMOND I,3,14.5,456,66,390,jp
170,ふうニキ,DIAMOND I,3,11.6,526,61,465,jp
171,enamel,DIAMOND I,3,9.4,341,32,309,jp
172,watchhhhhh,DIAMOND I,3,18.7,150,28,122,jp
173,Rhino Cider,DIAMOND I,3,12.5,192,24,168,jp
174,ciple753,DIAMOND I,2,12.9,301,39,262,jp
175,ジャジャラ,DIAMOND I,2,15.7,197,31,166,jp
176,Sakurakouji Luna,DIAMOND I,2,20.6,126,26,100,jp
177,Kyoutle,DIAMOND I,1,12.7,660,84,576,jp
178,はんえつか,DIAMOND I,1,16.8,185,31,154,jp
179,しかめまどか,DIAMOND I,0,14.6,1214,177,1037,jp
180,醤ØuØ油,DIAMOND I,0,14.0,827,116,711,jp
181,Premium Malt,DIAMOND I,0,13.3,678,90,588,jp
182,gacchapin20,DIAMOND I,0,13.4,649,87,562,jp
183,pano,DIAMOND I,0,17.0,448,76,372,jp
184,Shield Samba,DIAMOND I,0,13.3,481,64,417,jp
185,tomonar1,DIAMOND I,0,14.2,393,56,337,jp
186,アイルー卿,DIAMOND I,0,15.1,364,55,309,jp
187,Endcyclone,DIAMOND I,0,27.0,148,40,108,jp
188,laser501,DIAMOND I,0,16.4,237,39,198,jp
189,siva fes,DIAMOND I,0,12.5,279,35,244,jp
190,キャンディ  猫,DIAMOND I,0,19.6,173,34,139,jp
191,yatsuhashi567,DIAMOND I,0,13.5,251,34,217,jp
192,下了88,DIAMOND I,0,27.6,116,32,84,jp
193,toudoriDX2,DIAMOND I,0,9.9,302,30,272,jp
194,εOnOз,DIAMOND I,0,18.7,139,26,113,jp
195,nasyoter,DIAMOND I,0,15.1,139,21,118,jp
196,所念皆星河,DIAMOND II,96,18.7,316,59,257,jp
197,newie,DIAMOND II,94,15.5,328,51,277,jp
198,UnpokoKenshi,DIAMOND II,93,17.7,231,41,190,jp
199,AHIKJDK,DIAMOND II,92,27.2,103,28,75,jp
200,center8128,DIAMOND II,87,15.0,173,26,147,jp
1,AFTV 꼴픽이,CHALLENGER I,1685,19.2,1014,195,819,kr
2,곰과제리2,CHALLENGER I,1627,20.2,312,63,249,kr
3,김린Or남친,CHALLENGER I,1503,18.0,890,160,730,kr
4,스트롱뽀송뽀송,CHALLENGER I,1456,15.1,958,145,813,kr
5,정동글2,CHALLENGER I,1452,18.6,327,61,266,kr
6,홀애비2,CHALLENGER I,1429,18.9,1006,190,816,kr
7,정동글,CHALLENGER I,1412,17.8,596,106,490,kr
8,퐈피는잘못없어,CHALLENGER I,1372,17.6,1187,209,978,kr
9,노마딕,CHALLENGER I,1327,17.8,645,115,530,kr
10,청정민,CHALLENGER I,1304,14.4,1311,189,1122,kr
11,곰과제리,CHALLENGER I,1303,18.5,834,154,680,kr
12,럭키체스777,CHALLENGER I,1242,13.5,681,92,589,kr
13,AFTV 웃바,CHALLENGER I,1240,18.1,585,106,479,kr
14,난몰라,CHALLENGER I,1239,17.2,431,74,357,kr
15,난몰라2,CHALLENGER I,1222,13.0,508,66,442,kr
16,체주미,CHALLENGER I,1203,17.6,307,54,253,kr
17,펠새로이,CHALLENGER I,1201,18.1,733,133,600,kr
18,shungjinsoo,CHALLENGER I,1193,17.9,886,159,727,kr
19,SanChess,CHALLENGER I,1173,17.1,572,98,474,kr
20,알레 델리,CHALLENGER I,1164,23.2,280,65,215,kr
21,BAAMM,CHALLENGER I,1149,18.8,1270,239,1031,kr
22,shungjinsoo2,CHALLENGER I,1141,16.8,457,77,380,kr
23,아기용1,CHALLENGER I,1135,19.9,1615,321,1294,kr
24,Alle Deli,CHALLENGER I,1124,14.8,487,72,415,kr
25,기도메타777,CHALLENGER I,1116,14.0,335,47,288,kr
26,Cherryon,CHALLENGER I,1109,15.4,903,139,764,kr
27,두니주니,CHALLENGER I,1076,18.3,1305,239,1066,kr
28,화살 세례,CHALLENGER I,1058,17.1,694,119,575,kr
29,알맹승지,CHALLENGER I,1051,11.7,599,70,529,kr
30,피노키훈,CHALLENGER I,1045,18.4,815,150,665,kr
31,TZ 제리,CHALLENGER I,1045,14.6,608,89,519,kr
32,깽 만,CHALLENGER I,1033,13.2,823,109,714,kr
33,바삭한빵,CHALLENGER I,1032,18.1,464,84,380,kr
34,Park Eunbin,CHALLENGER I,1032,17.2,464,80,384,kr
35,곰과제리3,CHALLENGER I,1018,16.1,391,63,328,kr
36,마스터 3,CHALLENGER I,1017,10.5,848,89,759,kr
37,축 꾸,CHALLENGER I,1004,18.2,831,151,680,kr
38,종자잇,CHALLENGER I,982,16.3,411,67,344,kr
39,끓인사발면,CHALLENGER I,971,19.8,378,75,303,kr
40,Fiora TOP,CHALLENGER I,965,12.6,629,79,550,kr
41,머리한입꼬리한입,CHALLENGER I,948,16.4,1018,167,851,kr
42,My Paradise,CHALLENGER I,944,23.2,751,174,577,kr
43,왜 나만 운없냐,CHALLENGER I,937,17.8,348,62,286,kr
44,IIIlllIIIlllII,CHALLENGER I,921,11.3,1321,150,1171,kr
45,포식자원툴,CHALLENGER I,912,15.4,943,145,798,kr
46,코스모TV,CHALLENGER I,910,17.1,697,119,578,kr
47,펠 다,CHALLENGER I,902,23.7,401,95,306,kr
48,카시장인 삿카시,CHALLENGER I,901,14.8,426,63,363,kr
49,패트롤원툴,CHALLENGER I,895,17.2,640,110,530,kr
50,prexis,CHALLENGER I,892,11.0,1062,117,945,kr
51,사랑해꿀아,CHALLENGER I,889,15.1,575,87,488,kr
52,현이야아아,CHALLENGER I,888,13.1,817,107,710,kr
53,정동기리,CHALLENGER I,871,17.4,305,53,252,kr
54,최killing,CHALLENGER I,853,12.4,709,88,621,kr
55,김유Or,CHALLENGER I,853,16.6,464,77,387,kr
56,안산시청,CHALLENGER I,849,17.2,535,92,443,kr
57,hiimg4nmi,CHALLENGER I,844,15.0,802,120,682,kr
58,꽃피그,CHALLENGER I,842,18.4,282,52,230,kr
59,안지영,CHALLENGER I,841,18.3,339,62,277,kr
60,Gritor,CHALLENGER I,835,16.3,1279,209,1070,kr
61,롤체고오수,CHALLENGER I,833,17.1,234,40,194,kr
62,푸딩턱털낼름낼름,CHALLENGER I,832,19.6,322,63,259,kr
63,내가더사기얍,CHALLENGER I,830,15.9,514,82,432,kr
64,로자이어,CHALLENGER I,824,12.7,683,87,596,kr
65,TFT 너밤,CHALLENGER I,821,18.7,481,90,391,kr
66,킨드레드블루그린,CHALLENGER I,812,17.2,785,135,650,kr
67,천득 Youtube,CHALLENGER I,812,16.3,404,66,338,kr
68,천 득,CHALLENGER I,811,14.0,420,59,361,kr
69,woiwoer12,CHALLENGER I,810,16.0,956,153,803,kr
70,궁뎅크니,CHALLENGER I,810,14.5,710,103,607,kr
71,귀여운나르자나,CHALLENGER I,799,22.6,618,140,478,kr
72,그레이스바라기,CHALLENGER I,799,14.5,304,44,260,kr
73,보이지않는기물,CHALLENGER I,787,18.6,474,88,386,kr
74,버그활용법,CHALLENGER I,785,26.1,280,73,207,kr
75,개 북,CHALLENGER I,781,18.0,417,75,342,kr
76,초보끼리합시다,CHALLENGER I,780,14.3,764,109,655,kr
77,Everton FAN,CHALLENGER I,779,11.3,362,41,321,kr
78,끓인사발면2,CHALLENGER I,773,23.8,214,51,163,kr
79,빅머니장사장,CHALLENGER I,772,18.1,442,80,362,kr
80,Eunso,CHALLENGER I,770,14.9,1019,152,867,kr
81,고유나,CHALLENGER I,766,16.4,422,69,353,kr
82,바위게줍기장인,CHALLENGER I,763,15.2,874,133,741,kr
83,Younna,CHALLENGER I,759,21.2,184,39,145,kr
84,Keane Tft,CHALLENGER I,758,19.9,186,37,149,kr
85,원도깨비,CHALLENGER I,757,14.7,504,74,430,kr
86,종범1,CHALLENGER I,757,17.8,247,44,203,kr
87,지하닝2,CHALLENGER I,756,19.4,612,119,493,kr
88,챌린저라닉변함,CHALLENGER I,752,11.6,869,101,768,kr
89,꼴픽이 Youtube,CHALLENGER I,751,21.3,183,39,144,kr
90,lxry,CHALLENGER I,749,14.2,239,34,205,kr
91,귀여운쫑이자나,CHALLENGER I,747,16.1,826,133,693,kr
92,15조현지,CHALLENGER I,743,22.1,307,68,239,kr
93,옴팡이,CHALLENGER I,741,19.7,1485,292,1193,kr
94,TFT Xion,CHALLENGER I,741,13.7,1136,156,980,kr
95,Mongri,CHALLENGER I,732,16.4,1336,219,1117,kr
96,랑조췻,CHALLENGER I,732,11.6,1453,168,1285,kr
97,Dosu,CHALLENGER I,731,14.2,282,40,242,kr
98,90972114del,CHALLENGER I,729,16.0,1008,161,847,kr
99,시루시루해,CHALLENGER I,725,15.9,687,109,578,kr
100,전설의소라고동,CHALLENGER I,724,15.4,746,115,631,kr
101,TZ 제리쌤,CHALLENGER I,723,16.0,294,47,247,kr
102,찬란하고찬란하게,CHALLENGER I,718,12.4,1131,140,991,kr
103,AFTV로얄,CHALLENGER I,718,12.2,1099,134,965,kr
104,엠브로돈까스,CHALLENGER I,717,18.0,1497,270,1227,kr
105,체스보이민다빈,CHALLENGER I,715,17.2,1316,226,1090,kr
106,AFTV 구루루,CHALLENGER I,714,14.8,1300,193,1107,kr
107,롤접으면여친생김,CHALLENGER I,707,18.0,327,59,268,kr
108,노래하는 쭌,CHALLENGER I,706,10.7,804,86,718,kr
109,안 졍,CHALLENGER I,706,16.4,365,60,305,kr
110,유후a,CHALLENGER I,704,17.1,596,102,494,kr
111,알맹승지2,CHALLENGER I,699,10.5,474,50,424,kr
112,Pnaz,CHALLENGER I,695,29.7,222,66,156,kr
113,줘 너,CHALLENGER I,692,13.4,1045,140,905,kr
114,잉꾸잉꾸잉꾸,CHALLENGER I,691,15.0,700,105,595,kr
115,쓰레쉬핵초고수,CHALLENGER I,689,14.6,802,117,685,kr
116,이집트신화,CHALLENGER I,685,13.0,713,93,620,kr
117,오면 딴다,CHALLENGER I,683,13.5,787,106,681,kr
118,AFTV 깔창부린,CHALLENGER I,682,16.1,1770,286,1484,kr
119,possible,CHALLENGER I,677,15.9,527,84,443,kr
120,안하기로했자나,CHALLENGER I,677,16.8,322,54,268,kr
121,욕한번채금한번,CHALLENGER I,675,19.6,668,131,537,kr
122,포포도쓰,CHALLENGER I,673,14.3,813,116,697,kr
123,Why do I live,CHALLENGER I,671,17.0,577,98,479,kr
124,TZ 코그멍,CHALLENGER I,671,16.8,423,71,352,kr
125,게므론,CHALLENGER I,670,9.8,927,91,836,kr
126,패트롤원툴2,CHALLENGER I,668,14.7,712,105,607,kr
127,Blanker,CHALLENGER I,667,17.5,770,135,635,kr
128,WE CAN WlN,CHALLENGER I,666,17.3,537,93,444,kr
129,호랑이찌찌젖짜기,CHALLENGER I,664,15.6,539,84,455,kr
130,k1moddi,CHALLENGER I,659,18.3,213,39,174,kr
131,김음주,CHALLENGER I,657,14.1,767,108,659,kr
132,FateGrand5rder,CHALLENGER I,655,9.3,1132,105,1027,kr
133,혹시그거아냐,CHALLENGER I,655,14.2,387,55,332,kr
134,이Or름,CHALLENGER I,654,11.6,1001,116,885,kr
135,Roik,CHALLENGER I,652,28.0,132,37,95,kr
136,아갈머리를콰악,CHALLENGER I,650,22.5,204,46,158,kr
137,앗 추워,CHALLENGER I,647,15.0,731,110,621,kr
138,우디르디르,CHALLENGER I,647,15.0,652,98,554,kr
139,참새년,CHALLENGER I,645,13.9,546,76,470,kr
140,주나식,CHALLENGER I,636,17.6,244,43,201,kr
141,곽예림,CHALLENGER I,634,12.3,950,117,833,kr
142,오지마요제발,CHALLENGER I,633,11.5,992,114,878,kr
143,치약소년,CHALLENGER I,633,15.5,252,39,213,kr
144,대위 리정혁,CHALLENGER I,632,14.5,605,88,517,kr
145,삐진범,CHALLENGER I,631,14.9,242,36,206,kr
146,last40ne,CHALLENGER I,630,19.1,141,27,114,kr
147,조치타치,CHALLENGER I,629,10.5,792,83,709,kr
148,시즌2대한민국1등,CHALLENGER I,629,15.3,535,82,453,kr
149,미어캣군,CHALLENGER I,629,13.1,428,56,372,kr
150,땅콩달콤,CHALLENGER I,628,15.2,505,77,428,kr
151,proooa,CHALLENGER I,625,16.3,514,84,430,kr
152,깔딱깔딱,CHALLENGER I,624,18.1,785,142,643,kr
153,탑하겠습니다,CHALLENGER I,624,17.8,359,64,295,kr
154,카리조마,CHALLENGER I,623,17.7,513,91,422,kr
155,Ignited,CHALLENGER I,621,12.5,513,64,449,kr
156,YunHyeonSik,CHALLENGER I,618,12.6,364,46,318,kr
157,2000 11 12,CHALLENGER I,616,17.7,282,50,232,kr
158,남자는코멧,CHALLENGER I,614,13.1,390,51,339,kr
159,illilililli1,CHALLENGER I,614,16.3,252,41,211,kr
160,정밍호짱짱걸,CHALLENGER I,609,13.9,981,136,845,kr
161,EMP 모구,CHALLENGER I,609,15.8,438,69,369,kr
162,조치타칫쿵칫타,CHALLENGER I,607,9.5,410,39,371,kr
163,세번째차인달삼,CHALLENGER I,606,17.3,911,158,753,kr
164,Art DrucKer,CHALLENGER I,606,14.5,691,100,591,kr
165,지니쁘미,CHALLENGER I,605,15.6,275,43,232,kr
166,Trust me only,CHALLENGER I,604,11.0,471,52,419,kr
167,s3unguk,CHALLENGER I,602,14.6,547,80,467,kr
168,불꽃자잇 사생팬,CHALLENGER I,602,14.6,397,58,339,kr
169,멍청아린,CHALLENGER I,601,14.1,580,82,498,kr
170,봄날이갓두,CHALLENGER I,601,11.7,677,79,598,kr
171,대깨포식자,CHALLENGER I,601,13.6,447,61,386,kr
172,똥꼬에펜타킬,CHALLENGER I,596,11.3,405,46,359,kr
173,초식판다,CHALLENGER I,592,13.1,880,115,765,kr
174,길막장인,CHALLENGER I,592,18.0,412,74,338,kr
175,정 찰 돼,CHALLENGER I,591,12.2,433,53,380,kr
176,미래지향사나이,CHALLENGER I,590,15.8,637,101,536,kr
177,어런이222,CHALLENGER I,590,13.9,653,91,562,kr
178,미소왕,CHALLENGER I,590,13.8,630,87,543,kr
179,I Go Challenger,CHALLENGER I,590,14.9,369,55,314,kr
180,멀보노자슥아,CHALLENGER I,587,13.2,740,98,642,kr
181,뱅 탁,CHALLENGER I,586,12.3,496,61,435,kr
182,Schakal,CHALLENGER I,585,13.4,709,95,614,kr
183,이딴겜해주지마,CHALLENGER I,585,38.6,119,46,73,kr
184,Dpr live A,CHALLENGER I,584,14.7,177,26,151,kr
185,AF HappyVirus,CHALLENGER I,583,18.8,282,53,229,kr
186,진이애완동물,CHALLENGER I,582,15.2,488,74,414,kr
187,Viento 9,CHALLENGER I,575,13.8,477,66,411,kr
188,02Mania,CHALLENGER I,574,17.7,344,61,283,kr
189,빠꾸 없이 빠끄,CHALLENGER I,572,9.8,714,70,644,kr
190,르제스키,CHALLENGER I,571,17.3,578,100,478,kr
191,베가알쓰리짱,CHALLENGER I,570,13.7,670,92,578,kr
192,요들시너지 룰루,CHALLENGER I,569,13.9,223,31,192,kr
193,쥬상이,CHALLENGER I,568,14.5,303,44,259,kr
194,똥줄타노스,CHALLENGER I,565,17.4,270,47,223,kr
195,달삼이빡빡라이즈,CHALLENGER I,564,14.2,633,90,543,kr
196,터틀 킴,CHALLENGER I,562,12.7,551,70,481,kr
197,AFTV 오대,CHALLENGER I,560,16.1,1417,228,1189,kr
198,V 6 6 V,CHALLENGER I,560,12.3,665,82,583,kr
199,도리찡,CHALLENGER I,559,16.1,534,86,448,kr
200,한겜하고말사이에,CHALLENGER I,554,14.1,789,111,678,kr
1,Tewesineitor,CHALLENGER I,1498,29.1,306,89,217,lan
2,Rayio,CHALLENGER I,1305,23.1,928,214,714,lan
3,akalyzer,CHALLENGER I,1279,26.7,688,184,504,lan
4,Líon,CHALLENGER I,1231,20.5,557,114,443,lan
5,Crycer,CHALLENGER I,1007,30.3,304,92,212,lan
6,Quantum8,CHALLENGER I,1003,23.9,289,69,220,lan
7,CarryMe Akashi,CHALLENGER I,925,20.1,487,98,389,lan
8,SákuraHana,CHALLENGER I,921,32.6,224,73,151,lan
9,Yami Laicus,CHALLENGER I,896,27.7,303,84,219,lan
10,GhoStorm,CHALLENGER I,865,21.0,404,85,319,lan
11,NVS Bowen,CHALLENGER I,859,20.1,329,66,263,lan
12,bite of destiny,CHALLENGER I,778,21.1,539,114,425,lan
13,xBjaker,CHALLENGER I,768,20.8,308,64,244,lan
14,Cerealito,CHALLENGER I,753,18.3,409,75,334,lan
15,NVS Bowi,CHALLENGER I,685,23.1,242,56,186,lan
16,KilljoyMex,CHALLENGER I,652,23.1,242,56,186,lan
17,Ch1wy,CHALLENGER I,641,14.0,735,103,632,lan
18,Dal,CHALLENGER I,638,19.2,364,70,294,lan
19,lmlWarCrY,CHALLENGER I,629,21.7,300,65,235,lan
20,itken,CHALLENGER I,574,16.6,1010,168,842,lan
21,KiraDessu,CHALLENGER I,560,22.9,402,92,310,lan
22,MyzteryAlex,CHALLENGER I,557,12.5,944,118,826,lan
23,PipoMaster,CHALLENGER I,546,22.2,306,68,238,lan
24,QuiMi,CHALLENGER I,513,20.4,362,74,288,lan
25,MaRiO bRoS,CHALLENGER I,500,17.7,767,136,631,lan
26,RiftHerald,CHALLENGER I,495,17.7,209,37,172,lan
27,Dlanor,CHALLENGER I,484,20.9,444,93,351,lan
28,7DS HyperSpace,CHALLENGER I,476,21.7,1047,227,820,lan
29,Garto Ward,CHALLENGER I,475,17.6,319,56,263,lan
30,AztecMx,CHALLENGER I,475,13.4,238,32,206,lan
31,2D Jaro,CHALLENGER I,471,23.8,755,180,575,lan
32,Redmoonwolf,CHALLENGER I,448,11.9,354,42,312,lan
33,ianakin7,CHALLENGER I,436,18.1,782,142,640,lan
34,Hi im Clark,CHALLENGER I,431,22.6,288,65,223,lan
35,andmont,CHALLENGER I,418,19.7,264,52,212,lan
36,TftAcademy,CHALLENGER I,413,12.9,548,71,477,lan
37,Soul 1,CHALLENGER I,407,23.4,256,60,196,lan
38,Sealcune Mbappé,CHALLENGER I,406,19.0,563,107,456,lan
39,Lysıthea,CHALLENGER I,400,23.2,371,86,285,lan
40,shiry,CHALLENGER I,394,19.8,273,54,219,lan
41,Exus,CHALLENGER I,392,21.5,288,62,226,lan
42,melizaX,CHALLENGER I,390,17.4,338,59,279,lan
43,KllK EditZ,CHALLENGER I,390,18.0,289,52,237,lan
44,Im not villo,CHALLENGER I,389,21.0,366,77,289,lan
45,Ardén,CHALLENGER I,389,12.6,532,67,465,lan
46,TheBadMF,CHALLENGER I,388,16.8,351,59,292,lan
47,Mr Mugui,CHALLENGER I,381,17.1,1020,175,845,lan
48,JOnnyLR,CHALLENGER I,376,17.1,357,61,296,lan
49,Slix,CHALLENGER I,367,24.9,177,44,133,lan
50,AntonyGamingTFT,CHALLENGER I,318,15.5,491,76,415,lan
51,Quántum,"GRANDMASTER I
G",407,23.6,174,41,133,lan
52,Garchomp,"GRANDMASTER I
G",394,27.8,187,52,135,lan
53,Frondavil,"GRANDMASTER I
G",382,15.9,433,69,364,lan
54,Vampiro Playero,"GRANDMASTER I
G",346,19.0,310,59,251,lan
55,oliver10,"GRANDMASTER I
G",343,19.5,272,53,219,lan
56,warlocksky,"GRANDMASTER I
G",328,14.6,253,37,216,lan
57,Kurokoba,"GRANDMASTER I
G",323,19.0,179,34,145,lan
58,thewghost,"GRANDMASTER I
G",302,24.4,197,48,149,lan
59,Putint,"GRANDMASTER I
G",293,19.5,266,52,214,lan
60,Siempremuerto,"GRANDMASTER I
G",291,15.3,340,52,288,lan
61,No soy exoor,"GRANDMASTER I
G",267,25.1,175,44,131,lan
62,Main Q,"GRANDMASTER I
G",266,19.9,282,56,226,lan
63,CrisT1an,"GRANDMASTER I
G",263,22.9,170,39,131,lan
64,Gio9811,"GRANDMASTER I
G",255,15.7,236,37,199,lan
65,Gargota,"GRANDMASTER I
G",252,21.5,297,64,233,lan
66,Maguita,"GRANDMASTER I
G",248,18.1,332,60,272,lan
67,Too Sweet,"GRANDMASTER I
G",243,25.9,131,34,97,lan
68,PoronghaNegra,"GRANDMASTER I
G",234,17.1,397,68,329,lan
69,Rambotehamatado,"GRANDMASTER I
G",227,16.1,434,70,364,lan
70,Dondenuncias,"GRANDMASTER I
G",218,28.6,161,46,115,lan
71,TFT Lelouch,"GRANDMASTER I
G",218,14.2,260,37,223,lan
72,G2 Josar,"GRANDMASTER I
G",217,18.9,338,64,274,lan
73,Marenn,"GRANDMASTER I
G",207,13.6,287,39,248,lan
74,NAOS911,"GRANDMASTER I
G",206,11.6,614,71,543,lan
75,Psend,"GRANDMASTER I
G",206,19.5,200,39,161,lan
76,Cleopatro,"GRANDMASTER I
G",201,34.3,105,36,69,lan
77,Need more skins,"GRANDMASTER I
G",195,15.4,376,58,318,lan
78,Cjddd,"GRANDMASTER I
G",194,15.8,221,35,186,lan
79,ransabia,"GRANDMASTER I
G",190,14.3,628,90,538,lan
80,Xkorzo YT,"GRANDMASTER I
G",177,28.4,95,27,68,lan
81,LiL Exoor,"GRANDMASTER I
G",176,23.9,201,48,153,lan
82,Warblo,"GRANDMASTER I
G",174,24.4,405,99,306,lan
83,25356,"GRANDMASTER I
G",172,16.9,307,52,255,lan
84,Revengp,"GRANDMASTER I
G",172,20.4,220,45,175,lan
85,Twistä,"GRANDMASTER I
G",168,10.8,353,38,315,lan
86,llArthzll,"GRANDMASTER I
G",167,23.8,332,79,253,lan
87,Rodo TFT,"GRANDMASTER I
G",164,15.9,239,38,201,lan
88,lyonew,"GRANDMASTER I
G",156,13.8,507,70,437,lan
89,Khorge,"GRANDMASTER I
G",156,19.7,132,26,106,lan
90,panchoAngüis,"GRANDMASTER I
G",153,23.5,306,72,234,lan
91,Khorge PN,"GRANDMASTER I
G",145,19.0,210,40,170,lan
92,Vork,"GRANDMASTER I
G",144,15.1,443,67,376,lan
93,Pompo,"GRANDMASTER I
G",142,18.0,345,62,283,lan
94,Ucr,"GRANDMASTER I
G",139,14.6,377,55,322,lan
95,Jir0,"GRANDMASTER I
G",138,15.7,504,79,425,lan
96,zeiik,"GRANDMASTER I
G",138,16.9,267,45,222,lan
97,liou,"GRANDMASTER I
G",136,17.6,131,23,108,lan
98,FordHealer,"GRANDMASTER I
G",135,27.0,74,20,54,lan
99,McGregorr,"GRANDMASTER I
G",132,18.8,420,79,341,lan
100,TheFenixx,"GRANDMASTER I
G",125,30.3,211,64,147,lan
101,Stupefy,"GRANDMASTER I
G",123,13.2,440,58,382,lan
102,Pushesz,"GRANDMASTER I
G",117,18.7,348,65,283,lan
103,AbrahamBM,"GRANDMASTER I
G",117,16.8,191,32,159,lan
104,lkokito,"GRANDMASTER I
G",116,18.4,418,77,341,lan
105,ExtraWuiller,"GRANDMASTER I
G",116,14.3,245,35,210,lan
106,Pedro Bae,"GRANDMASTER I
G",113,24.6,349,86,263,lan
107,Nightlover,"GRANDMASTER I
G",109,17.3,330,57,273,lan
108,WJ Rem,"GRANDMASTER I
G",109,15.3,307,47,260,lan
109,javia316,"GRANDMASTER I
G",107,15.1,489,74,415,lan
110,Pauleandro,"GRANDMASTER I
G",107,8.3,577,48,529,lan
111,xHeroskillx,"GRANDMASTER I
G",107,15.8,240,38,202,lan
112,Aletsis,"GRANDMASTER I
G",107,22.1,145,32,113,lan
113,Phobosss,"GRANDMASTER I
G",105,14.4,348,50,298,lan
114,TheOnlyTeddy,"GRANDMASTER I
G",105,17.1,252,43,209,lan
115,Seìyu,"GRANDMASTER I
G",104,15.1,285,43,242,lan
116,No Mercy,"GRANDMASTER I
G",103,16.6,583,97,486,lan
117,TrafalgarL4w,"GRANDMASTER I
G",103,20.4,412,84,328,lan
118,TFT Ares,"GRANDMASTER I
G",102,11.0,547,60,487,lan
119,aeal99,"GRANDMASTER I
G",102,12.6,199,25,174,lan
120,lx Rayhad xl,"GRANDMASTER I
G",100,21.4,159,34,125,lan
121,rambo12345678,"GRANDMASTER I
G",99,14.7,523,77,446,lan
122,Skan011,"GRANDMASTER I
G",99,14.0,236,33,203,lan
123,Chesspants,"GRANDMASTER I
G",97,18.8,197,37,160,lan
124,Dizzy DestroyLAN,"GRANDMASTER I
G",96,20.9,91,19,72,lan
125,Anivio,"GRANDMASTER I
G",95,16.7,288,48,240,lan
126,papusmaximus,"GRANDMASTER I
G",95,6.5,324,21,303,lan
127,JONN93,"GRANDMASTER I
G",92,13.0,599,78,521,lan
128,BarbeQ,"GRANDMASTER I
G",90,15.7,562,88,474,lan
129,GøldLyon,"GRANDMASTER I
G",90,16.5,309,51,258,lan
130,Skaaarl,"GRANDMASTER I
G",90,16.3,257,42,215,lan
131,TFTJefe,"GRANDMASTER I
G",89,14.8,283,42,241,lan
132,Desü,"GRANDMASTER I
G",87,14.6,478,70,408,lan
133,Gatito Cósmıco,"GRANDMASTER I
G",85,17.6,239,42,197,lan
134,BarbieQ,"GRANDMASTER I
G",85,27.5,109,30,79,lan
135,ILY Elena Rubí,"GRANDMASTER I
G",85,23.9,113,27,86,lan
136,Cloud strife,"GRANDMASTER I
G",85,16.8,155,26,129,lan
137,GS Lancelot,"GRANDMASTER I
G",84,17.7,266,47,219,lan
138,Don Stban,"GRANDMASTER I
G",80,21.7,129,28,101,lan
139,God JdGa,"GRANDMASTER I
G",78,23.1,359,83,276,lan
140,XiaoPo06,"GRANDMASTER I
G",74,13.4,581,78,503,lan
141,Vey,"GRANDMASTER I
G",73,16.9,219,37,182,lan
142,DragoFenix2,"GRANDMASTER I
G",70,16.0,293,47,246,lan
143,Venonmanzer,"GRANDMASTER I
G",70,10.6,265,28,237,lan
144,Moncho,"GRANDMASTER I
G",69,12.8,156,20,136,lan
145,l Moe l,"GRANDMASTER I
G",68,12.6,310,39,271,lan
146,bEiMáR,"GRANDMASTER I
G",55,13.5,798,108,690,lan
147,Apödaca,"GRANDMASTER I
G",44,25.4,268,68,200,lan
148,socio2k,"GRANDMASTER I
G",28,17.9,312,56,256,lan
149,EN1GMA,"GRANDMASTER I
G",5,18.1,786,142,644,lan
150,Power,"GRANDMASTER I
G",0,14.0,400,56,344,lan
151,ChinoRobin,MASTER I,109,24.5,245,60,185,lan
152,Sleepfer,MASTER I,101,13.7,794,109,685,lan
153,JoseM29,MASTER I,66,16.0,350,56,294,lan
154,Nebura,MASTER I,65,19.5,205,40,165,lan
155,96Cronus05,MASTER I,63,21.2,203,43,160,lan
156,Ęnder,MASTER I,59,16.1,180,29,151,lan
157,Tactics,MASTER I,57,7.2,919,66,853,lan
158,Awela Requiem,MASTER I,57,23.2,233,54,179,lan
159,DLT Macloud,MASTER I,51,17.2,487,84,403,lan
160,JulesMont,MASTER I,50,21.2,231,49,182,lan
161,TheGearZ,MASTER I,50,11.7,180,21,159,lan
162,Stuff,MASTER I,49,14.0,386,54,332,lan
163,Lą Sultąną,MASTER I,49,28.7,94,27,67,lan
164,Frozte,MASTER I,48,17.9,223,40,183,lan
165,Orange,MASTER I,47,12.0,482,58,424,lan
166,Wamuu,MASTER I,45,17.5,382,67,315,lan
167,Arcaanine,MASTER I,45,10.7,590,63,527,lan
168,YaphetS Karma,MASTER I,44,23.0,165,38,127,lan
169,scarmg,MASTER I,43,20.0,350,70,280,lan
170,Lechuga Húmeda,MASTER I,42,16.7,252,42,210,lan
171,Wild Octupus,MASTER I,41,23.9,180,43,137,lan
172,Espemss,MASTER I,39,14.9,222,33,189,lan
173,Danté,MASTER I,38,19.0,331,63,268,lan
174,NKG Madness,MASTER I,38,21.9,196,43,153,lan
175,Lą Mąscotą,MASTER I,38,15.2,151,23,128,lan
176,TOMATOFARMER535,MASTER I,36,9.4,615,58,557,lan
177,Fêderico,MASTER I,36,17.1,315,54,261,lan
178,diandi,MASTER I,36,18.9,259,49,210,lan
179,soli hdz,MASTER I,35,17.3,428,74,354,lan
180,HaganeNoren,MASTER I,34,20.5,215,44,171,lan
181,Miguel Aleman,MASTER I,34,17.3,196,34,162,lan
182,D4nyle,MASTER I,33,14.1,1540,217,1323,lan
183,FjBlanco,MASTER I,32,17.7,362,64,298,lan
184,Marvelous,MASTER I,32,17.6,262,46,216,lan
185,Enryu The Red,MASTER I,30,18.6,307,57,250,lan
186,Gizu,MASTER I,29,13.2,416,55,361,lan
187,chërlyn,MASTER I,28,23.4,320,75,245,lan
188,Devilx500,MASTER I,28,13.7,497,68,429,lan
189,Utephh,MASTER I,27,16.1,260,42,218,lan
190,Archi,MASTER I,27,12.7,237,30,207,lan
191,Dirmund,MASTER I,27,9.8,264,26,238,lan
192,El HuachicoIero,MASTER I,27,15.9,94,15,79,lan
193,Farek,MASTER I,26,12.9,659,85,574,lan
194,Tengen Uzui,MASTER I,26,22.7,198,45,153,lan
195,Mahito,MASTER I,26,23.3,116,27,89,lan
196,BlitzDance,MASTER I,25,18.2,148,27,121,lan
197,Camipson,MASTER I,24,15.0,233,35,198,lan
198,ALXNIGHT,MASTER I,23,15.8,366,58,308,lan
199,elchicolinux,MASTER I,22,15.8,247,39,208,lan
200,Šęcręt Aurôrą,MASTER I,21,14.2,288,41,247,lan
1,FaryaAndWoIyo,CHALLENGER I,1768,29.5,349,103,246,las
2,Shireen4,CHALLENGER I,1682,27.0,507,137,370,las
3,Kłaytøn,CHALLENGER I,1637,24.6,410,101,309,las
4,Tolengo73,CHALLENGER I,1225,27.2,519,141,378,las
5,S de Sencillo,CHALLENGER I,1100,18.7,1355,253,1102,las
6,JustDream,CHALLENGER I,1099,17.7,913,162,751,las
7,DarksBit,CHALLENGER I,993,24.0,254,61,193,las
8,UCH TheLiNe,CHALLENGER I,983,31.0,261,81,180,las
9,No Quarter,CHALLENGER I,852,21.4,387,83,304,las
10,Altenahue,CHALLENGER I,833,22.9,488,112,376,las
11,Samenix,CHALLENGER I,811,27.4,285,78,207,las
12,Highroll,CHALLENGER I,802,20.2,649,131,518,las
13,Fourloko RX,CHALLENGER I,785,21.6,278,60,218,las
14,FuryTank,CHALLENGER I,768,21.7,327,71,256,las
15,Priend,CHALLENGER I,760,17.9,621,111,510,las
16,CooLDownJJ,CHALLENGER I,696,25.0,296,74,222,las
17,LifesBadTFT,CHALLENGER I,691,21.7,258,56,202,las
18,Fan de la Linea,CHALLENGER I,681,25.5,192,49,143,las
19,Christus,CHALLENGER I,600,29.7,148,44,104,las
20,Changuito 10,CHALLENGER I,576,21.2,193,41,152,las
21,shuuumpy,CHALLENGER I,568,19.9,413,82,331,las
22,Dukie,CHALLENGER I,538,20.0,185,37,148,las
23,New Stage,CHALLENGER I,523,19.1,324,62,262,las
24,Girlfromnoxuss,CHALLENGER I,522,20.1,623,125,498,las
25,Bugame,CHALLENGER I,504,22.6,221,50,171,las
26,UCH Morfer,CHALLENGER I,498,17.6,290,51,239,las
27,Jesus,CHALLENGER I,497,23.1,143,33,110,las
28,RoSweL TacTicS,CHALLENGER I,484,14.8,899,133,766,las
29,Greyd0n,CHALLENGER I,440,13.6,413,56,357,las
30,Karnal,CHALLENGER I,438,14.9,523,78,445,las
31,Åzok,CHALLENGER I,438,15.9,433,69,364,las
32,TFT MMR Perfect,CHALLENGER I,409,17.4,529,92,437,las
33,Wazapper,CHALLENGER I,393,16.2,320,52,268,las
34,Nico Del Baño,CHALLENGER I,377,26.1,153,40,113,las
35,ChakoPopoco,CHALLENGER I,376,15.3,469,72,397,las
36,Cupiditas,CHALLENGER I,373,20.1,304,61,243,las
37,xiomax,CHALLENGER I,369,16.5,334,55,279,las
38,InvadersMD,CHALLENGER I,366,16.1,727,117,610,las
39,Gara Arg,CHALLENGER I,365,18.6,402,75,327,las
40,sendohrai,CHALLENGER I,365,18.1,309,56,253,las
41,iudex Jevic,CHALLENGER I,361,17.7,729,129,600,las
42,AUGUSTOMARCO,CHALLENGER I,359,14.6,342,50,292,las
43,Lyked,CHALLENGER I,356,25.7,261,67,194,las
44,Rubik,CHALLENGER I,351,17.1,269,46,223,las
45,Gei Ye Si,CHALLENGER I,346,19.4,465,90,375,las
46,MorteMTW,CHALLENGER I,345,17.0,606,103,503,las
47,MättZ,CHALLENGER I,340,11.3,505,57,448,las
48,Fradox22,CHALLENGER I,332,21.3,188,40,148,las
49,ACÁ MANDO YO,CHALLENGER I,328,20.9,421,88,333,las
50,100cityfico,CHALLENGER I,298,11.2,473,53,420,las
51,ANIMEWEEBLORD420,"GRANDMASTER I
G",361,26.5,132,35,97,las
52,Mr GFS Reaper,"GRANDMASTER I
G",341,22.1,483,107,376,las
53,Emad Joestar,"GRANDMASTER I
G",341,18.0,211,38,173,las
54,ROH inSec t0,"GRANDMASTER I
G",317,14.4,422,61,361,las
55,404NameeNotFound,"GRANDMASTER I
G",307,16.3,510,83,427,las
56,StuPot,"GRANDMASTER I
G",302,17.3,294,51,243,las
57,Don Galli,"GRANDMASTER I
G",300,19.6,158,31,127,las
58,ElbalmoR,"GRANDMASTER I
G",299,17.2,290,50,240,las
59,Raruto,"GRANDMASTER I
G",297,13.8,268,37,231,las
60,BC Thoryn,"GRANDMASTER I
G",288,21.1,223,47,176,las
61,ssbita,"GRANDMASTER I
G",285,18.6,306,57,249,las
62,RNGPDD,"GRANDMASTER I
G",285,24.8,109,27,82,las
63,hartung,"GRANDMASTER I
G",284,16.1,354,57,297,las
64,Xork,"GRANDMASTER I
G",263,20.5,443,91,352,las
65,Tr1ckster,"GRANDMASTER I
G",253,29.7,111,33,78,las
66,Cvictoria Bryant,"GRANDMASTER I
G",248,16.2,470,76,394,las
67,iForeverBronze,"GRANDMASTER I
G",233,16.7,797,133,664,las
68,SouLXisT,"GRANDMASTER I
G",232,19.5,226,44,182,las
69,RetoSuperado,"GRANDMASTER I
G",222,15.5,349,54,295,las
70,TwitchTVLifesBad,"GRANDMASTER I
G",203,26.5,151,40,111,las
71,Ryuuk Kyuu,"GRANDMASTER I
G",202,15.0,167,25,142,las
72,HeRz BenT,"GRANDMASTER I
G",191,19.5,328,64,264,las
73,JueguenNormal,"GRANDMASTER I
G",187,14.9,469,70,399,las
74,geoffroy123,"GRANDMASTER I
G",186,14.5,145,21,124,las
75,TWOEASY,"GRANDMASTER I
G",160,13.7,262,36,226,las
76,Dogor,"GRANDMASTER I
G",157,16.2,283,46,237,las
77,Rekatria,"GRANDMASTER I
G",157,17.9,218,39,179,las
78,Kozukî Oden,"GRANDMASTER I
G",156,12.2,237,29,208,las
79,QT FD,"GRANDMASTER I
G",152,17.7,576,102,474,las
80,KenMasters7,"GRANDMASTER I
G",146,23.1,143,33,110,las
81,Ghosty321,"GRANDMASTER I
G",144,14.6,405,59,346,las
82,Zionooooo,"GRANDMASTER I
G",143,16.4,237,39,198,las
83,Óxidos Basicos,"GRANDMASTER I
G",141,16.3,288,47,241,las
84,BolaDeLomo,"GRANDMASTER I
G",141,15.5,296,46,250,las
85,Desgr4cia,"GRANDMASTER I
G",139,10.4,1012,105,907,las
86,DONBOMBASTIC,"GRANDMASTER I
G",137,16.8,274,46,228,las
87,Dtoke Freestyler,"GRANDMASTER I
G",132,13.9,454,63,391,las
88,TOXIAS,"GRANDMASTER I
G",131,17.1,187,32,155,las
89,el ayuwóki,"GRANDMASTER I
G",126,14.9,482,72,410,las
90,Danielove,"GRANDMASTER I
G",125,14.2,360,51,309,las
91,animesenpai2,"GRANDMASTER I
G",125,14.6,253,37,216,las
92,ACD Doomleg,"GRANDMASTER I
G",122,15.0,600,90,510,las
93,xZaMaSx,"GRANDMASTER I
G",122,16.4,366,60,306,las
94,CodMeiro,"GRANDMASTER I
G",122,15.1,312,47,265,las
95,LuckyDuit,"GRANDMASTER I
G",120,16.3,282,46,236,las
96,Gaattsu,"GRANDMASTER I
G",116,12.9,535,69,466,las
97,YourGod22,"GRANDMASTER I
G",116,12.5,248,31,217,las
98,xaimmer,"GRANDMASTER I
G",115,16.8,507,85,422,las
99,Elsa Nito,"GRANDMASTER I
G",107,14.3,434,62,372,las
100,NachoG95,"GRANDMASTER I
G",106,16.9,492,83,409,las
101,Masul,"GRANDMASTER I
G",103,18.4,321,59,262,las
102,CriXaLis,"GRANDMASTER I
G",101,17.9,431,77,354,las
103,zaqlev,"GRANDMASTER I
G",101,18.0,266,48,218,las
104,Broncelotee,"GRANDMASTER I
G",97,15.0,473,71,402,las
105,Peronism,"GRANDMASTER I
G",94,14.8,283,42,241,las
106,EMiguel,"GRANDMASTER I
G",94,20.8,168,35,133,las
107,Viangrele,"GRANDMASTER I
G",90,25.0,304,76,228,las
108,LOLEROPERONOPACO,"GRANDMASTER I
G",89,19.0,305,58,247,las
109,CuriousChameIeon,"GRANDMASTER I
G",88,20.5,415,85,330,las
110,ravenoneforeva,"GRANDMASTER I
G",88,20.8,313,65,248,las
111,toy chikita,"GRANDMASTER I
G",88,21.2,207,44,163,las
112,KTP Yoshi,"GRANDMASTER I
G",87,13.7,444,61,383,las
113,Sirzechsl,"GRANDMASTER I
G",87,13.2,416,55,361,las
114,henryqez,"GRANDMASTER I
G",87,16.1,328,53,275,las
115,Daelon TFT,"GRANDMASTER I
G",85,12.9,409,53,356,las
116,NOSABIAQUEPONE,"GRANDMASTER I
G",84,16.6,193,32,161,las
117,SlashFullMuteAll,"GRANDMASTER I
G",83,15.7,338,53,285,las
118,KeRikoWisKi,"GRANDMASTER I
G",82,15.2,270,41,229,las
119,Hardcorito Facho,"GRANDMASTER I
G",82,17.6,227,40,187,las
120,Tortuga Inmortal,"GRANDMASTER I
G",81,14.0,485,68,417,las
121,HuNnnTeR,"GRANDMASTER I
G",79,16.4,793,130,663,las
122,Dungeon,"GRANDMASTER I
G",79,16.2,383,62,321,las
123,ElnicoMata,"GRANDMASTER I
G",77,12.1,676,82,594,las
124,TU WAIFU ME AMA,"GRANDMASTER I
G",77,17.9,173,31,142,las
125,Shadow Ares,"GRANDMASTER I
G",77,16.0,156,25,131,las
126,iPurge1,"GRANDMASTER I
G",73,13.7,386,53,333,las
127,64 Bits,"GRANDMASTER I
G",73,13.7,233,32,201,las
128,Cv 366,"GRANDMASTER I
G",72,17.5,206,36,170,las
129,TheClasman,"GRANDMASTER I
G",66,14.6,412,60,352,las
130,UCH Koro,"GRANDMASTER I
G",65,17.4,344,60,284,las
131,Sáyron,"GRANDMASTER I
G",65,13.2,433,57,376,las
132,Luchiiitoo,"GRANDMASTER I
G",62,13.9,345,48,297,las
133,Crux,"GRANDMASTER I
G",61,15.5,348,54,294,las
134,Daian21,"GRANDMASTER I
G",61,8.4,403,34,369,las
135,skitifornia,"GRANDMASTER I
G",59,14.5,571,83,488,las
136,Xerwell,"GRANDMASTER I
G",59,15.1,404,61,343,las
137,Zeikana,"GRANDMASTER I
G",59,17.2,348,60,288,las
138,BTS TFT Player,"GRANDMASTER I
G",58,21.6,306,66,240,las
139,Necroshine77,"GRANDMASTER I
G",57,19.4,372,72,300,las
140,TheDanieTFT,"GRANDMASTER I
G",57,13.2,182,24,158,las
141,Lean Live,"GRANDMASTER I
G",56,14.2,331,47,284,las
142,WaIter White Jr,"GRANDMASTER I
G",55,13.2,417,55,362,las
143,psyque,"GRANDMASTER I
G",54,19.7,198,39,159,las
144,Tactics iBaggy,"GRANDMASTER I
G",54,14.8,230,34,196,las
145,Ola soi Smurf,"GRANDMASTER I
G",53,32.9,82,27,55,las
146,VortexN,"GRANDMASTER I
G",25,14.8,398,59,339,las
147,Beldum,"GRANDMASTER I
G",2,16.1,292,47,245,las
148,UCH StartNoob,"GRANDMASTER I
G",2,12.2,222,27,195,las
149,KravenPa,"GRANDMASTER I
G",0,17.0,430,73,357,las
150,Brooklyn Baby,MASTER I,84,24.7,158,39,119,las
151,xl Zero lx,MASTER I,80,12.4,717,89,628,las
152,IICelesteII,MASTER I,66,15.9,605,96,509,las
153,Best Teemo LAS,MASTER I,65,15.9,484,77,407,las
154,Sikolio,MASTER I,64,18.3,398,73,325,las
155,Heisnb3rg,MASTER I,64,19.4,206,40,166,las
156,MaurooCARP,MASTER I,55,17.8,236,42,194,las
157,SOY AGNÓSTICO,MASTER I,55,13.1,305,40,265,las
158,Lonkiwi,MASTER I,54,16.3,436,71,365,las
159,carkrod,MASTER I,52,14.6,678,99,579,las
160,Ledasor,MASTER I,52,21.0,224,47,177,las
161,TiagoAbner,MASTER I,51,13.3,294,39,255,las
162,Sadness Xiu,MASTER I,51,12.2,286,35,251,las
163,Keru,MASTER I,50,16.0,331,53,278,las
164,Penzio,MASTER I,50,13.2,273,36,237,las
165,spiirati,MASTER I,48,14.8,418,62,356,las
166,ElDryzler,MASTER I,45,11.7,377,44,333,las
167,Blasgare,MASTER I,45,9.1,340,31,309,las
168,Kamajuchi77,MASTER I,42,16.1,572,92,480,las
169,Error 402,MASTER I,42,14.4,208,30,178,las
170,El Palo Me Mama,MASTER I,41,19.8,182,36,146,las
171,OrangeMoon,MASTER I,37,18.7,925,173,752,las
172,T2W DOGORwashere,MASTER I,36,19.6,255,50,205,las
173,LIEUTENANT DAN,MASTER I,36,17.6,273,48,225,las
174,tft main lol,MASTER I,36,21.8,101,22,79,las
175,CisTHD,MASTER I,35,16.0,469,75,394,las
176,LioCR7,MASTER I,35,14.6,500,73,427,las
177,Riften,MASTER I,35,16.4,183,30,153,las
178,Wolf Bak,MASTER I,34,15.7,459,72,387,las
179,ikarosdesu,MASTER I,33,15.7,115,18,97,las
180,WWWWWWW,MASTER I,27,14.9,376,56,320,las
181,xikhario,MASTER I,26,16.3,331,54,277,las
182,HUAWEI AFeng,MASTER I,23,31.0,71,22,49,las
183,guitardead,MASTER I,22,18.2,209,38,171,las
184,Casi te gano,MASTER I,21,8.1,850,69,781,las
185,Trimsk,MASTER I,20,14.6,247,36,211,las
186,LL Jhin,MASTER I,20,15.8,184,29,155,las
187,Belfreath,MASTER I,19,12.2,294,36,258,las
188,MateDeCoco,MASTER I,19,16.8,208,35,173,las
189,UruSativaCarryJr,MASTER I,17,20.5,215,44,171,las
190,Twitch Jaypi9,MASTER I,16,16.1,719,116,603,las
191,1nstant Karma,MASTER I,16,15.4,369,57,312,las
192,Farnese,MASTER I,15,15.3,489,75,414,las
193,dimeloneri,MASTER I,15,12.6,325,41,284,las
194,Super Carlitos,MASTER I,14,11.9,552,66,486,las
195,Zoa,MASTER I,14,16.3,208,34,174,las
196,Hao,MASTER I,14,9.9,202,20,182,las
197,Laud,MASTER I,14,13.7,124,17,107,las
198,God DMZ,MASTER I,12,16.3,331,54,277,las
199,Kiroichy,MASTER I,12,21.3,230,49,181,las
200,Seminare,MASTER I,11,16.4,310,51,259,las
1,vx s5683169,CHALLENGER I,1081,24.4,406,99,307,oce
2,Angora,CHALLENGER I,995,26.2,351,92,259,oce
3,CombatEZ,CHALLENGER I,921,25.4,169,43,126,oce
4,KirinSupreme,CHALLENGER I,727,19.4,479,93,386,oce
5,Steve Lau,CHALLENGER I,619,21.8,907,198,709,oce
6,I Want You,CHALLENGER I,547,18.8,580,109,471,oce
7,ilikeud,CHALLENGER I,545,22.3,247,55,192,oce
8,Blender Main,CHALLENGER I,503,21.4,182,39,143,oce
9,HatsuneMik,CHALLENGER I,489,25.9,166,43,123,oce
10,Chatskiiees,CHALLENGER I,470,17.9,532,95,437,oce
11,dz2,CHALLENGER I,459,13.9,452,63,389,oce
12,JimJaam,CHALLENGER I,448,19.2,480,92,388,oce
13,stealmybuild TTV,CHALLENGER I,446,17.0,435,74,361,oce
14,jiaonizuodog,CHALLENGER I,442,18.7,664,124,540,oce
15,QWERXF,CHALLENGER I,431,20.9,306,64,242,oce
16,yuzhibo777,CHALLENGER I,416,19.5,359,70,289,oce
17,m2att,CHALLENGER I,396,14.8,1023,152,871,oce
18,Kïng Tryndamere,CHALLENGER I,379,18.0,428,77,351,oce
19,Last Wh1sper,CHALLENGER I,379,23.5,166,39,127,oce
20,ˇPhoenix,CHALLENGER I,378,23.6,317,75,242,oce
21,chinaLZH,CHALLENGER I,370,22.7,247,56,191,oce
22,MYdi,CHALLENGER I,369,17.6,352,62,290,oce
23,VNLunar,CHALLENGER I,368,14.1,341,48,293,oce
24,fengyingzhong,CHALLENGER I,367,24.6,122,30,92,oce
25,Bruceissss,CHALLENGER I,363,18.1,524,95,429,oce
26,oubo,CHALLENGER I,361,19.6,332,65,267,oce
27,Son Chae Young,CHALLENGER I,359,19.6,229,45,184,oce
28,dodododododododo,CHALLENGER I,356,20.5,1270,260,1010,oce
29,Jacky Xie,CHALLENGER I,353,22.5,404,91,313,oce
30,qp9,CHALLENGER I,344,15.3,360,55,305,oce
31,smsqs,CHALLENGER I,337,22.9,319,73,246,oce
32,Jack Griffin,CHALLENGER I,336,14.0,307,43,264,oce
33,WIld Sins Main,CHALLENGER I,329,15.1,325,49,276,oce
34,NayiGOJi,CHALLENGER I,324,19.5,277,54,223,oce
35,BeaBear,CHALLENGER I,317,17.1,334,57,277,oce
36,Slayer Bo,CHALLENGER I,315,17.5,308,54,254,oce
37,Cwute Panda,CHALLENGER I,311,16.9,450,76,374,oce
38,Rng28002200,CHALLENGER I,310,20.7,179,37,142,oce
39,MakinSomeBacon,CHALLENGER I,307,14.7,382,56,326,oce
40,lloydeee,CHALLENGER I,304,20.4,357,73,284,oce
41,Cyphos,CHALLENGER I,298,18.6,388,72,316,oce
42,plplplpp,CHALLENGER I,296,22.2,284,63,221,oce
43,3uphonium,CHALLENGER I,295,20.8,288,60,228,oce
44,thedashuaibi,CHALLENGER I,293,19.1,388,74,314,oce
45,lovestarrysky,CHALLENGER I,292,17.1,533,91,442,oce
46,Damon989,CHALLENGER I,290,19.1,199,38,161,oce
47,sorryimlikethis,CHALLENGER I,287,24.0,275,66,209,oce
48,Heart1ess,CHALLENGER I,286,20.1,264,53,211,oce
49,LongYu66,CHALLENGER I,285,17.7,328,58,270,oce
50,zhuodaye,CHALLENGER I,213,16.9,373,63,310,oce
51,ihjkljg,"GRANDMASTER I
G",295,16.5,243,40,203,oce
52,Escha,"GRANDMASTER I
G",293,13.8,610,84,526,oce
53,samesame,"GRANDMASTER I
G",274,13.5,466,63,403,oce
54,Just Mango,"GRANDMASTER I
G",268,21.5,316,68,248,oce
55,xg1998,"GRANDMASTER I
G",264,16.8,197,33,164,oce
56,Haober,"GRANDMASTER I
G",262,26.2,160,42,118,oce
57,6324ii,"GRANDMASTER I
G",261,27.6,134,37,97,oce
58,zhuweiran,"GRANDMASTER I
G",256,16.5,399,66,333,oce
59,Maxilees,"GRANDMASTER I
G",252,16.3,208,34,174,oce
60,Law of the few,"GRANDMASTER I
G",250,13.7,663,91,572,oce
61,zofou,"GRANDMASTER I
G",249,17.4,414,72,342,oce
62,1ydia233,"GRANDMASTER I
G",244,23.3,120,28,92,oce
63,PPAP,"GRANDMASTER I
G",242,13.4,335,45,290,oce
64,Madnsss,"GRANDMASTER I
G",225,18.6,226,42,184,oce
65,Reborn Myth,"GRANDMASTER I
G",222,12.5,449,56,393,oce
66,YILINHHH,"GRANDMASTER I
G",218,15.7,351,55,296,oce
67,ggds4y,"GRANDMASTER I
G",209,16.3,374,61,313,oce
68,jieshao211,"GRANDMASTER I
G",208,18.1,193,35,158,oce
69,Dunk xiaolu,"GRANDMASTER I
G",205,16.8,453,76,377,oce
70,zhangtao666,"GRANDMASTER I
G",204,23.2,151,35,116,oce
71,Fischball,"GRANDMASTER I
G",202,18.8,192,36,156,oce
72,1234mutouren,"GRANDMASTER I
G",198,21.3,94,20,74,oce
73,TonystarkIRON,"GRANDMASTER I
G",195,25.2,127,32,95,oce
74,Jukelord,"GRANDMASTER I
G",194,14.6,314,46,268,oce
75,guangdongfoshan,"GRANDMASTER I
G",193,20.6,160,33,127,oce
76,Laotie Letsgo,"GRANDMASTER I
G",189,25.0,148,37,111,oce
77,Fallangle,"GRANDMASTER I
G",187,18.6,199,37,162,oce
78,jffhjjir,"GRANDMASTER I
G",186,23.7,152,36,116,oce
79,TheExpIosiveTaco,"GRANDMASTER I
G",185,15.3,228,35,193,oce
80,GiveMeGunS,"GRANDMASTER I
G",182,16.9,201,34,167,oce
81,roflwhatever,"GRANDMASTER I
G",178,26.6,128,34,94,oce
82,Yuki0720,"GRANDMASTER I
G",172,12.3,413,51,362,oce
83,dxapple,"GRANDMASTER I
G",170,15.6,237,37,200,oce
84,DonAlternate,"GRANDMASTER I
G",167,20.5,322,66,256,oce
85,vx1123913246,"GRANDMASTER I
G",163,15.8,511,81,430,oce
86,HanDaY,"GRANDMASTER I
G",163,20.0,255,51,204,oce
87,Jinsang,"GRANDMASTER I
G",163,16.9,254,43,211,oce
88,CampBishop,"GRANDMASTER I
G",154,20.8,255,53,202,oce
89,WU YAN ZZU,"GRANDMASTER I
G",153,14.1,319,45,274,oce
90,yundingle,"GRANDMASTER I
G",149,22.3,188,42,146,oce
91,3sansansan,"GRANDMASTER I
G",143,18.3,438,80,358,oce
92,Mounty,"GRANDMASTER I
G",136,12.3,579,71,508,oce
93,aa1816,"GRANDMASTER I
G",135,16.0,275,44,231,oce
94,CLMEpapa,"GRANDMASTER I
G",134,17.6,323,57,266,oce
95,Mascot,"GRANDMASTER I
G",132,12.4,275,34,241,oce
96,hjhukbt,"GRANDMASTER I
G",129,16.6,331,55,276,oce
97,xinya45,"GRANDMASTER I
G",127,18.8,452,85,367,oce
98,WayneToDieeeeeee,"GRANDMASTER I
G",125,26.8,157,42,115,oce
99,aksidhhdid,"GRANDMASTER I
G",123,16.7,510,85,425,oce
100,Maraudaur,"GRANDMASTER I
G",121,15.9,560,89,471,oce
101,cococake,"GRANDMASTER I
G",120,14.4,353,51,302,oce
102,WO DongDongDong,"GRANDMASTER I
G",120,13.0,392,51,341,oce
103,Lethal Zedstarr,"GRANDMASTER I
G",119,11.5,494,57,437,oce
104,knlght999,"GRANDMASTER I
G",119,19.0,189,36,153,oce
105,dilisiad,"GRANDMASTER I
G",117,23.3,176,41,135,oce
106,why zyh and pipi,"GRANDMASTER I
G",117,14.3,287,41,246,oce
107,SilencedbymySins,"GRANDMASTER I
G",115,17.7,147,26,121,oce
108,Fwuffy Panda,"GRANDMASTER I
G",113,23.4,201,47,154,oce
109,Age of Empires 3,"GRANDMASTER I
G",111,14.0,457,64,393,oce
110,fanfanbaby,"GRANDMASTER I
G",110,29.4,102,30,72,oce
111,Letme11,"GRANDMASTER I
G",109,14.9,316,47,269,oce
112,Rainbow Baby huh,"GRANDMASTER I
G",109,13.6,242,33,209,oce
113,ImaginaryDragons,"GRANDMASTER I
G",108,11.7,163,19,144,oce
114,AngelMuzi,"GRANDMASTER I
G",107,21.3,155,33,122,oce
115,Whisper9897,"GRANDMASTER I
G",105,16.3,141,23,118,oce
116,ding1978,"GRANDMASTER I
G",103,16.4,237,39,198,oce
117,huozhigaoxin,"GRANDMASTER I
G",102,16.8,238,40,198,oce
118,Jum,"GRANDMASTER I
G",97,16.7,215,36,179,oce
119,PVC Cai,"GRANDMASTER I
G",95,11.7,420,49,371,oce
120,ANTIQUE HEALBOT,"GRANDMASTER I
G",94,15.6,347,54,293,oce
121,TheRealDirtyDan,"GRANDMASTER I
G",92,11.0,454,50,404,oce
122,kuaileyouxi,"GRANDMASTER I
G",92,23.4,167,39,128,oce
123,free57,"GRANDMASTER I
G",92,32.3,96,31,65,oce
124,Jenry,"GRANDMASTER I
G",90,13.3,188,25,163,oce
125,Side Character,"GRANDMASTER I
G",87,12.9,363,47,316,oce
126,Mo poisoness,"GRANDMASTER I
G",86,18.3,415,76,339,oce
127,txtx233,"GRANDMASTER I
G",86,16.7,269,45,224,oce
128,TooBreezy,"GRANDMASTER I
G",83,13.6,191,26,165,oce
129,mahui521,"GRANDMASTER I
G",78,17.1,310,53,257,oce
130,aicmg11111,"GRANDMASTER I
G",74,26.4,91,24,67,oce
131,RedHawk101,"GRANDMASTER I
G",72,21.8,354,77,277,oce
132,bankaiteam,"GRANDMASTER I
G",72,17.1,281,48,233,oce
133,okhaige,"GRANDMASTER I
G",72,13.0,315,41,274,oce
134,king0247,"GRANDMASTER I
G",71,19.6,276,54,222,oce
135,qkkaannuu,"GRANDMASTER I
G",71,13.7,380,52,328,oce
136,bingmoyan,"GRANDMASTER I
G",68,16.8,411,69,342,oce
137,amazingccc,"GRANDMASTER I
G",66,19.9,156,31,125,oce
138,AiryLaMenteuse,"GRANDMASTER I
G",66,15.0,206,31,175,oce
139,DarthRoshan,"GRANDMASTER I
G",65,14.1,354,50,304,oce
140,WnLyKingKK,"GRANDMASTER I
G",64,16.0,661,106,555,oce
141,Wo Tai Nan Le,"GRANDMASTER I
G",64,14.5,606,88,518,oce
142,dier306,"GRANDMASTER I
G",63,18.5,119,22,97,oce
143,Toby,"GRANDMASTER I
G",62,11.6,251,29,222,oce
144,dnn,"GRANDMASTER I
G",61,17.1,586,100,486,oce
145,Ni Bie ZouWei le,"GRANDMASTER I
G",59,18.4,653,120,533,oce
146,huya21063703,"GRANDMASTER I
G",57,16.9,166,28,138,oce
147,01 04 1999,"GRANDMASTER I
G",34,19.4,196,38,158,oce
148,xiaozhiZP,"GRANDMASTER I
G",20,17.3,417,72,345,oce
149,liontiger,"GRANDMASTER I
G",16,24.3,136,33,103,oce
150,sanxingcaixukun,"GRANDMASTER I
G",0,13.4,688,92,596,oce
151,orymdzz,MASTER I,174,18.6,263,49,214,oce
152,zhouyinuo,MASTER I,122,17.7,243,43,200,oce
153,wuzyu123,MASTER I,108,28.9,76,22,54,oce
154,CLUBCANTHANDLEME,MASTER I,100,16.5,321,53,268,oce
155,Member,MASTER I,79,13.8,246,34,212,oce
156,CterMinh,MASTER I,73,12.4,435,54,381,oce
157,xianqishenjiangl,MASTER I,69,17.2,366,63,303,oce
158,k9night,MASTER I,68,17.5,229,40,189,oce
159,jiushishen,MASTER I,66,20.2,168,34,134,oce
160,zyoona,MASTER I,63,15.5,400,62,338,oce
161,BlueRose134,MASTER I,59,14.4,402,58,344,oce
162,ASJD957,MASTER I,59,18.9,249,47,202,oce
163,wanmgc,MASTER I,59,11.7,324,38,286,oce
164,Whitelight,MASTER I,59,22.5,102,23,79,oce
165,821,MASTER I,57,14.8,332,49,283,oce
166,vhugggg,MASTER I,57,10.8,380,41,339,oce
167,styllll,MASTER I,57,15.8,215,34,181,oce
168,BiscottiSwarls,MASTER I,56,13.6,346,47,299,oce
169,keljiw,MASTER I,56,18.7,155,29,126,oce
170,IllIIIll,MASTER I,55,15.9,151,24,127,oce
171,Tactics GOD,MASTER I,52,19.9,216,43,173,oce
172,ssjfirzen,MASTER I,50,11.7,1564,183,1381,oce
173,chenshaqi,MASTER I,50,17.0,165,28,137,oce
174,leiloveyang,MASTER I,49,20.1,254,51,203,oce
175,weiningyuan,MASTER I,46,20.3,148,30,118,oce
176,fapaiyuanwm,MASTER I,46,18.8,117,22,95,oce
177,Dwyan3 Wade,MASTER I,45,14.6,419,61,358,oce
178,wggrggt,MASTER I,45,23.7,114,27,87,oce
179,sunshinellll,MASTER I,44,20.7,111,23,88,oce
180,callbobo,MASTER I,44,30.6,72,22,50,oce
181,haoxintai,MASTER I,42,18.1,177,32,145,oce
182,aozhourenmeimama,MASTER I,42,25.7,101,26,75,oce
183,jaming,MASTER I,42,15.9,145,23,122,oce
184,YUKINO013,MASTER I,41,14.1,327,46,281,oce
185,Forget,MASTER I,41,18.9,185,35,150,oce
186,peppa demon,MASTER I,41,20.0,150,30,120,oce
187,Nekkiiiii,MASTER I,40,11.5,357,41,316,oce
188,eeadea,MASTER I,40,17.5,183,32,151,oce
189,shinlove311,MASTER I,39,18.1,149,27,122,oce
190,Lógic,MASTER I,38,18.2,253,46,207,oce
191,assqbqqq,MASTER I,37,14.8,345,51,294,oce
192,bbllff,MASTER I,36,16.4,293,48,245,oce
193,wangmiss,MASTER I,36,20.3,217,44,173,oce
194,zhenyoudianshuai,MASTER I,36,20.9,191,40,151,oce
195,Mikkey,MASTER I,36,14.3,279,40,239,oce
196,RKGG,MASTER I,36,15.5,232,36,196,oce
197,hemoumouya,MASTER I,35,28.6,140,40,100,oce
198,An arurf player,MASTER I,34,10.4,374,39,335,oce
199,uwggwuwhll,MASTER I,33,16.6,302,50,252,oce
200,woshizhong,MASTER I,33,16.6,229,38,191,oce
1,kinqmusti43,CHALLENGER I,1562,25.4,527,134,393,tr
2,Rubic,CHALLENGER I,1536,26.6,647,172,475,tr
3,MAD JOSEPH,CHALLENGER I,1146,19.8,651,129,522,tr
4,speedruzlol,CHALLENGER I,1139,24.5,445,109,336,tr
5,MAD JOSEPH 2,CHALLENGER I,962,25.0,300,75,225,tr
6,Ayenbe,CHALLENGER I,861,26.6,267,71,196,tr
7,Benedetto,CHALLENGER I,827,22.6,332,75,257,tr
8,Stay ruthless,CHALLENGER I,780,27.5,781,215,566,tr
9,jan uma,CHALLENGER I,645,21.8,252,55,197,tr
10,keLch,CHALLENGER I,631,22.6,349,79,270,tr
11,Jok3r xx,CHALLENGER I,556,22.0,304,67,237,tr
12,Perceid TFT,CHALLENGER I,556,26.2,149,39,110,tr
13,NİZİPLİİİ,CHALLENGER I,536,21.7,890,193,697,tr
14,Jenerik,CHALLENGER I,495,22.3,256,57,199,tr
15,bestâ,CHALLENGER I,486,21.5,367,79,288,tr
16,Daldım Kazdım,CHALLENGER I,480,22.7,286,65,221,tr
17,Darksword02,CHALLENGER I,479,16.3,790,129,661,tr
18,Liquidzer,CHALLENGER I,472,18.4,452,83,369,tr
19,MAC MASCARA,CHALLENGER I,471,14.8,595,88,507,tr
20,SİVASLI PONÇİK,CHALLENGER I,468,16.0,337,54,283,tr
21,Jthie,CHALLENGER I,467,20.9,258,54,204,tr
22,Jonas Salk,CHALLENGER I,466,11.8,599,71,528,tr
23,lAdastra,CHALLENGER I,460,19.9,548,109,439,tr
24,GreatEagle,CHALLENGER I,456,18.7,390,73,317,tr
25,Waiden,CHALLENGER I,450,18.3,834,153,681,tr
26,clssJaGG,CHALLENGER I,438,15.2,725,110,615,tr
27,Morte D Amour,CHALLENGER I,416,16.4,651,107,544,tr
28,SunChos,CHALLENGER I,410,14.8,985,146,839,tr
29,TFT Colorâblê,CHALLENGER I,409,16.9,213,36,177,tr
30,TFT Colorâblê v2,CHALLENGER I,398,15.2,230,35,195,tr
31,ŁuciâN,CHALLENGER I,395,14.0,349,49,300,tr
32,FeelingTheBlanks,CHALLENGER I,393,11.9,480,57,423,tr
33,MUHENDİSBEY TFT,CHALLENGER I,391,17.4,409,71,338,tr
34,mettuzwee,CHALLENGER I,386,25.6,180,46,134,tr
35,Slay,CHALLENGER I,385,21.1,251,53,198,tr
36,Meglendiel,CHALLENGER I,383,17.0,712,121,591,tr
37,11 04 2004,CHALLENGER I,383,14.7,498,73,425,tr
38,Shinzu,CHALLENGER I,377,10.2,502,51,451,tr
39,NEXTENAAA,CHALLENGER I,374,18.7,257,48,209,tr
40,Nîtratex,CHALLENGER I,366,10.6,407,43,364,tr
41,sefaFluxx,CHALLENGER I,365,19.1,953,182,771,tr
42,zikerr,CHALLENGER I,361,14.8,526,78,448,tr
43,BrushLeee,CHALLENGER I,335,15.5,174,27,147,tr
44,Top 8,CHALLENGER I,327,24.7,259,64,195,tr
45,THE BOSS PALA,CHALLENGER I,326,13.6,360,49,311,tr
46,StahpItRito v2,CHALLENGER I,321,21.8,174,38,136,tr
47,StahpItRito,CHALLENGER I,314,25.7,183,47,136,tr
48,Discronatia,CHALLENGER I,311,16.7,323,54,269,tr
49,Rapscallion FK,CHALLENGER I,306,21.1,470,99,371,tr
50,Spanker HS,CHALLENGER I,305,20.3,552,112,440,tr
51,Phoebe,"GRANDMASTER I
G",320,19.3,384,74,310,tr
52,Skinner27,"GRANDMASTER I
G",305,22.1,145,32,113,tr
53,Troll Bir Nick,"GRANDMASTER I
G",298,19.1,873,167,706,tr
54,TFT Ołrïc,"GRANDMASTER I
G",288,13.6,213,29,184,tr
55,No Life Ceset,"GRANDMASTER I
G",279,17.8,691,123,568,tr
56,Furriya,"GRANDMASTER I
G",278,18.5,254,47,207,tr
57,9x37,"GRANDMASTER I
G",260,14.5,606,88,518,tr
58,TEOİSTİK,"GRANDMASTER I
G",259,13.6,330,45,285,tr
59,ƒallenGod,"GRANDMASTER I
G",219,20.0,310,62,248,tr
60,SUQ MADİK,"GRANDMASTER I
G",216,18.9,238,45,193,tr
61,ŹéÐáñìêłš,"GRANDMASTER I
G",202,13.5,683,92,591,tr
62,Sayonara Baby,"GRANDMASTER I
G",197,11.9,902,107,795,tr
63,Kemal KS,"GRANDMASTER I
G",186,15.9,673,107,566,tr
64,ÇokTaRinTinTinV2,"GRANDMASTER I
G",178,18.5,405,75,330,tr
65,Luca Toni,"GRANDMASTER I
G",174,16.9,242,41,201,tr
66,Punaise,"GRANDMASTER I
G",167,12.3,1132,139,993,tr
67,play for a fun,"GRANDMASTER I
G",167,18.3,251,46,205,tr
68,Bir Spartalı,"GRANDMASTER I
G",162,17.4,270,47,223,tr
69,ATC Bulbasaur,"GRANDMASTER I
G",161,17.1,245,42,203,tr
70,qR Kai Hiwatari,"GRANDMASTER I
G",160,11.1,343,38,305,tr
71,Prenses Irelia,"GRANDMASTER I
G",156,13.9,567,79,488,tr
72,caglar128,"GRANDMASTER I
G",153,13.3,225,30,195,tr
73,canadianturkey,"GRANDMASTER I
G",151,24.4,172,42,130,tr
74,Jâsper,"GRANDMASTER I
G",150,18.5,178,33,145,tr
75,itsAƒucknComedy,"GRANDMASTER I
G",148,15.3,255,39,216,tr
76,Hyperr roll babe,"GRANDMASTER I
G",147,19.8,116,23,93,tr
77,Beramusluu TFT,"GRANDMASTER I
G",140,15.4,466,72,394,tr
78,Groove Street CJ,"GRANDMASTER I
G",140,11.3,539,61,478,tr
79,My0neSS,"GRANDMASTER I
G",137,17.5,867,152,715,tr
80,Kral Leonidass,"GRANDMASTER I
G",137,13.6,826,112,714,tr
81,GotchaAssBoy,"GRANDMASTER I
G",129,25.8,120,31,89,tr
82,valiumx,"GRANDMASTER I
G",127,12.0,933,112,821,tr
83,Motosho,"GRANDMASTER I
G",125,20.1,249,50,199,tr
84,Dr Manhattan,"GRANDMASTER I
G",124,20.8,240,50,190,tr
85,slowly sari,"GRANDMASTER I
G",124,17.1,286,49,237,tr
86,TheBigWal,"GRANDMASTER I
G",123,12.1,224,27,197,tr
87,Boxerli Arap,"GRANDMASTER I
G",121,23.3,270,63,207,tr
88,Kara Sevdalım,"GRANDMASTER I
G",117,19.1,681,130,551,tr
89,Sağtık CEBO,"GRANDMASTER I
G",115,10.9,457,50,407,tr
90,Riven İs Mine,"GRANDMASTER I
G",108,17.7,265,47,218,tr
91,Berke İnan,"GRANDMASTER I
G",106,16.6,265,44,221,tr
92,asvpxtitan,"GRANDMASTER I
G",105,14.0,673,94,579,tr
93,Ragyo,"GRANDMASTER I
G",104,17.2,835,144,691,tr
94,Plug,"GRANDMASTER I
G",104,16.4,384,63,321,tr
95,Sir BÂGÎ,"GRANDMASTER I
G",102,12.1,372,45,327,tr
96,ForyuS,"GRANDMASTER I
G",101,10.6,922,98,824,tr
97,KÜNEFE,"GRANDMASTER I
G",101,15.6,243,38,205,tr
98,Seyfi Baba QQ,"GRANDMASTER I
G",99,18.0,645,116,529,tr
99,Xaviertz,"GRANDMASTER I
G",93,17.7,402,71,331,tr
100,T H O S U N,"GRANDMASTER I
G",93,16.8,202,34,168,tr
101,ResqueL,"GRANDMASTER I
G",91,19.9,206,41,165,tr
102,TEKSİN,"GRANDMASTER I
G",87,15.5,401,62,339,tr
103,MrDdad,"GRANDMASTER I
G",86,20.1,377,76,301,tr
104,Pressure Fatih,"GRANDMASTER I
G",84,16.9,189,32,157,tr
105,elyêl,"GRANDMASTER I
G",83,22.1,497,110,387,tr
106,wraıth slayer,"GRANDMASTER I
G",81,16.1,224,36,188,tr
107,Castiel2897,"GRANDMASTER I
G",79,17.9,273,49,224,tr
108,ImCurly,"GRANDMASTER I
G",77,16.5,643,106,537,tr
109,Apo sen misin la,"GRANDMASTER I
G",75,17.3,330,57,273,tr
110,ReachijaX,"GRANDMASTER I
G",73,13.3,825,110,715,tr
111,OgUzhan22,"GRANDMASTER I
G",73,14.2,677,96,581,tr
112,CacaReyiz1907,"GRANDMASTER I
G",71,13.2,714,94,620,tr
113,Maegi,"GRANDMASTER I
G",70,17.3,336,58,278,tr
114,Gollum TFT,"GRANDMASTER I
G",69,16.6,458,76,382,tr
115,Im Ventum,"GRANDMASTER I
G",69,10.1,396,40,356,tr
116,cropovez,"GRANDMASTER I
G",68,12.7,221,28,193,tr
117,BBang,"GRANDMASTER I
G",63,12.6,748,94,654,tr
118,xTCxINFLAMES,"GRANDMASTER I
G",61,10.2,463,47,416,tr
119,BeeepbeepimaJeep,"GRANDMASTER I
G",61,15.4,214,33,181,tr
120,Nerva,"GRANDMASTER I
G",60,14.0,214,30,184,tr
121,AxiBy,"GRANDMASTER I
G",58,14.9,584,87,497,tr
122,EazyPz,"GRANDMASTER I
G",58,22.3,269,60,209,tr
123,ISGT PeaceI,"GRANDMASTER I
G",57,15.2,145,22,123,tr
124,Ruheass,"GRANDMASTER I
G",56,17.9,448,80,368,tr
125,WestosTFT,"GRANDMASTER I
G",55,10.5,332,35,297,tr
126,THEPRAT,"GRANDMASTER I
G",53,11.7,403,47,356,tr
127,xlProDRoMaLlx,"GRANDMASTER I
G",49,15.9,214,34,180,tr
128,KimbuLeyla,"GRANDMASTER I
G",49,16.8,149,25,124,tr
129,Thanos Pyke,"GRANDMASTER I
G",48,16.0,356,57,299,tr
130,Coria,"GRANDMASTER I
G",48,15.0,373,56,317,tr
131,N0NNstar,"GRANDMASTER I
G",47,16.7,442,74,368,tr
132,Reis Back,"GRANDMASTER I
G",47,12.3,341,42,299,tr
133,mFatality,"GRANDMASTER I
G",46,12.6,538,68,470,tr
134,SSW,"GRANDMASTER I
G",45,13.6,1192,162,1030,tr
135,Nö1 TFT,"GRANDMASTER I
G",45,13.4,357,48,309,tr
136,Rykes,"GRANDMASTER I
G",45,17.0,265,45,220,tr
137,hi im KeNji ea,"GRANDMASTER I
G",43,13.3,776,103,673,tr
138,ÇopurBey,"GRANDMASTER I
G",41,11.5,859,99,760,tr
139,Usta Splinterr,"GRANDMASTER I
G",40,13.6,228,31,197,tr
140,bertugrul,"GRANDMASTER I
G",39,19.9,241,48,193,tr
141,caydas,"GRANDMASTER I
G",38,16.5,613,101,512,tr
142,Irrepressible,"GRANDMASTER I
G",38,17.6,261,46,215,tr
143,TFT Orfane,"GRANDMASTER I
G",37,17.5,332,58,274,tr
144,DT Escanor,"GRANDMASTER I
G",37,15.0,253,38,215,tr
145,Durp,"GRANDMASTER I
G",37,19.2,161,31,130,tr
146,Doğay,"GRANDMASTER I
G",36,18.9,249,47,202,tr
147,ll Mr Yılmâz TFT,"GRANDMASTER I
G",35,15.2,407,62,345,tr
148,ÜSTADIM,"GRANDMASTER I
G",35,12.1,281,34,247,tr
149,MhmtAkgl,"GRANDMASTER I
G",0,13.3,602,80,522,tr
150,Ağlak Kebir,"GRANDMASTER I
G",0,13.7,183,25,158,tr
151,LordCampus,MASTER I,32,18.9,307,58,249,tr
152,veifanN,MASTER I,31,24.6,244,60,184,tr
153,Boşver,MASTER I,30,18.3,459,84,375,tr
154,sads,MASTER I,30,15.7,511,80,431,tr
155,blobfısh,MASTER I,30,14.4,327,47,280,tr
156,Terryfold,MASTER I,29,24.3,115,28,87,tr
157,IamSonGoku,MASTER I,27,13.8,486,67,419,tr
158,SKT X,MASTER I,27,12.3,447,55,392,tr
159,John Scatt,MASTER I,26,17.0,112,19,93,tr
160,MertTFT,MASTER I,23,12.9,341,44,297,tr
161,AsiTatanqa,MASTER I,23,11.8,365,43,322,tr
162,serseratx,MASTER I,23,15.0,253,38,215,tr
163,diwine fish,MASTER I,23,20.2,163,33,130,tr
164,TFT CEBO,MASTER I,23,14.6,158,23,135,tr
165,IV Sentinel,MASTER I,22,17.6,523,92,431,tr
166,CHEF CUKKA,MASTER I,22,9.8,533,52,481,tr
167,SauirasSalviaa,MASTER I,20,13.5,939,127,812,tr
168,Beysal,MASTER I,19,23.1,208,48,160,tr
169,Prince Rhaegar,MASTER I,19,12.2,302,37,265,tr
170,idlemonkk,MASTER I,18,20.6,398,82,316,tr
171,hknelmsua,MASTER I,18,19.9,221,44,177,tr
172,İqos,MASTER I,17,21.5,321,69,252,tr
173,HattoriZarbo,MASTER I,17,15.7,306,48,258,tr
174,UnknownZ7,MASTER I,17,16.7,203,34,169,tr
175,ArcHaic,MASTER I,16,18.6,231,43,188,tr
176,KaanGultekin,MASTER I,16,20.4,176,36,140,tr
177,artyomdh,MASTER I,16,19.9,136,27,109,tr
178,KÓÐ ÃÐI ŻÉÐ,MASTER I,15,16.5,339,56,283,tr
179,BABALARIN AHMET,MASTER I,14,13.8,470,65,405,tr
180,TRANSFOURGOT,MASTER I,14,8.2,218,18,200,tr
181,No Pasaran1917,MASTER I,13,19.6,179,35,144,tr
182,Necessarium,MASTER I,11,13.9,237,33,204,tr
183,AcviLion,MASTER I,9,16.8,447,75,372,tr
184,BEN THRESH NABER,MASTER I,9,12.3,220,27,193,tr
185,Srcnym,MASTER I,8,18.2,285,52,233,tr
186,AdnantalhaV,MASTER I,8,20.2,233,47,186,tr
187,Peredhil,MASTER I,7,12.8,305,39,266,tr
188,Swarles Barkley,MASTER I,7,27.7,101,28,73,tr
189,IIIMeA CuLpAIII,MASTER I,7,15.9,176,28,148,tr
190,Fenrîr,MASTER I,6,14.1,474,67,407,tr
191,AçılnBenDokturm,MASTER I,6,16.5,261,43,218,tr
192,PARA,MASTER I,6,17.4,224,39,185,tr
193,Qyrieq,MASTER I,6,9.1,242,22,220,tr
194,BarRraK,MASTER I,5,16.5,218,36,182,tr
195,Simurg TFT,MASTER I,5,21.6,162,35,127,tr
196,Bihter ZiyagiI,MASTER I,3,13.3,622,83,539,tr
197,ecivecivokkemj,MASTER I,3,21.2,165,35,130,tr
198,Mutsuz,MASTER I,3,13.6,198,27,171,tr
199,WhackyLuck,MASTER I,2,16.1,477,77,400,tr
200,AshleyG,MASTER I,2,12.3,551,68,483,tr
1,KroniiinepTFT,CHALLENGER I,908,27.9,355,99,256,ru
2,aLeProfane,CHALLENGER I,792,26.2,378,99,279,ru
3,HORNIE MY BABY,CHALLENGER I,772,33.5,260,87,173,ru
4,Dyachello,CHALLENGER I,747,20.6,398,82,316,ru
5,chmochma,CHALLENGER I,740,24.8,303,75,228,ru
6,Nycteus,CHALLENGER I,640,23.0,217,50,167,ru
7,kobeyang,CHALLENGER I,620,28.8,546,157,389,ru
8,LMS trojancbkui,CHALLENGER I,575,14.7,592,87,505,ru
9,WuHan jiayou,CHALLENGER I,569,28.1,224,63,161,ru
10,МRAZIverniteNICK,CHALLENGER I,440,26.5,355,94,261,ru
11,superworldRU,CHALLENGER I,397,19.7,376,74,302,ru
12,Yablo4niy,CHALLENGER I,395,24.9,185,46,139,ru
13,DespicabIe,CHALLENGER I,369,25.2,294,74,220,ru
14,L9 Rengy,CHALLENGER I,367,17.6,541,95,446,ru
15,kiiller,CHALLENGER I,337,18.6,210,39,171,ru
16,Marijuanamama,CHALLENGER I,322,15.7,351,55,296,ru
17,Тяньци,CHALLENGER I,322,21.5,186,40,146,ru
18,Theblueboy,CHALLENGER I,312,30.0,200,60,140,ru
19,Hardrinnz,CHALLENGER I,308,30.0,150,45,105,ru
20,DrKaktys,CHALLENGER I,297,17.4,195,34,161,ru
21,KENGBI,CHALLENGER I,291,20.0,509,102,407,ru
22,NMЯ NO ИМЯ,CHALLENGER I,268,20.2,312,63,249,ru
23,CNGOOD,CHALLENGER I,247,24.5,257,63,194,ru
24,NeverTrustSoloQ,CHALLENGER I,232,24.4,197,48,149,ru
25,Авиатор Платонов,CHALLENGER I,221,24.9,333,83,250,ru
26,Zauberbiest,CHALLENGER I,219,17.9,262,47,215,ru
27,Không Có Link,CHALLENGER I,198,17.4,596,104,492,ru
28,Светофорчик,CHALLENGER I,196,26.4,250,66,184,ru
29,JoSmog,CHALLENGER I,195,15.9,615,98,517,ru
30,FIMA,CHALLENGER I,195,21.9,246,54,192,ru
31,CNGOOD1,CHALLENGER I,195,21.6,232,50,182,ru
32,VN iRabity,CHALLENGER I,185,19.8,647,128,519,ru
33,Sacred Nоrris,CHALLENGER I,172,14.1,1357,192,1165,ru
34,Sоul Reaver,CHALLENGER I,165,20.8,183,38,145,ru
35,Programmer,CHALLENGER I,161,16.5,212,35,177,ru
36,ENDEAVOUR,CHALLENGER I,156,18.6,307,57,250,ru
37,ìnsane,CHALLENGER I,151,20.3,300,61,239,ru
38,e 1,CHALLENGER I,149,17.8,353,63,290,ru
39,Legenda of LOL,CHALLENGER I,145,13.2,340,45,295,ru
40,Iggi 1TrickPferd,CHALLENGER I,136,27.4,168,46,122,ru
41,Mark of uroboros,CHALLENGER I,132,21.7,968,210,758,ru
42,Torianos,CHALLENGER I,132,11.9,594,71,523,ru
43,Kahzoo is KING,CHALLENGER I,127,32.4,102,33,69,ru
44,Кисюня,CHALLENGER I,125,27.8,108,30,78,ru
45,Long live China,CHALLENGER I,120,18.1,276,50,226,ru
46,fantik999,CHALLENGER I,119,16.2,173,28,145,ru
47,Paprika,CHALLENGER I,118,20.9,172,36,136,ru
48,Bingo123456,CHALLENGER I,107,17.7,373,66,307,ru
49,Kapibaro,CHALLENGER I,101,23.5,344,81,263,ru
50,BEASTMXDE,CHALLENGER I,99,18.7,375,70,305,ru
51,Sebastian7,"GRANDMASTER I
G",84,21.8,239,52,187,ru
52,PeiPei,"GRANDMASTER I
G",71,13.0,478,62,416,ru
53,lza,"GRANDMASTER I
G",69,21.4,201,43,158,ru
54,Sapfer,"GRANDMASTER I
G",68,17.3,496,86,410,ru
55,LegendsNeverDIE0,"GRANDMASTER I
G",58,23.5,277,65,212,ru
56,BomBibomXD,"GRANDMASTER I
G",58,12.6,515,65,450,ru
57,Arclight Panda,"GRANDMASTER I
G",57,19.3,383,74,309,ru
58,NikeIII,"GRANDMASTER I
G",55,28.8,184,53,131,ru
59,Rukashi,"GRANDMASTER I
G",50,31.5,108,34,74,ru
60,Rocket MaRin,"GRANDMASTER I
G",49,23.6,233,55,178,ru
61,Silent Sona,"GRANDMASTER I
G",38,19.6,383,75,308,ru
62,dontlookatmepls,"GRANDMASTER I
G",36,32.2,90,29,61,ru
63,Youbanyouto,"GRANDMASTER I
G",34,18.6,194,36,158,ru
64,im famous,"GRANDMASTER I
G",34,15.7,229,36,193,ru
65,Hoang,"GRANDMASTER I
G",33,20.9,201,42,159,ru
66,ZiGZaG08,"GRANDMASTER I
G",32,16.4,262,43,219,ru
67,zhangqiling,"GRANDMASTER I
G",32,16.3,264,43,221,ru
68,Th3Gambl3r,"GRANDMASTER I
G",30,19.2,604,116,488,ru
69,Arcade bÔÔbs,"GRANDMASTER I
G",30,21.0,515,108,407,ru
70,inspekt0r,"GRANDMASTER I
G",30,18.6,334,62,272,ru
71,The Inspired One,"GRANDMASTER I
G",30,20.3,148,30,118,ru
72,Spring North,"GRANDMASTER I
G",29,18.0,233,42,191,ru
73,yurchiv,"GRANDMASTER I
G",26,10.0,718,72,646,ru
74,K R I P S I,"GRANDMASTER I
G",25,23.9,264,63,201,ru
75,Джим Рейнор,"GRANDMASTER I
G",22,17.6,312,55,257,ru
76,Shinkulirion,"GRANDMASTER I
G",21,21.7,378,82,296,ru
77,Ветра Севера,"GRANDMASTER I
G",17,9.0,565,51,514,ru
78,Леди Меламори,"GRANDMASTER I
G",16,14.7,211,31,180,ru
79,Ice Ivern,"GRANDMASTER I
G",13,15.2,236,36,200,ru
80,ПаГа,"GRANDMASTER I
G",12,13.9,431,60,371,ru
81,Tâm Luct,"GRANDMASTER I
G",7,16.1,224,36,188,ru
82,Генерал Docta,"GRANDMASTER I
G",5,29.7,155,46,109,ru
83,AlloC,"GRANDMASTER I
G",3,21.1,199,42,157,ru
84,ropo4ka,"GRANDMASTER I
G",0,17.6,449,79,370,ru
85,TFT tsm,"GRANDMASTER I
G",0,16.2,431,70,361,ru
86,Hand off 3,"GRANDMASTER I
G",0,20.6,334,69,265,ru
87,Hen predator,"GRANDMASTER I
G",0,19.8,338,67,271,ru
88,Kiss my fizz,"GRANDMASTER I
G",0,21.3,301,64,237,ru
89,Morozilkin,"GRANDMASTER I
G",0,21.8,220,48,172,ru
90,ruComix,"GRANDMASTER I
G",0,23.4,201,47,154,ru
91,CuPofCrAcK,"GRANDMASTER I
G",0,11.0,401,44,357,ru
92,Hail of Blades,"GRANDMASTER I
G",0,24.2,161,39,122,ru
93,hornie,"GRANDMASTER I
G",0,27.0,137,37,100,ru
94,bingo666fly,"GRANDMASTER I
G",0,21.8,170,37,133,ru
95,Killl Lov3,"GRANDMASTER I
G",0,24.2,120,29,91,ru
96,iQuestions,"GRANDMASTER I
G",0,18.9,132,25,107,ru
97,Воруй94,DIAMOND I,86,26.2,141,37,104,ru
98,BrotherFrank,DIAMOND I,77,26.2,126,33,93,ru
99,thanh169,DIAMOND I,75,22.8,552,126,426,ru
100,TOMSK7777,DIAMOND I,75,23.1,399,92,307,ru
101,ChinaNirvana,DIAMOND I,75,22.3,399,89,310,ru
102,СерёгаСПб,DIAMOND I,75,19.1,430,82,348,ru
103,Крада,DIAMOND I,75,12.8,602,77,525,ru
104,Крушитель001,DIAMOND I,75,19.2,369,71,298,ru
105,EmperorCHN,DIAMOND I,75,25.4,264,67,197,ru
106,SUSUWE,DIAMOND I,75,17.0,383,65,318,ru
107,Lorraine,DIAMOND I,75,27.0,233,63,170,ru
108,DuongLan,DIAMOND I,75,16.1,367,59,308,ru
109,Eldrax,DIAMOND I,75,13.4,441,59,382,ru
110,lºˆºl,DIAMOND I,75,23.0,248,57,191,ru
111,1348319349,DIAMOND I,75,21.1,270,57,213,ru
112,Saitaf,DIAMOND I,75,23.0,226,52,174,ru
113,qsoso,DIAMOND I,75,17.2,302,52,250,ru
114,dyboщит,DIAMOND I,75,18.5,276,51,225,ru
115,blvckboy,DIAMOND I,75,15.3,320,49,271,ru
116,Dunngarm,DIAMOND I,75,26.3,171,45,126,ru
117,CR0WNZ,DIAMOND I,75,16.0,269,43,226,ru
118,Make me Purr,DIAMOND I,75,20.0,200,40,160,ru
119,RaNdoOoMuK,DIAMOND I,75,20.5,190,39,151,ru
120,Just Cancer,DIAMOND I,75,18.4,207,38,169,ru
121,vulcaner,DIAMOND I,66,21.1,185,39,146,ru
122,VN Error RoLL,DIAMOND I,65,13.9,626,87,539,ru
123,sketcheer,DIAMOND I,59,17.0,306,52,254,ru
124,Wuaneon,DIAMOND I,58,18.9,164,31,133,ru
125,Remilia Scarlet,DIAMOND I,56,21.7,212,46,166,ru
126,Малолетка,DIAMOND I,54,33.3,75,25,50,ru
127,NikolayDjan,DIAMOND I,53,18.4,451,83,368,ru
128,Callsign Kindred,DIAMOND I,52,33.0,88,29,59,ru
129,TG Rot Stillness,DIAMOND I,51,11.9,394,47,347,ru
130,AKJSDs,DIAMOND I,49,24.9,201,50,151,ru
131,Дрeeейвен,DIAMOND I,48,11.0,662,73,589,ru
132,УРОД,DIAMOND I,48,40.1,177,71,106,ru
133,Жабка Лиска,DIAMOND I,48,23.6,288,68,220,ru
134,NorMe,DIAMOND I,46,18.4,152,28,124,ru
135,KissTheStar,DIAMOND I,44,9.2,413,38,375,ru
136,AeCorah,DIAMOND I,42,25.1,573,144,429,ru
137,junestone,DIAMOND I,41,30.4,214,65,149,ru
138,Ksorn,DIAMOND I,41,12.8,203,26,177,ru
139,Trang4438,DIAMOND I,39,19.8,394,78,316,ru
140,sasha1OOO,DIAMOND I,39,19.1,178,34,144,ru
141,royál beggar,DIAMOND I,38,23.6,186,44,142,ru
142,Snowman322,DIAMOND I,37,14.7,470,69,401,ru
143,ReMiXoN007,DIAMOND I,33,22.7,141,32,109,ru
144,8xm12a,DIAMOND I,32,11.6,276,32,244,ru
145,liuzhuni,DIAMOND I,29,14.4,1035,149,886,ru
146,MuTuZ,DIAMOND I,29,15.8,215,34,181,ru
147,PistolMaravich,DIAMOND I,25,36.1,263,95,168,ru
148,SUPRAAAA,DIAMOND I,25,26.3,99,26,73,ru
149,CapsuleZZZ,DIAMOND I,20,16.9,213,36,177,ru
150,NickDeko,DIAMOND I,18,18.4,419,77,342,ru
151,Kimchi wang,DIAMOND I,17,34.6,127,44,83,ru
152,Arclight JinBey,DIAMOND I,16,18.5,319,59,260,ru
153,Anurion89,DIAMOND I,14,19.9,316,63,253,ru
154,StaverOk,DIAMOND I,14,21.2,231,49,182,ru
155,beznika2,DIAMOND I,14,14.6,213,31,182,ru
156,Ignotas,DIAMOND I,13,23.3,90,21,69,ru
157,kecodon9x,DIAMOND I,12,18.0,205,37,168,ru
158,Лапки Юми,DIAMOND I,11,16.1,328,53,275,ru
159,Ji Yong,DIAMOND I,11,13.3,279,37,242,ru
160,HMTuanRu,DIAMOND I,10,19.4,345,67,278,ru
161,ПоНосик в Одеяле,DIAMOND I,10,28.3,191,54,137,ru
162,лесk urself jgl,DIAMOND I,9,20.2,203,41,162,ru
163,SorrNyak,DIAMOND I,9,18.3,197,36,161,ru
164,Takanashi Hikka,DIAMOND I,9,18.6,167,31,136,ru
165,Юрa,DIAMOND I,5,15.0,207,31,176,ru
166,Cоming Down,DIAMOND I,4,17.1,216,37,179,ru
167,Tot,DIAMOND I,4,19.2,135,26,109,ru
168,Evildeaad,DIAMOND I,4,27.8,90,25,65,ru
169,ktotamnukogonet,DIAMOND I,3,25.8,128,33,95,ru
170,royál beggar,DIAMOND I,3,20.7,150,31,119,ru
171,angelys,DIAMOND I,3,10.4,288,30,258,ru
172,SadSlipperS,DIAMOND I,0,12.2,549,67,482,ru
173,Janelicher,DIAMOND I,0,28.8,208,60,148,ru
174,Лёшкина игра,DIAMOND I,0,24.2,231,56,175,ru
175,Вика Клубника,DIAMOND I,0,21.3,249,53,196,ru
176,GGJIANG,DIAMOND I,0,18.9,281,53,228,ru
177,LooKDKc,DIAMOND I,0,19.5,267,52,215,ru
178,LPL dynasty,DIAMOND I,0,21.7,212,46,166,ru
179,Мёртвый принц,DIAMOND I,0,18.1,221,40,181,ru
180,EleemY,DIAMOND I,0,33.0,112,37,75,ru
181,clown syndrome,DIAMOND I,0,22.1,154,34,120,ru
182,PINCER,DIAMOND I,0,25.6,125,32,93,ru
183,JusticeNari,DIAMOND I,0,15.2,210,32,178,ru
184,Ayumiclq313,DIAMOND I,0,22.6,128,29,99,ru
185,Дым из трубы,DIAMOND I,0,27.2,103,28,75,ru
186,Vladimir Syusin,DIAMOND I,0,11.0,246,27,219,ru
187,Russiabang,DIAMOND I,0,11.5,200,23,177,ru
188,Kalabaka,DIAMOND II,96,27.2,872,237,635,ru
189,Emma Hix,DIAMOND II,82,27.4,117,32,85,ru
190,Desperateing,DIAMOND II,76,30.8,78,24,54,ru
191,CN liang,DIAMOND II,75,16.3,423,69,354,ru
192,LHYloveLWJ,DIAMOND II,75,14.4,436,63,373,ru
193,laojiazuishuai,DIAMOND II,75,18.6,334,62,272,ru
194,WO S LAOMAOZI,DIAMOND II,75,21.6,268,58,210,ru
195,lanyuheissl55555,DIAMOND II,75,19.9,276,55,221,ru
196,Bushuwotoudehong,DIAMOND II,75,19.9,276,55,221,ru
197,Lord Ochinchin,DIAMOND II,75,54.1,98,53,45,ru
198,RngUziJianZihao,DIAMOND II,75,18.4,266,49,217,ru
199,sitius1986,DIAMOND II,75,17.6,279,49,230,ru
200,Мерцание,DIAMOND II,75,9.7,462,45,417,ru
