rank,name,tier,lp,win rate,played,wins,losses,region
1,Mismatched Socks,CHALLENGER I,1599,21.5,497,107,390,na
2,Ms MatchedSocks,CHALLENGER I,1488,21.8,464,101,363,na
3,Salvyyy,CHALLENGER I,1451,26.2,286,75,211,na
4,GrandVice8,CHALLENGER I,1424,20.0,789,158,631,na
5,Kurumx,CHALLENGER I,1398,20.7,680,141,539,na
6,gv8,CHALLENGER I,1343,21.4,593,127,466,na
7,FluffyHS,CHALLENGER I,1338,18.4,461,85,376,na
8,bertasaurus,CHALLENGER I,1218,17.7,949,168,781,na
9,Naturesbf,CHALLENGER I,1168,15.5,976,151,825,na
10,Krmx,CHALLENGER I,1118,20.4,642,131,511,na
11,111094 R,CHALLENGER I,1117,13.8,1715,236,1479,na
12,JIGEJIUWO,CHALLENGER I,1107,16.6,535,89,446,na
13,Old Lodo,CHALLENGER I,1008,16.8,411,69,342,na
14,Cottontail,CHALLENGER I,1004,15.5,747,116,631,na
15,ajmonsta,CHALLENGER I,1003,16.4,537,88,449,na
16,Silliest,CHALLENGER I,906,25.4,366,93,273,na
17,M35S,CHALLENGER I,867,15.4,964,149,815,na
18,Kalsuo,CHALLENGER I,863,16.7,914,153,761,na
19,lLykus,CHALLENGER I,860,16.3,887,145,742,na
20,The Cxk,CHALLENGER I,851,17.2,564,97,467,na
21,Inphinit3,CHALLENGER I,843,16.1,498,80,418,na
22,Grillsyy,CHALLENGER I,838,15.7,737,116,621,na
23,ItzYaBoyBeasty,CHALLENGER I,824,17.1,1017,174,843,na
24,dowfu ph,CHALLENGER I,824,20.2,272,55,217,na
25,ttv KitingisHard,CHALLENGER I,819,17.2,958,165,793,na
26,Kled Bundy,CHALLENGER I,807,13.6,1373,187,1186,na
27,HiROKKKKJP,CHALLENGER I,802,16.5,613,101,512,na
28,BIuePrincess,CHALLENGER I,801,18.3,251,46,205,na
29,enchabi,CHALLENGER I,799,16.1,299,48,251,na
30,inay,CHALLENGER I,793,15.8,1005,159,846,na
31,TempestLife,CHALLENGER I,780,20.2,287,58,229,na
32,Agon,CHALLENGER I,779,17.7,835,148,687,na
33,Ripple Overdrive,CHALLENGER I,778,15.3,313,48,265,na
34,EAOST,CHALLENGER I,763,15.2,619,94,525,na
35,Flandre Bot,CHALLENGER I,762,16.4,250,41,209,na
36,Live for the Day,CHALLENGER I,760,19.4,846,164,682,na
37,GoyoTV,CHALLENGER I,760,15.5,879,136,743,na
38,pastafartianist,CHALLENGER I,758,22.4,241,54,187,na
39,McDull,CHALLENGER I,756,14.6,837,122,715,na
40,C9 k3soju,CHALLENGER I,754,20.6,1035,213,822,na
41,TwitchTV Odyceuz,CHALLENGER I,749,18.0,489,88,401,na
42,Ol Lodo,CHALLENGER I,748,16.0,481,77,404,na
43,Me Starship,CHALLENGER I,748,17.2,326,56,270,na
44,Hiraino,CHALLENGER I,747,15.7,969,152,817,na
45,ttvGooGieGaminG,CHALLENGER I,743,14.8,452,67,385,na
46,VX15152242663,CHALLENGER I,739,19.7,604,119,485,na
47,Nice Mister Kien,CHALLENGER I,736,16.8,494,83,411,na
48,Wrackle,CHALLENGER I,736,13.9,395,55,340,na
49,wx qq258790278,CHALLENGER I,735,19.2,432,83,349,na
50,Xeno,CHALLENGER I,730,20.5,307,63,244,na
51,wo chi bu pang,CHALLENGER I,728,17.9,301,54,247,na
52,Broccóli,CHALLENGER I,725,14.5,532,77,455,na
53,Gunmay,CHALLENGER I,725,10.9,560,61,499,na
54,PureAlohaa,CHALLENGER I,724,16.9,391,66,325,na
55,Kiyoon,CHALLENGER I,713,18.5,1016,188,828,na
56,WhySofaKing,CHALLENGER I,713,14.6,513,75,438,na
57,Sun Astronaut,CHALLENGER I,699,14.6,349,51,298,na
58,matchedsock,CHALLENGER I,694,18.8,138,26,112,na
59,NA SMURF KEKW,CHALLENGER I,684,17.0,224,38,186,na
60,Fxxx Yaaa,CHALLENGER I,681,17.8,422,75,347,na
61,theMaskedPatel,CHALLENGER I,678,16.5,327,54,273,na
62,Ex Railgun,CHALLENGER I,674,16.7,789,132,657,na
63,ChrisKillsX,CHALLENGER I,672,19.3,166,32,134,na
64,Jangsterang,CHALLENGER I,669,15.4,403,62,341,na
65,morellos,CHALLENGER I,660,17.6,279,49,230,na
66,Zadust TFT,CHALLENGER I,659,15.6,591,92,499,na
67,Stompalittle,CHALLENGER I,657,14.6,1277,187,1090,na
68,ogapmaler cuck,CHALLENGER I,657,24.2,153,37,116,na
69,MaskedPatel,CHALLENGER I,649,15.7,249,39,210,na
70,qieqie,CHALLENGER I,647,18.8,548,103,445,na
71,Kira,CHALLENGER I,647,16.7,588,98,490,na
72,Jaekun2maX,CHALLENGER I,647,18.2,274,50,224,na
73,BentoBot,CHALLENGER I,644,15.4,696,107,589,na
74,influrrier,CHALLENGER I,642,16.1,953,153,800,na
75,WANG SHUO ZHE,CHALLENGER I,641,18.1,292,53,239,na
76,Sphinx,CHALLENGER I,640,9.9,759,75,684,na
77,Moggy Mako,CHALLENGER I,638,9.1,670,61,609,na
78,Xerluk,CHALLENGER I,637,13.7,678,93,585,na
79,A shadowy figure,CHALLENGER I,636,15.8,603,95,508,na
80,BeIiever,CHALLENGER I,635,21.0,629,132,497,na
81,FroSteeMate,CHALLENGER I,633,15.0,1192,179,1013,na
82,zzzzzzZ7,CHALLENGER I,632,19.3,259,50,209,na
83,Eason with U,CHALLENGER I,628,20.0,310,62,248,na
84,TheMagykal,CHALLENGER I,627,16.6,935,155,780,na
85,TFTbigJB,CHALLENGER I,624,17.2,460,79,381,na
86,TTV iantyler,CHALLENGER I,623,17.3,358,62,296,na
87,Elvisbeback,CHALLENGER I,622,11.0,327,36,291,na
88,Cris,CHALLENGER I,621,14.1,1506,213,1293,na
89,Midrash,CHALLENGER I,620,16.1,410,66,344,na
90,firest0ne,CHALLENGER I,618,7.5,1644,124,1520,na
91,Simple Plan,CHALLENGER I,617,14.3,630,90,540,na
92,ME EIGHTH,CHALLENGER I,605,16.5,242,40,202,na
93,Doublezzzz,CHALLENGER I,604,13.5,695,94,601,na
94,Me Predator,CHALLENGER I,604,18.1,321,58,263,na
95,Agaze,CHALLENGER I,604,17.2,233,40,193,na
96,DreamErica,CHALLENGER I,603,14.5,1028,149,879,na
97,Ashe The Frost,CHALLENGER I,602,11.3,689,78,611,na
98,SalvyWintrade69,CHALLENGER I,601,15.9,257,41,216,na
99,PockyGom,CHALLENGER I,600,15.7,738,116,622,na
100,slippinbug,CHALLENGER I,600,17.3,306,53,253,na
101,DoraAmon,CHALLENGER I,600,27.4,124,34,90,na
102,piggy2448,CHALLENGER I,596,18.7,380,71,309,na
103,lilsteppy,CHALLENGER I,594,20.6,397,82,315,na
104,birdwings,CHALLENGER I,594,13.3,352,47,305,na
105,chainpullz,CHALLENGER I,593,13.9,338,47,291,na
106,P1KACHuuuuuuu,CHALLENGER I,593,31.1,103,32,71,na
107,FinaldF,CHALLENGER I,592,13.0,1397,182,1215,na
108,Keane fans,CHALLENGER I,590,17.3,1330,230,1100,na
109,Sojin,CHALLENGER I,589,15.6,854,133,721,na
110,TTV Kenya1,CHALLENGER I,589,15.3,710,109,601,na
111,chickensaveme,CHALLENGER I,589,14.5,324,47,277,na
112,Stonerule,CHALLENGER I,587,17.1,456,78,378,na
113,Humilis,CHALLENGER I,585,13.1,291,38,253,na
114,Souless,CHALLENGER I,584,23.1,190,44,146,na
115,Visual,CHALLENGER I,583,16.8,495,83,412,na
116,H2211,CHALLENGER I,580,19.4,1273,247,1026,na
117,Akurai,CHALLENGER I,577,17.8,353,63,290,na
118,21 Zsy,CHALLENGER I,576,21.1,512,108,404,na
119,garet,CHALLENGER I,575,14.0,573,80,493,na
120,RippleOverdrive2,CHALLENGER I,573,21.2,179,38,141,na
121,El Conejo Malo,CHALLENGER I,569,20.3,291,59,232,na
122,OrAnGe JuIc3,CHALLENGER I,568,13.2,408,54,354,na
123,Lab Member 001,CHALLENGER I,565,15.8,355,56,299,na
124,Ian952,CHALLENGER I,563,17.5,566,99,467,na
125,Purify,CHALLENGER I,561,13.4,1091,146,945,na
126,lnaban,CHALLENGER I,561,15.5,676,105,571,na
127,paulhnlee,CHALLENGER I,560,22.0,232,51,181,na
128,Blaim,CHALLENGER I,559,16.2,717,116,601,na
129,Tinkady,CHALLENGER I,558,18.4,593,109,484,na
130,WúJi,CHALLENGER I,558,17.2,273,47,226,na
131,Aesah,CHALLENGER I,557,19.1,637,122,515,na
132,Catybear,CHALLENGER I,557,15.3,491,75,416,na
133,Scoped32,CHALLENGER I,557,15.9,415,66,349,na
134,xin luan le,CHALLENGER I,556,14.9,435,65,370,na
135,17º C,CHALLENGER I,555,18.4,457,84,373,na
136,Muffinn TFT,CHALLENGER I,555,18.7,225,42,183,na
137,NED carry,CHALLENGER I,554,17.5,331,58,273,na
138,Coleman TFT,CHALLENGER I,554,18.7,225,42,183,na
139,George Brown TFT,CHALLENGER I,552,14.5,495,72,423,na
140,tinkady69,CHALLENGER I,552,17.0,253,43,210,na
141,dpei,CHALLENGER I,551,16.9,450,76,374,na
142,blackwhited,CHALLENGER I,548,14.6,446,65,381,na
143,Flashbâng,CHALLENGER I,547,9.1,888,81,807,na
144,DeadlyCO2,CHALLENGER I,547,11.9,544,65,479,na
145,birdy511,CHALLENGER I,547,15.3,373,57,316,na
146,anmin9nb,CHALLENGER I,546,14.4,556,80,476,na
147,Bonzolo,CHALLENGER I,545,15.1,830,125,705,na
148,kpopfan7,CHALLENGER I,544,13.5,170,23,147,na
149,Terde,CHALLENGER I,542,17.6,624,110,514,na
150,Oonnii,CHALLENGER I,542,20.8,355,74,281,na
151,robinsongz,CHALLENGER I,542,15.8,443,70,373,na
152,OmniPie,CHALLENGER I,541,13.7,911,125,786,na
153,TheHentaiGod,CHALLENGER I,541,15.6,748,117,631,na
154,Twitch RayditzFN,CHALLENGER I,540,15.8,1243,196,1047,na
155,RIOT thatsPRIMAL,CHALLENGER I,540,11.2,958,107,851,na
156,Yiggles,CHALLENGER I,536,15.3,847,130,717,na
157,Mean Mister Kien,CHALLENGER I,536,14.4,740,107,633,na
158,2418,CHALLENGER I,536,14.3,357,51,306,na
159,Eunwilf,CHALLENGER I,534,18.0,317,57,260,na
160,Gurt Games,CHALLENGER I,534,9.2,523,48,475,na
161,ˉ dà mó wáng,CHALLENGER I,533,15.3,569,87,482,na
162,xplitcit,CHALLENGER I,532,14.6,949,139,810,na
163,KomradeKush,CHALLENGER I,532,12.0,819,98,721,na
164,iCopyKeane,CHALLENGER I,532,11.9,361,43,318,na
165,Wolves Save Me,CHALLENGER I,531,13.1,1041,136,905,na
166,Partnerkiller 02,CHALLENGER I,531,16.5,534,88,446,na
167,JayGeBee,CHALLENGER I,529,14.3,677,97,580,na
168,NicholasLy6,CHALLENGER I,529,19.8,293,58,235,na
169,MegaInfernoBomb,CHALLENGER I,529,15.2,277,42,235,na
170,TTVHentaiGodTFT,CHALLENGER I,529,19.3,212,41,171,na
171,TacticalLukarina,CHALLENGER I,528,15.1,841,127,714,na
172,TurboARAM,CHALLENGER I,526,14.6,556,81,475,na
173,Pawnup,CHALLENGER I,526,14.0,364,51,313,na
174,Lemon IceCream,CHALLENGER I,525,12.7,755,96,659,na
175,DxnTFT,CHALLENGER I,524,15.7,828,130,698,na
176,MikeP,CHALLENGER I,524,17.4,155,27,128,na
177,chitosechitose,CHALLENGER I,523,14.0,662,93,569,na
178,Liquid Saint,CHALLENGER I,523,19.3,362,70,292,na
179,Jaekun4maX,CHALLENGER I,523,22.7,185,42,143,na
180,C9 Khroen,CHALLENGER I,522,19.1,387,74,313,na
181,Nhân tâm TFT,CHALLENGER I,522,18.3,284,52,232,na
182,JiaJiaJiaJiaJia,CHALLENGER I,520,18.9,491,93,398,na
183,KurumsSoreNut,CHALLENGER I,519,25.0,148,37,111,na
184,v Köi v,CHALLENGER I,518,21.8,367,80,287,na
185,AndyofLove,CHALLENGER I,517,17.0,312,53,259,na
186,Turn1Delver,CHALLENGER I,516,14.8,1751,259,1492,na
187,anewwplayer,CHALLENGER I,514,18.2,291,53,238,na
188,zugrug,CHALLENGER I,513,13.2,816,108,708,na
189,Kłaytøn,CHALLENGER I,512,15.0,514,77,437,na
190,In Your Eye,CHALLENGER I,511,26.4,220,58,162,na
191,Jaekun1maX,CHALLENGER I,510,18.2,274,50,224,na
192,AndyofSmurf,CHALLENGER I,510,19.1,188,36,152,na
193,Nhân Tâm,CHALLENGER I,509,17.3,411,71,340,na
194,buscusu,CHALLENGER I,508,18.5,827,153,674,na
195,CounTerWu,CHALLENGER I,506,13.6,674,92,582,na
196,Mango TheHun,CHALLENGER I,500,16.6,259,43,216,na
197,You MDZZ,CHALLENGER I,494,16.4,316,52,264,na
198,Jaekun3maX,CHALLENGER I,458,27.7,119,33,86,na
199,Reigncat,CHALLENGER I,447,14.7,313,46,267,na
200,piglet2448,CHALLENGER I,414,21.7,203,44,159,na
1,cuckmyblade,CHALLENGER I,1685,24.7,518,128,390,br
2,brüninho,CHALLENGER I,1683,21.2,599,127,472,br
3,Zadust,CHALLENGER I,1605,33.5,346,116,230,br
4,Odyceuz,CHALLENGER I,1381,24.0,505,121,384,br
5,tartaruguinhas2,CHALLENGER I,1315,21.7,580,126,454,br
6,inc mplete,CHALLENGER I,1304,17.2,777,134,643,br
7,Slooper,CHALLENGER I,1302,24.6,374,92,282,br
8,techzz,CHALLENGER I,1279,23.6,619,146,473,br
9,eusouolucas,CHALLENGER I,1244,18.4,729,134,595,br
10,FabledDofus,CHALLENGER I,1189,19.6,510,100,410,br
11,Higuree,CHALLENGER I,1160,21.3,550,117,433,br
12,Paralelepipo,CHALLENGER I,1153,26.1,257,67,190,br
13,ftdrain,CHALLENGER I,1140,30.1,292,88,204,br
14,BarksdaIe,CHALLENGER I,1132,28.9,249,72,177,br
15,Dairon,CHALLENGER I,981,21.4,322,69,253,br
16,Archway,CHALLENGER I,960,17.0,446,76,370,br
17,Gúne,CHALLENGER I,955,23.0,430,99,331,br
18,Serask,CHALLENGER I,944,21.6,547,118,429,br
19,Medico do SUS22,CHALLENGER I,940,17.9,615,110,505,br
20,m3rdapequena,CHALLENGER I,917,25.9,259,67,192,br
21,Mierdagrande,CHALLENGER I,908,29.4,218,64,154,br
22,Past,CHALLENGER I,872,25.1,474,119,355,br
23,TG Wed,CHALLENGER I,845,16.9,723,122,601,br
24,Miss Queen,CHALLENGER I,791,13.2,395,52,343,br
25,Jael TFT,CHALLENGER I,763,20.4,412,84,328,br
26,CD ERICK,CHALLENGER I,761,18.0,267,48,219,br
27,Twitch NickTFT,CHALLENGER I,745,21.3,539,115,424,br
28,Billy Bait,CHALLENGER I,739,16.3,761,124,637,br
29,Nescau Insolúvel,CHALLENGER I,737,19.6,347,68,279,br
30,escolinha do inc,CHALLENGER I,734,21.3,427,91,336,br
31,the ego illusion,CHALLENGER I,732,25.2,293,74,219,br
32,Haxwei,CHALLENGER I,726,19.0,216,41,175,br
33,OOO,CHALLENGER I,721,18.4,517,95,422,br
34,Royal Kvasterr,CHALLENGER I,717,14.6,445,65,380,br
35,mDobZ,CHALLENGER I,714,18.2,264,48,216,br
36,BlasHelldder,CHALLENGER I,712,19.1,423,81,342,br
37,T F Toddy,CHALLENGER I,707,25.6,160,41,119,br
38,Garras of Rivia,CHALLENGER I,698,23.7,300,71,229,br
39,Yvissaur,CHALLENGER I,698,22.0,314,69,245,br
40,Encatroll é trix,CHALLENGER I,692,15.9,301,48,253,br
41,odyceuZEDeletric,CHALLENGER I,692,42.0,100,42,58,br
42,Felipolv000,CHALLENGER I,691,20.7,217,45,172,br
43,Vowtz,CHALLENGER I,690,16.6,362,60,302,br
44,RFK Azura,CHALLENGER I,688,26.1,471,123,348,br
45,Lünna,CHALLENGER I,682,20.1,822,165,657,br
46,Irisdescent,CHALLENGER I,681,20.8,260,54,206,br
47,DEZZlN,CHALLENGER I,680,16.8,493,83,410,br
48,TFT Médico,CHALLENGER I,680,21.4,196,42,154,br
49,HawkEyeCs7,CHALLENGER I,668,17.2,692,119,573,br
50,Lula Livrão TFT,CHALLENGER I,667,16.0,437,70,367,br
51,Koala Esbelto,"GRANDMASTER I
G",700,19.9,727,145,582,br
52,MATEUS DO SUS DF,"GRANDMASTER I
G",674,16.5,490,81,409,br
53,LOVER 97,"GRANDMASTER I
G",653,14.8,216,32,184,br
54,O HIPER CRIME,"GRANDMASTER I
G",646,14.8,425,63,362,br
55,TFT Azura,"GRANDMASTER I
G",622,23.2,237,55,182,br
56,AdrianoK,"GRANDMASTER I
G",606,17.6,346,61,285,br
57,Neves,"GRANDMASTER I
G",596,17.9,374,67,307,br
58,Tsuuzaki,"GRANDMASTER I
G",567,20.3,468,95,373,br
59,TwitchTV Patr0ci,"GRANDMASTER I
G",566,15.6,770,120,650,br
60,Melança,"GRANDMASTER I
G",559,16.3,687,112,575,br
61,Bioosfera,"GRANDMASTER I
G",557,15.5,483,75,408,br
62,SÄNT hyun,"GRANDMASTER I
G",535,13.6,817,111,706,br
63,Nihonjin,"GRANDMASTER I
G",495,18.1,403,73,330,br
64,Titos,"GRANDMASTER I
G",493,17.9,447,80,367,br
65,Kirbyzin,"GRANDMASTER I
G",491,16.1,669,108,561,br
66,Jvão,"GRANDMASTER I
G",491,19.1,528,101,427,br
67,tft igor18,"GRANDMASTER I
G",477,22.3,197,44,153,br
68,R Angra,"GRANDMASTER I
G",461,17.5,325,57,268,br
69,Shinobu300,"GRANDMASTER I
G",455,19.4,377,73,304,br
70,B Lara,"GRANDMASTER I
G",453,21.3,338,72,266,br
71,CD CFCDuuuuds,"GRANDMASTER I
G",450,14.0,765,107,658,br
72,Bandu,"GRANDMASTER I
G",446,17.7,526,93,433,br
73,Allahu TK,"GRANDMASTER I
G",444,12.5,1001,125,876,br
74,kirinde,"GRANDMASTER I
G",442,14.3,704,101,603,br
75,O HIPER CARRY,"GRANDMASTER I
G",431,15.1,550,83,467,br
76,Tallis Sauro,"GRANDMASTER I
G",431,18.3,349,64,285,br
77,Siilent,"GRANDMASTER I
G",421,14.7,686,101,585,br
78,faker indiano,"GRANDMASTER I
G",411,14.8,485,72,413,br
79,souumlucas,"GRANDMASTER I
G",392,23.7,131,31,100,br
80,Duest,"GRANDMASTER I
G",391,17.9,229,41,188,br
81,HeathClyff,"GRANDMASTER I
G",387,19.9,251,50,201,br
82,Levi,"GRANDMASTER I
G",372,21.4,477,102,375,br
83,Goiano,"GRANDMASTER I
G",369,15.2,387,59,328,br
84,Yuu Better,"GRANDMASTER I
G",347,13.9,1500,209,1291,br
85,NeeverGiveUp,"GRANDMASTER I
G",345,14.3,488,70,418,br
86,l Hyper Carry,"GRANDMASTER I
G",333,16.9,1024,173,851,br
87,TWITCHTV Stykr,"GRANDMASTER I
G",328,20.8,342,71,271,br
88,SKT1 RyuZUU,"GRANDMASTER I
G",328,15.0,260,39,221,br
89,vcs sao pateta,"GRANDMASTER I
G",313,12.5,664,83,581,br
90,Batata Rufles,"GRANDMASTER I
G",304,17.8,287,51,236,br
91,Hisekken,"GRANDMASTER I
G",296,16.5,393,65,328,br
92,RAHZAO TFT,"GRANDMASTER I
G",293,9.7,680,66,614,br
93,Vampyrus,"GRANDMASTER I
G",290,17.4,878,153,725,br
94,Sâm,"GRANDMASTER I
G",290,9.8,923,91,832,br
95,Flangonator,"GRANDMASTER I
G",286,16.2,523,85,438,br
96,twitch narkesh1,"GRANDMASTER I
G",283,19.7,330,65,265,br
97,Don Batatone,"GRANDMASTER I
G",280,12.4,226,28,198,br
98,GarrastaClean,"GRANDMASTER I
G",279,20.1,253,51,202,br
99,RafaStark,"GRANDMASTER I
G",278,18.0,283,51,232,br
100,Mon Nom,"GRANDMASTER I
G",276,15.0,707,106,601,br
101,itzzLara,"GRANDMASTER I
G",258,16.4,226,37,189,br
102,Mino Th,"GRANDMASTER I
G",256,19.9,166,33,133,br
103,y Satsue,"GRANDMASTER I
G",255,13.4,142,19,123,br
104,Edinaldo Safadão,"GRANDMASTER I
G",254,14.4,299,43,256,br
105,LosAngelesLakers,"GRANDMASTER I
G",254,20.4,157,32,125,br
106,maçãcomcanela,"GRANDMASTER I
G",253,13.3,474,63,411,br
107,divino Jax JG,"GRANDMASTER I
G",252,11.1,1046,116,930,br
108,MominhoGameplays,"GRANDMASTER I
G",252,17.8,405,72,333,br
109,gazzsinhoxD,"GRANDMASTER I
G",251,16.9,254,43,211,br
110,SKEPET,"GRANDMASTER I
G",250,12.0,565,68,497,br
111,MonteiroLombrado,"GRANDMASTER I
G",249,14.3,448,64,384,br
112,CD Noah Hunter,"GRANDMASTER I
G",248,15.2,355,54,301,br
113,twí,"GRANDMASTER I
G",245,15.3,313,48,265,br
114,Zamora Lindão,"GRANDMASTER I
G",243,11.3,423,48,375,br
115,BARbahh,"GRANDMASTER I
G",241,15.1,324,49,275,br
116,Beastar,"GRANDMASTER I
G",240,17.4,305,53,252,br
117,huggz,"GRANDMASTER I
G",239,17.6,944,166,778,br
118,JhoyLow,"GRANDMASTER I
G",238,21.4,196,42,154,br
119,Daníela,"GRANDMASTER I
G",238,17.3,225,39,186,br
120,BieuL,"GRANDMASTER I
G",236,17.8,303,54,249,br
121,Advomago,"GRANDMASTER I
G",235,15.3,144,22,122,br
122,MarrZ,"GRANDMASTER I
G",234,9.5,422,40,382,br
123,Sènna,"GRANDMASTER I
G",233,10.5,420,44,376,br
124,Crackudo Pistola,"GRANDMASTER I
G",232,15.6,308,48,260,br
125,Doutor Wily,"GRANDMASTER I
G",231,24.1,303,73,230,br
126,Ovas de Peixe,"GRANDMASTER I
G",230,14.9,589,88,501,br
127,FrostxD1,"GRANDMASTER I
G",229,12.6,1035,130,905,br
128,Rubimhood 2,"GRANDMASTER I
G",229,19.0,163,31,132,br
129,mitastico,"GRANDMASTER I
G",228,16.1,317,51,266,br
130,Mestre Akroma,"GRANDMASTER I
G",226,11.6,1121,130,991,br
131,É o tal do Lula,"GRANDMASTER I
G",226,25.9,340,88,252,br
132,JahBullOn,"GRANDMASTER I
G",226,12.8,374,48,326,br
133,Walladi,"GRANDMASTER I
G",225,15.8,196,31,165,br
134,DonCrazy,"GRANDMASTER I
G",224,12.2,825,101,724,br
135,ivelthin2,"GRANDMASTER I
G",224,15.2,224,34,190,br
136,Greafen,"GRANDMASTER I
G",223,17.6,573,101,472,br
137,Numb3r2,"GRANDMASTER I
G",223,17.8,366,65,301,br
138,Royalzito,"GRANDMASTER I
G",218,17.5,452,79,373,br
139,killua do rj,"GRANDMASTER I
G",216,12.1,688,83,605,br
140,Djcaveira TFT,"GRANDMASTER I
G",215,17.4,637,111,526,br
141,CD Koiti,"GRANDMASTER I
G",214,17.2,273,47,226,br
142,Warrior Lulis,"GRANDMASTER I
G",213,20.6,223,46,177,br
143,Park Ro Jin,"GRANDMASTER I
G",210,14.4,306,44,262,br
144,MinoThalysson,"GRANDMASTER I
G",203,22.6,257,58,199,br
145,Ruivão,"GRANDMASTER I
G",203,21.0,224,47,177,br
146,jelly roll blues,"GRANDMASTER I
G",200,15.0,486,73,413,br
147,RyüZU,"GRANDMASTER I
G",200,12.6,507,64,443,br
148,TAKOKUCHEIROSO,"GRANDMASTER I
G",199,16.5,243,40,203,br
149,RESIDENT DA ESCS,"GRANDMASTER I
G",182,13.7,866,119,747,br
150,Paciente67,"GRANDMASTER I
G",163,24.0,129,31,98,br
151,Eu só jogo TFT,MASTER I,302,17.8,606,108,498,br
152,NgMartins,MASTER I,221,13.6,627,85,542,br
153,AcidoVoador,MASTER I,217,21.6,444,96,348,br
154,Fake Texugo,MASTER I,217,18.6,252,47,205,br
155,Heathcote,MASTER I,207,15.3,248,38,210,br
156,sir blackpwner,MASTER I,203,10.4,623,65,558,br
157,Noé Mechanics,MASTER I,187,12.2,369,45,324,br
158,Von King,MASTER I,186,19.5,169,33,136,br
159,Guizi16,MASTER I,184,22.9,201,46,155,br
160,Smurf divino Jax,MASTER I,183,20.1,303,61,242,br
161,LEONERIX,MASTER I,177,13.1,366,48,318,br
162,Carinha de Raiva,MASTER I,172,18.6,264,49,215,br
163,Vermei,MASTER I,169,13.2,333,44,289,br
164,Cadê a namorada,MASTER I,159,11.5,400,46,354,br
165,Jokerrx,MASTER I,156,15.6,211,33,178,br
166,Roubaram o meu,MASTER I,153,15.3,176,27,149,br
167,Kawori Miyazono,MASTER I,142,9.5,1096,104,992,br
168,xXperrsonXx,MASTER I,142,18.9,280,53,227,br
169,Dézim TFT,MASTER I,140,18.7,166,31,135,br
170,PheonixS W,MASTER I,139,18.8,384,72,312,br
171,Viking Vaporuub,MASTER I,139,19.5,231,45,186,br
172,JUJU DO TFT,MASTER I,138,8.1,1074,87,987,br
173,Inside Digitally,MASTER I,137,21.7,161,35,126,br
174,XebeckX3,MASTER I,136,17.2,314,54,260,br
175,Tuiu ZX,MASTER I,132,11.5,208,24,184,br
176,betorino,MASTER I,131,16.9,1105,187,918,br
177,DeBitous,MASTER I,131,15.1,608,92,516,br
178,Arckie,MASTER I,130,19.4,365,71,294,br
179,HIGOR HIGOR TFT,MASTER I,130,18.8,345,65,280,br
180,xShanks,MASTER I,129,13.0,253,33,220,br
181,GlaucondE,MASTER I,128,12.7,181,23,158,br
182,SannTFT,MASTER I,125,18.5,400,74,326,br
183,Cheleia,MASTER I,124,13.5,260,35,225,br
184,Ezo,MASTER I,118,16.3,558,91,467,br
185,anuib,MASTER I,117,9.0,924,83,841,br
186,Adboy,MASTER I,116,19.2,276,53,223,br
187,Le ismym4in,MASTER I,115,13.2,205,27,178,br
188,7sCeyEkwaH,MASTER I,114,15.1,166,25,141,br
189,TAKOKUFEDENO,MASTER I,113,29.9,97,29,68,br
190,Scaith,MASTER I,111,26.2,80,21,59,br
191,zMysto,MASTER I,104,11.8,194,23,171,br
192,MAMI TIROTEIO,MASTER I,103,18.7,182,34,148,br
193,Sakura Hitomi,MASTER I,101,14.4,395,57,338,br
194,ViroseMata,MASTER I,100,20.7,270,56,214,br
195,Aphroddi,MASTER I,100,17.3,295,51,244,br
196,Batooré,MASTER I,100,19.4,253,49,204,br
197,dedinho do lula,MASTER I,98,12.5,288,36,252,br
198,BtG Wonderweiss,MASTER I,97,14.4,438,63,375,br
199,xGottschalk,MASTER I,94,19.3,398,77,321,br
200,Lucas reformado,MASTER I,94,17.0,394,67,327,br
1,DaSaEbaVMo6niq,CHALLENGER I,1733,25.7,448,115,333,eune
2,TFT Hadaf,CHALLENGER I,1437,26.1,449,117,332,eune
3,Deepityy,CHALLENGER I,1171,26.6,282,75,207,eune
4,Chinese Superbot,CHALLENGER I,1154,24.7,750,185,565,eune
5,Deepityyy,CHALLENGER I,1115,29.4,282,83,199,eune
6,Hi Im Hadaf,CHALLENGER I,1040,21.6,287,62,225,eune
7,Barbalofono,CHALLENGER I,1026,14.1,547,77,470,eune
8,nuenueyouyuegou,CHALLENGER I,1014,30.7,231,71,160,eune
9,wenfan,CHALLENGER I,965,26.8,209,56,153,eune
10,Sting Youclif,CHALLENGER I,956,21.1,251,53,198,eune
11,ShayonZ,CHALLENGER I,943,24.6,406,100,306,eune
12,H4rlequinForest,CHALLENGER I,931,12.3,1044,129,915,eune
13,Kier0n,CHALLENGER I,874,24.9,253,63,190,eune
14,yingyi,CHALLENGER I,871,24.9,189,47,142,eune
15,Quevash,CHALLENGER I,841,20.9,254,53,201,eune
16,Abo Sreee3,CHALLENGER I,813,26.0,373,97,276,eune
17,Nevilter,CHALLENGER I,792,15.2,387,59,328,eune
18,Thrae,CHALLENGER I,780,23.2,564,131,433,eune
19,Ambitious Noob,CHALLENGER I,743,21.9,366,80,286,eune
20,BBit,CHALLENGER I,737,25.6,168,43,125,eune
21,Cebo v9,CHALLENGER I,733,23.2,185,43,142,eune
22,End of The Line,CHALLENGER I,728,15.4,1090,168,922,eune
23,Kumihowo,CHALLENGER I,712,26.6,192,51,141,eune
24,masterboi,CHALLENGER I,666,13.3,480,64,416,eune
25,LuQ876,CHALLENGER I,662,14.4,755,109,646,eune
26,Maro0N,CHALLENGER I,659,25.8,159,41,118,eune
27,Im Sneaky,CHALLENGER I,649,16.9,603,102,501,eune
28,Tokuchi Toua,CHALLENGER I,643,18.7,257,48,209,eune
29,shonun,CHALLENGER I,641,27.4,135,37,98,eune
30,Sesard,CHALLENGER I,633,16.8,297,50,247,eune
31,Fadder,CHALLENGER I,628,18.1,487,88,399,eune
32,Brynool,CHALLENGER I,623,22.1,253,56,197,eune
33,rngshinyruo,CHALLENGER I,621,23.5,204,48,156,eune
34,Tryndabeard TTV,CHALLENGER I,620,22.0,209,46,163,eune
35,Tw1stedFate1,CHALLENGER I,605,26.2,183,48,135,eune
36,WP Szati,CHALLENGER I,604,20.1,324,65,259,eune
37,JaguarKWT,CHALLENGER I,600,15.9,195,31,164,eune
38,earlyheart,CHALLENGER I,594,23.7,190,45,145,eune
39,Endø,CHALLENGER I,592,16.9,301,51,250,eune
40,Bardton Senna,CHALLENGER I,591,17.5,332,58,274,eune
41,DIV Fortanu,CHALLENGER I,590,17.6,352,62,290,eune
42,tokkila,CHALLENGER I,586,17.6,364,64,300,eune
43,pjsaig,CHALLENGER I,582,30.9,126,39,87,eune
44,Swimmable Toast,CHALLENGER I,575,27.6,141,39,102,eune
45,hemourenya,CHALLENGER I,570,20.6,282,58,224,eune
46,No Ragrets,CHALLENGER I,566,20.3,306,62,244,eune
47,BillKong,CHALLENGER I,555,19.8,308,61,247,eune
48,Άνεργος,CHALLENGER I,509,14.7,387,57,330,eune
49,Freak Simba,CHALLENGER I,508,12.8,444,57,387,eune
50,4NDI,CHALLENGER I,425,19.6,726,142,584,eune
51,tftsoftexe,"GRANDMASTER I
G",517,19.6,326,64,262,eune
52,KREATOPITA,"GRANDMASTER I
G",510,15.8,291,46,245,eune
53,longlive,"GRANDMASTER I
G",479,13.6,352,48,304,eune
54,citrusZZ,"GRANDMASTER I
G",460,17.7,378,67,311,eune
55,acoj,"GRANDMASTER I
G",455,16.1,286,46,240,eune
56,MARStoiAN,"GRANDMASTER I
G",453,11.5,589,68,521,eune
57,qqqwwweeerrrttt,"GRANDMASTER I
G",442,27.5,309,85,224,eune
58,Redundancia,"GRANDMASTER I
G",439,24.5,335,82,253,eune
59,yuquan,"GRANDMASTER I
G",439,21.2,382,81,301,eune
60,Petrusxa030,"GRANDMASTER I
G",431,16.6,344,57,287,eune
61,DcStarz,"GRANDMASTER I
G",428,20.2,262,53,209,eune
62,nayemnau,"GRANDMASTER I
G",425,20.7,314,65,249,eune
63,jakecn,"GRANDMASTER I
G",421,18.2,209,38,171,eune
64,ŹZ ZZ ZZ ZZ ZZ,"GRANDMASTER I
G",414,15.7,1034,162,872,eune
65,huyabinzi,"GRANDMASTER I
G",401,18.8,240,45,195,eune
66,SaintBlacky,"GRANDMASTER I
G",399,13.1,647,85,562,eune
67,Lucifer Junior,"GRANDMASTER I
G",392,18.9,413,78,335,eune
68,Electrolyze,"GRANDMASTER I
G",392,20.2,257,52,205,eune
69,victor victoris,"GRANDMASTER I
G",386,13.2,539,71,468,eune
70,kasux,"GRANDMASTER I
G",385,25.4,252,64,188,eune
71,deqiang,"GRANDMASTER I
G",378,20.1,278,56,222,eune
72,theq123,"GRANDMASTER I
G",378,18.2,209,38,171,eune
73,yql5201314,"GRANDMASTER I
G",377,27.8,126,35,91,eune
74,SnailDaddy,"GRANDMASTER I
G",373,15.2,611,93,518,eune
75,MaKharg JG,"GRANDMASTER I
G",368,18.0,439,79,360,eune
76,tousinimab,"GRANDMASTER I
G",360,18.3,301,55,246,eune
77,huawuyan,"GRANDMASTER I
G",359,14.3,224,32,192,eune
78,SB CCisMyCounter,"GRANDMASTER I
G",357,17.7,310,55,255,eune
79,forever52,"GRANDMASTER I
G",356,23.9,167,40,127,eune
80,abe the savior,"GRANDMASTER I
G",355,15.9,648,103,545,eune
81,Alfa Bard,"GRANDMASTER I
G",353,23.4,171,40,131,eune
82,laiwanwano,"GRANDMASTER I
G",350,15.9,510,81,429,eune
83,For chr1st sake,"GRANDMASTER I
G",349,11.1,727,81,646,eune
84,ARNOLD,"GRANDMASTER I
G",345,16.4,822,135,687,eune
85,MLxDDD,"GRANDMASTER I
G",342,18.3,387,71,316,eune
86,qiqi277,"GRANDMASTER I
G",342,26.4,129,34,95,eune
87,kEEN v7,"GRANDMASTER I
G",341,18.5,162,30,132,eune
88,dendek,"GRANDMASTER I
G",340,20.6,321,66,255,eune
89,RNGuziuziuzi,"GRANDMASTER I
G",339,29.9,127,38,89,eune
90,12abvt3,"GRANDMASTER I
G",338,23.6,195,46,149,eune
91,LyAmAm,"GRANDMASTER I
G",337,22.1,167,37,130,eune
92,JointBongo,"GRANDMASTER I
G",329,24.1,145,35,110,eune
93,OFC Cute,"GRANDMASTER I
G",326,14.5,454,66,388,eune
94,xiaozhuhuijie,"GRANDMASTER I
G",325,19.7,188,37,151,eune
95,wangyinghui,"GRANDMASTER I
G",324,21.4,131,28,103,eune
96,uzirrr,"GRANDMASTER I
G",318,18.4,305,56,249,eune
97,CHINCZYQ,"GRANDMASTER I
G",317,16.2,142,23,119,eune
98,dlskssss,"GRANDMASTER I
G",313,23.6,148,35,113,eune
99,wangweichuizi,"GRANDMASTER I
G",313,14.3,230,33,197,eune
100,Cuudi,"GRANDMASTER I
G",305,17.3,404,70,334,eune
101,xiangshiyurenhai,"GRANDMASTER I
G",301,15.6,405,63,342,eune
102,Laamakuiskaaja,"GRANDMASTER I
G",298,11.7,633,74,559,eune
103,drma330,"GRANDMASTER I
G",297,16.2,297,48,249,eune
104,Wykonc,"GRANDMASTER I
G",288,17.6,245,43,202,eune
105,baobazhengqi111,"GRANDMASTER I
G",288,25.9,85,22,63,eune
106,Nickon,"GRANDMASTER I
G",286,16.7,383,64,319,eune
107,JJiusan,"GRANDMASTER I
G",285,18.1,288,52,236,eune
108,lplGOOD,"GRANDMASTER I
G",283,17.3,278,48,230,eune
109,lBigossl,"GRANDMASTER I
G",283,11.9,360,43,317,eune
110,Kőrean Jungler,"GRANDMASTER I
G",281,16.1,897,144,753,eune
111,lidayea,"GRANDMASTER I
G",281,15.0,306,46,260,eune
112,Riku Na,"GRANDMASTER I
G",281,30.2,119,36,83,eune
113,sfedis,"GRANDMASTER I
G",278,15.2,368,56,312,eune
114,l StreamR l,"GRANDMASTER I
G",276,17.2,483,83,400,eune
115,Epitheoritiς,"GRANDMASTER I
G",274,15.6,315,49,266,eune
116,Efrebee,"GRANDMASTER I
G",274,20.5,151,31,120,eune
117,harimania,"GRANDMASTER I
G",273,24.4,160,39,121,eune
118,Ih8java,"GRANDMASTER I
G",270,18.4,570,105,465,eune
119,Darosch,"GRANDMASTER I
G",266,13.2,280,37,243,eune
120,onik1997,"GRANDMASTER I
G",264,39.4,104,41,63,eune
121,BlackCats,"GRANDMASTER I
G",263,14.3,532,76,456,eune
122,kecsketej5,"GRANDMASTER I
G",262,18.9,417,79,338,eune
123,SKT Mexes,"GRANDMASTER I
G",262,15.0,233,35,198,eune
124,jijn3rj4j,"GRANDMASTER I
G",258,24.0,150,36,114,eune
125,Donger Bonger,"GRANDMASTER I
G",257,30.7,114,35,79,eune
126,Pana2525,"GRANDMASTER I
G",256,20.6,277,57,220,eune
127,shaodong,"GRANDMASTER I
G",255,14.2,351,50,301,eune
128,islam alghoul,"GRANDMASTER I
G",255,15.4,272,42,230,eune
129,TFT Poulaki,"GRANDMASTER I
G",254,14.3,726,104,622,eune
130,yyyyyye,"GRANDMASTER I
G",253,19.7,411,81,330,eune
131,Challenger Heart,"GRANDMASTER I
G",253,19.0,189,36,153,eune
132,jhghgh,"GRANDMASTER I
G",253,23.0,135,31,104,eune
133,Unlucky Team,"GRANDMASTER I
G",253,15.4,195,30,165,eune
134,lordpepigz,"GRANDMASTER I
G",252,15.3,313,48,265,eune
135,Cerebel22,"GRANDMASTER I
G",249,13.9,259,36,223,eune
136,Hari,"GRANDMASTER I
G",248,16.8,143,24,119,eune
137,Neebo,"GRANDMASTER I
G",246,19.0,226,43,183,eune
138,VERONICA RUN RUN,"GRANDMASTER I
G",243,24.9,245,61,184,eune
139,OSG Legend,"GRANDMASTER I
G",243,16.1,236,38,198,eune
140,Ćelestial,"GRANDMASTER I
G",242,15.2,415,63,352,eune
141,Ο Β Ε Υ,"GRANDMASTER I
G",241,17.3,307,53,254,eune
142,qwbctyz,"GRANDMASTER I
G",238,29.2,144,42,102,eune
143,MiNo22,"GRANDMASTER I
G",238,14.6,253,37,216,eune
144,zyfather,"GRANDMASTER I
G",228,14.6,403,59,344,eune
145,jiaozhiaini,"GRANDMASTER I
G",221,17.5,257,45,212,eune
146,Chieftan Nessus,"GRANDMASTER I
G",219,14.0,214,30,184,eune
147,ALEXPOTTERZ,"GRANDMASTER I
G",198,16.1,211,34,177,eune
148,Apa,"GRANDMASTER I
G",194,13.5,207,28,179,eune
149,LeBronze Jàmes,"GRANDMASTER I
G",155,19.6,519,102,417,eune
150,ibananao,"GRANDMASTER I
G",148,17.7,407,72,335,eune
151,Mvp UnFeeLer,MASTER I,295,20.7,300,62,238,eune
152,Paljo,MASTER I,268,17.3,173,30,143,eune
153,asd110,MASTER I,259,15.7,607,95,512,eune
154,forever88,MASTER I,259,24.9,366,91,275,eune
155,pujsapepa,MASTER I,256,21.1,412,87,325,eune
156,lolchessxogud,MASTER I,251,16.4,189,31,158,eune
157,IceButcher,MASTER I,250,14.3,273,39,234,eune
158,ZBlang,MASTER I,250,29.4,102,30,72,eune
159,fenghenhao,MASTER I,242,24.2,95,23,72,eune
160,laonazaici,MASTER I,237,15.5,265,41,224,eune
161,božský tureto,MASTER I,235,13.5,245,33,212,eune
162,dadudu66,MASTER I,234,23.3,219,51,168,eune
163,rekklescranetail,MASTER I,232,25.0,172,43,129,eune
164,K3NNY1337,MASTER I,231,13.8,355,49,306,eune
165,shenchao1,MASTER I,227,21.2,245,52,193,eune
166,Lethal Presencee,MASTER I,226,15.5,425,66,359,eune
167,Tiro X Eqt,MASTER I,221,13.8,267,37,230,eune
168,plotak,MASTER I,210,20.7,188,39,149,eune
169,Lil Vayne J7,MASTER I,207,19.0,717,136,581,eune
170,EoL,MASTER I,207,20.3,261,53,208,eune
171,shalockkrie,MASTER I,205,17.2,198,34,164,eune
172,xiaofeng998,MASTER I,205,23.9,138,33,105,eune
173,Ykxnbo,MASTER I,203,18.2,258,47,211,eune
174,sdR,MASTER I,201,18.0,460,83,377,eune
175,nóChance,MASTER I,199,14.9,477,71,406,eune
176,haopi99,MASTER I,198,20.5,244,50,194,eune
177,duange666,MASTER I,196,23.9,142,34,108,eune
178,nononoling,MASTER I,196,20.6,141,29,112,eune
179,F1Neee,MASTER I,195,15.3,495,76,419,eune
180,KarnageTheCrane,MASTER I,190,13.2,288,38,250,eune
181,toitos21,MASTER I,189,11.7,446,52,394,eune
182,qiwangwuxiaodi,MASTER I,188,29.0,169,49,120,eune
183,NBDandan,MASTER I,187,16.2,197,32,165,eune
184,Cebanthon,MASTER I,185,25.7,179,46,133,eune
185,Chinese0008,MASTER I,185,25.2,111,28,83,eune
186,cy9696,MASTER I,182,23.2,151,35,116,eune
187,klausrofl twitch,MASTER I,180,13.4,358,48,310,eune
188,faker1209,MASTER I,178,18.4,468,86,382,eune
189,ismeNVT,MASTER I,176,11.4,376,43,333,eune
190,aal233,MASTER I,175,15.4,487,75,412,eune
191,nibuxiang,MASTER I,174,11.8,195,23,172,eune
192,qqsxxeesd,MASTER I,172,18.2,275,50,225,eune
193,tinmar,MASTER I,166,16.5,327,54,273,eune
194,Róach,MASTER I,165,18.1,371,67,304,eune
195,qaqqqqq,MASTER I,165,17.0,223,38,185,eune
196,kunxiang1028,MASTER I,163,17.9,274,49,225,eune
197,mailegebiao,MASTER I,163,26.8,127,34,93,eune
198,LTUGAMER,MASTER I,161,16.6,241,40,201,eune
199,Razyo,MASTER I,157,16.5,273,45,228,eune
200,linyinyin,MASTER I,155,12.2,572,70,502,eune
1,Deis1k,CHALLENGER I,1710,21.4,639,137,502,euw
2,Salvyyy,CHALLENGER I,1675,23.3,288,67,221,euw
3,DarkHighroll,CHALLENGER I,1580,22.6,438,99,339,euw
4,Salvyyy TFT,CHALLENGER I,1502,24.3,416,101,315,euw
5,Gìngg,CHALLENGER I,1355,25.3,328,83,245,euw
6,Luque,CHALLENGER I,1329,17.9,876,157,719,euw
7,DarkHydra,CHALLENGER I,1329,21.1,588,124,464,euw
8,SwellerTiger,CHALLENGER I,1328,19.1,388,74,314,euw
9,GingGG,CHALLENGER I,1286,22.1,745,165,580,euw
10,Leon Trotskij,CHALLENGER I,1269,24.0,338,81,257,euw
11,l2yKo,CHALLENGER I,1266,21.9,1281,280,1001,euw
12,Voltariusx,CHALLENGER I,1259,18.5,432,80,352,euw
13,Voltariux,CHALLENGER I,1191,17.7,519,92,427,euw
14,Lallana,CHALLENGER I,1179,18.7,369,69,300,euw
15,Wet Jungler,CHALLENGER I,1140,15.1,728,110,618,euw
16,fan2Kstagne,CHALLENGER I,1137,22.6,195,44,151,euw
17,Hotline ming,CHALLENGER I,1135,15.9,788,125,663,euw
18,SwellerTigerTFT,CHALLENGER I,1129,13.3,685,91,594,euw
19,Kagerou OwO,CHALLENGER I,1087,20.8,438,91,347,euw
20,Lev D Trotskij,CHALLENGER I,1049,18.5,585,108,477,euw
21,Bèst Heca EUW,CHALLENGER I,1041,18.4,1441,265,1176,euw
22,SmileyCereal,CHALLENGER I,1032,17.7,1178,209,969,euw
23,Un33d,CHALLENGER I,1030,17.3,675,117,558,euw
24,BALOTELLI777 TFT,CHALLENGER I,1029,16.2,501,81,420,euw
25,Lipo Razak,CHALLENGER I,1010,16.6,547,91,456,euw
26,Magarky,CHALLENGER I,1006,16.7,545,91,454,euw
27,Pazi4S,CHALLENGER I,1003,12.2,492,60,432,euw
28,Qetzer,CHALLENGER I,999,15.5,676,105,571,euw
29,Sologesang,CHALLENGER I,972,14.8,586,87,499,euw
30,Phabal,CHALLENGER I,947,14.2,662,94,568,euw
31,Liquid Tabzz,CHALLENGER I,940,21.9,565,124,441,euw
32,Sbstn TFT,CHALLENGER I,932,14.5,538,78,460,euw
33,Sunny Lu,CHALLENGER I,913,17.6,981,173,808,euw
34,outplayingmyself,CHALLENGER I,903,18.4,494,91,403,euw
35,Phbl,CHALLENGER I,900,14.1,683,96,587,euw
36,Deisik,CHALLENGER I,898,18.8,373,70,303,euw
37,iHG Tuttek,CHALLENGER I,874,16.3,742,121,621,euw
38,Raizuken,CHALLENGER I,863,18.3,372,68,304,euw
39,RyKo v2,CHALLENGER I,852,25.4,327,83,244,euw
40,TSM Guillosko,CHALLENGER I,828,15.6,868,135,733,euw
41,IBRAHIMOVIĆ777,CHALLENGER I,824,26.4,216,57,159,euw
42,sayvallahbru,CHALLENGER I,819,14.7,389,57,332,euw
43,Lorus,CHALLENGER I,816,9.5,759,72,687,euw
44,HASHIDA,CHALLENGER I,801,14.0,744,104,640,euw
45,Tits,CHALLENGER I,797,24.1,236,57,179,euw
46,BozzBrain v2,CHALLENGER I,795,14.5,345,50,295,euw
47,Just so xi so,CHALLENGER I,793,19.0,316,60,256,euw
48,Monphis,CHALLENGER I,785,16.4,1208,198,1010,euw
49,lsochan,CHALLENGER I,776,16.7,282,47,235,euw
50,lucky smile boy,CHALLENGER I,771,15.7,1192,187,1005,euw
51,ll TFT KEKW ll,CHALLENGER I,762,14.7,462,68,394,euw
52,PonRoo,CHALLENGER I,761,12.5,1025,128,897,euw
53,JdnTagNovoline,CHALLENGER I,760,21.0,200,42,158,euw
54,Palaloa,CHALLENGER I,759,16.3,245,40,205,euw
55,Némaïdès,CHALLENGER I,757,14.1,618,87,531,euw
56,dirtyspear,CHALLENGER I,756,15.6,508,79,429,euw
57,AKA magic,CHALLENGER I,741,12.9,800,103,697,euw
58,Kezman,CHALLENGER I,739,19.4,345,67,278,euw
59,Dedicasse Fahd,CHALLENGER I,738,16.0,645,103,542,euw
60,TarteMan TFT,CHALLENGER I,737,15.1,463,70,393,euw
61,kassellen,CHALLENGER I,736,13.2,985,130,855,euw
62,BeasTFT2,CHALLENGER I,736,19.6,204,40,164,euw
63,Sñus,CHALLENGER I,735,18.6,1185,221,964,euw
64,Sparakay TFT,CHALLENGER I,735,15.3,267,41,226,euw
65,BenVK,CHALLENGER I,719,16.2,625,101,524,euw
66,MogamboDTB,CHALLENGER I,717,12.6,294,37,257,euw
67,Cachual,CHALLENGER I,715,25.6,219,56,163,euw
68,RazakTFT,CHALLENGER I,713,15.0,1067,160,907,euw
69,slime03,CHALLENGER I,712,16.9,549,93,456,euw
70,Banisher95,CHALLENGER I,711,13.5,488,66,422,euw
71,RICH H0MIE QUAN,CHALLENGER I,710,15.1,291,44,247,euw
72,dknsbs,CHALLENGER I,708,15.9,552,88,464,euw
73,ajoe1231,CHALLENGER I,703,17.6,813,143,670,euw
74,Can I trust you,CHALLENGER I,702,20.5,283,58,225,euw
75,Khristor,CHALLENGER I,699,14.8,399,59,340,euw
76,Sayorï best girl,CHALLENGER I,695,17.4,242,42,200,euw
77,JedenTagNovoline,CHALLENGER I,691,23.4,197,46,151,euw
78,TFT Enzosexe,CHALLENGER I,690,12.3,912,112,800,euw
79,FluffyHS,CHALLENGER I,690,16.4,445,73,372,euw
80,Miiouw,CHALLENGER I,685,14.5,524,76,448,euw
81,Palaloa TFT,CHALLENGER I,682,13.1,474,62,412,euw
82,Bränk,CHALLENGER I,681,15.6,473,74,399,euw
83,Rïft,CHALLENGER I,680,16.0,225,36,189,euw
84,Xerxan,CHALLENGER I,678,15.2,678,103,575,euw
85,Ev4ngelion,CHALLENGER I,670,16.5,702,116,586,euw
86,TFT Buttons,CHALLENGER I,669,16.1,615,99,516,euw
87,Un11d,CHALLENGER I,669,17.9,341,61,280,euw
88,Zyriosly,CHALLENGER I,666,16.8,912,153,759,euw
89,TehSilli,CHALLENGER I,666,19.6,409,80,329,euw
90,5454XD,CHALLENGER I,663,17.1,555,95,460,euw
91,TFTACKK,CHALLENGER I,663,25.9,197,51,146,euw
92,PUNISH1nG,CHALLENGER I,661,17.6,290,51,239,euw
93,BALOTELLI777,CHALLENGER I,659,18.6,533,99,434,euw
94,AmuuMuu,CHALLENGER I,656,12.0,1055,127,928,euw
95,IceLoom,CHALLENGER I,654,17.8,242,43,199,euw
96,WINZEEER,CHALLENGER I,649,14.9,749,112,637,euw
97,rare not nice,CHALLENGER I,645,15.2,591,90,501,euw
98,OnlyBetter,CHALLENGER I,643,9.9,415,41,374,euw
99,LeDuck TFT,CHALLENGER I,640,16.9,1138,193,945,euw
100,Göl D Roger,CHALLENGER I,640,12.7,812,103,709,euw
101,Kÿu,CHALLENGER I,639,17.4,407,71,336,euw
102,Adonis17,CHALLENGER I,638,16.7,774,129,645,euw
103,iPoPz v2,CHALLENGER I,637,19.0,210,40,170,euw
104,Can I mock you,CHALLENGER I,630,28.6,140,40,100,euw
105,LIPO Absykos,CHALLENGER I,628,14.2,414,59,355,euw
106,Xeno TFTx,CHALLENGER I,620,10.2,780,80,700,euw
107,męntal,CHALLENGER I,617,13.6,545,74,471,euw
108,ahuia,CHALLENGER I,617,19.2,229,44,185,euw
109,Tatufo,CHALLENGER I,614,14.2,626,89,537,euw
110,Yanís,CHALLENGER I,614,16.1,415,67,348,euw
111,kacpersky191TFT,CHALLENGER I,611,14.2,857,122,735,euw
112,YowiTFT,CHALLENGER I,611,20.6,247,51,196,euw
113,Gôn Freeçss,CHALLENGER I,610,20.9,278,58,220,euw
114,YPRN Chwbk,CHALLENGER I,609,18.7,321,60,261,euw
115,Jedi Master AK,CHALLENGER I,606,16.4,939,154,785,euw
116,o0OLyReO0o,CHALLENGER I,605,19.7,294,58,236,euw
117,Kjekken123,CHALLENGER I,602,20.1,518,104,414,euw
118,TFT Emperador,CHALLENGER I,601,13.2,947,125,822,euw
119,Vicer v2,CHALLENGER I,600,15.0,306,46,260,euw
120,Kenopsia,CHALLENGER I,597,10.1,889,90,799,euw
121,TFT ArKoK,CHALLENGER I,593,15.7,898,141,757,euw
122,Nutscrackeros,CHALLENGER I,593,15.2,231,35,196,euw
123,always be hape,CHALLENGER I,592,17.7,385,68,317,euw
124,Drunkiris,CHALLENGER I,592,20.0,305,61,244,euw
125,T4nPoP,CHALLENGER I,589,15.3,1459,224,1235,euw
126,MCMCinITALY,CHALLENGER I,589,18.5,497,92,405,euw
127,Freezzette,CHALLENGER I,589,12.0,640,77,563,euw
128,Suisaiga 2,CHALLENGER I,589,17.2,423,73,350,euw
129,LeDuck v2,CHALLENGER I,589,15.3,437,67,370,euw
130,zomgowy,CHALLENGER I,584,17.4,235,41,194,euw
131,Liber8 Hong Kong,CHALLENGER I,583,17.4,489,85,404,euw
132,Warmeur le vrai,CHALLENGER I,582,22.9,223,51,172,euw
133,The Gay Minion,CHALLENGER I,581,13.5,637,86,551,euw
134,Sirfetchd,CHALLENGER I,578,10.4,299,31,268,euw
135,Subahibi,CHALLENGER I,577,14.7,434,64,370,euw
136,Nyan Zebra,CHALLENGER I,575,16.3,252,41,211,euw
137,MaCkTFT,CHALLENGER I,570,12.9,1628,210,1418,euw
138,hongmorongguang,CHALLENGER I,567,18.0,361,65,296,euw
139,FengXiaoQiLing,CHALLENGER I,566,22.9,266,61,205,euw
140,Whiteyeas,CHALLENGER I,566,14.5,344,50,294,euw
141,KAD Mason,CHALLENGER I,563,16.5,284,47,237,euw
142,birdyrrr,CHALLENGER I,561,18.3,251,46,205,euw
143,Billgax,CHALLENGER I,560,13.9,562,78,484,euw
144,5454,CHALLENGER I,560,14.6,520,76,444,euw
145,stayl23,CHALLENGER I,560,13.7,481,66,415,euw
146,Sir Bobz,CHALLENGER I,559,10.9,450,49,401,euw
147,Futaken,CHALLENGER I,557,16.3,263,43,220,euw
148,Wholean,CHALLENGER I,556,12.1,527,64,463,euw
149,Sløt,CHALLENGER I,556,17.4,316,55,261,euw
150,Döbereiner,CHALLENGER I,555,16.0,613,98,515,euw
151,VicerTFT,CHALLENGER I,554,15.6,443,69,374,euw
152,Summuner Name,CHALLENGER I,554,18.9,297,56,241,euw
153,GRIEFER XDDD,CHALLENGER I,549,18.7,251,47,204,euw
154,Zididi,CHALLENGER I,546,15.7,1538,242,1296,euw
155,TheUnbornYordle,CHALLENGER I,546,13.4,350,47,303,euw
156,Kirbes,CHALLENGER I,545,14.9,435,65,370,euw
157,Esel51,CHALLENGER I,544,11.5,391,45,346,euw
158,EnlèveTesMoufles,CHALLENGER I,543,17.6,295,52,243,euw
159,hi im hochin,CHALLENGER I,542,17.1,322,55,267,euw
160,JollyFaker777,CHALLENGER I,540,16.1,361,58,303,euw
161,Rehnz,CHALLENGER I,539,14.6,734,107,627,euw
162,Bersalis,CHALLENGER I,538,16.0,332,53,279,euw
163,Lonnen,CHALLENGER I,536,14.2,537,76,461,euw
164,WawaTatata,CHALLENGER I,536,13.6,557,76,481,euw
165,spongebob smiley,CHALLENGER I,536,16.9,414,70,344,euw
166,Lelouuch,CHALLENGER I,535,16.2,320,52,268,euw
167,Bersa TFT,CHALLENGER I,530,15.9,517,82,435,euw
168,idlemonk TFT,CHALLENGER I,530,10.8,622,67,555,euw
169,MarooNTFT,CHALLENGER I,530,17.1,210,36,174,euw
170,Lynn Risa,CHALLENGER I,529,17.1,491,84,407,euw
171,I R INVINC1BLE,CHALLENGER I,527,15.1,737,111,626,euw
172,UnbornYordle,CHALLENGER I,527,18.2,506,92,414,euw
173,MapleKK,CHALLENGER I,526,19.6,194,38,156,euw
174,Itario,CHALLENGER I,525,12.6,451,57,394,euw
175,dameoiseau,CHALLENGER I,525,12.3,269,33,236,euw
176,Funkfreed,CHALLENGER I,524,16.1,341,55,286,euw
177,Korra HD,CHALLENGER I,524,26.9,134,36,98,euw
178,Pray to RNG god,CHALLENGER I,523,12.8,297,38,259,euw
179,Tschabading,CHALLENGER I,519,13.5,865,117,748,euw
180,YowiTFT2,CHALLENGER I,516,20.7,222,46,176,euw
181,TeemoDaSlayer420,CHALLENGER I,515,20.7,179,37,142,euw
182,Gilozinho,CHALLENGER I,514,13.4,910,122,788,euw
183,Ranceta,CHALLENGER I,514,11.4,560,64,496,euw
184,G2 ReventXz,CHALLENGER I,514,20.6,305,63,242,euw
185,Genotik,CHALLENGER I,514,13.4,469,63,406,euw
186,Racklure,CHALLENGER I,513,14.4,914,132,782,euw
187,iPoPz,CHALLENGER I,513,16.4,549,90,459,euw
188,sun666shine,CHALLENGER I,512,19.3,342,66,276,euw
189,joel19,CHALLENGER I,510,11.4,1028,117,911,euw
190,gluteus maxímus,CHALLENGER I,509,16.2,394,64,330,euw
191,Kalflo,CHALLENGER I,508,12.5,1280,160,1120,euw
192,AquareIIe,CHALLENGER I,508,17.2,331,57,274,euw
193,BenVK TFT,CHALLENGER I,508,16.6,343,57,286,euw
194,Shσtgun,CHALLENGER I,507,15.5,779,121,658,euw
195,Sτοrm,CHALLENGER I,507,14.9,740,110,630,euw
196,Doud78,CHALLENGER I,507,17.9,329,59,270,euw
197,iamTLT,CHALLENGER I,505,12.3,334,41,293,euw
198,zoomgowy,CHALLENGER I,504,19.2,224,43,181,euw
199,Alpha Player 2,CHALLENGER I,502,15.6,469,73,396,euw
200,justinng,CHALLENGER I,502,17.5,389,68,321,euw
1,Hiraino,CHALLENGER I,711,22.0,441,97,344,jp
2,思い出の昼下がり,CHALLENGER I,544,26.3,209,55,154,jp
3,chocotto,CHALLENGER I,529,21.7,484,105,379,jp
4,dayona,CHALLENGER I,525,17.6,1115,196,919,jp
5,pureheart player,CHALLENGER I,508,18.6,425,79,346,jp
6,hakutou,CHALLENGER I,498,24.2,691,167,524,jp
7,KKQ,CHALLENGER I,481,21.3,352,75,277,jp
8,じーく,CHALLENGER I,476,19.1,335,64,271,jp
9,むむっ,CHALLENGER I,462,22.1,316,70,246,jp
10,Age 21,CHALLENGER I,451,22.4,201,45,156,jp
11,Shroud Fanboy,CHALLENGER I,439,15.7,1090,171,919,jp
12,Best 佐藤 JP,CHALLENGER I,432,24.0,250,60,190,jp
13,シャドウバース,CHALLENGER I,391,19.0,630,120,510,jp
14,Best太郎JP,CHALLENGER I,386,21.9,338,74,264,jp
15,ajun,CHALLENGER I,373,17.9,739,132,607,jp
16,害獣あらいぐま,CHALLENGER I,365,13.3,413,55,358,jp
17,ひまわり準決勝,CHALLENGER I,360,25.0,196,49,147,jp
18,etsuya0505,CHALLENGER I,342,16.6,565,94,471,jp
19,God Fukuoka,CHALLENGER I,337,19.4,365,71,294,jp
20,kes,CHALLENGER I,314,19.2,369,71,298,jp
21,だよな,CHALLENGER I,294,21.3,211,45,166,jp
22,HiROKKtft,CHALLENGER I,289,19.4,340,66,274,jp
23,young4u,CHALLENGER I,285,17.4,374,65,309,jp
24,りーり,CHALLENGER I,276,13.0,1015,132,883,jp
25,Adrenaline,CHALLENGER I,274,18.7,502,94,408,jp
26,煩いマン,CHALLENGER I,272,17.2,279,48,231,jp
27,えっっ,CHALLENGER I,272,17.6,222,39,183,jp
28,Hechima777,CHALLENGER I,260,14.9,691,103,588,jp
29,trotv,CHALLENGER I,241,15.7,522,82,440,jp
30,大門未知子,CHALLENGER I,234,18.9,196,37,159,jp
31,dozepk,CHALLENGER I,228,15.2,441,67,374,jp
32,vvvvvvvvvipp,CHALLENGER I,227,18.6,543,101,442,jp
33,Twisted Fate Bot,CHALLENGER I,224,16.7,353,59,294,jp
34,dozeqk,CHALLENGER I,222,19.6,214,42,172,jp
35,Jackn,CHALLENGER I,216,22.7,255,58,197,jp
36,沼の大破神,CHALLENGER I,210,19.7,299,59,240,jp
37,macro11,CHALLENGER I,207,17.4,311,54,257,jp
38,喚くマン,CHALLENGER I,202,18.1,441,80,361,jp
39,sueno09,CHALLENGER I,198,14.3,286,41,245,jp
40,FoT DazzingDog,CHALLENGER I,176,21.7,277,60,217,jp
41,deárest,CHALLENGER I,176,26.7,101,27,74,jp
42,pveman,CHALLENGER I,174,18.7,358,67,291,jp
43,Waterfox,CHALLENGER I,171,12.8,305,39,266,jp
44,賃砲丸出侍,CHALLENGER I,157,23.6,212,50,162,jp
45,秋水宴,CHALLENGER I,154,16.4,269,44,225,jp
46,karakuti,CHALLENGER I,148,19.6,229,45,184,jp
47,elfiny,CHALLENGER I,146,19.0,168,32,136,jp
48,Yaruo,CHALLENGER I,128,17.0,283,48,235,jp
49,rionest,CHALLENGER I,122,17.3,1071,185,886,jp
50,Tぽいんと,CHALLENGER I,116,20.2,307,62,245,jp
51,山田周人,"GRANDMASTER I
G",155,16.3,491,80,411,jp
52,Ponty,"GRANDMASTER I
G",121,15.7,783,123,660,jp
53,ぼんちょび,"GRANDMASTER I
G",100,25.3,178,45,133,jp
54,濃厚鶏白湯拉麺,"GRANDMASTER I
G",85,16.8,202,34,168,jp
55,かふす,"GRANDMASTER I
G",77,18.4,837,154,683,jp
56,Count Mak,"GRANDMASTER I
G",73,19.8,445,88,357,jp
57,ますにゃ,"GRANDMASTER I
G",72,13.6,778,106,672,jp
58,まくらi,"GRANDMASTER I
G",67,21.1,180,38,142,jp
59,center8128,"GRANDMASTER I
G",65,15.3,196,30,166,jp
60,しかめまどか2,"GRANDMASTER I
G",64,23.2,224,52,172,jp
61,dngr,"GRANDMASTER I
G",63,17.3,283,49,234,jp
62,bonchobi,"GRANDMASTER I
G",62,15.2,472,72,400,jp
63,Piyochan76,"GRANDMASTER I
G",54,15.9,283,45,238,jp
64,URUUUU,"GRANDMASTER I
G",53,19.5,462,90,372,jp
65,pccc,"GRANDMASTER I
G",50,31.9,91,29,62,jp
66,にじむら,"GRANDMASTER I
G",43,12.3,734,90,644,jp
67,理解のある彼くん,"GRANDMASTER I
G",43,16.5,431,71,360,jp
68,bappy,"GRANDMASTER I
G",41,17.8,805,143,662,jp
69,醤ØuØ油,"GRANDMASTER I
G",29,13.8,900,124,776,jp
70,contrail,"GRANDMASTER I
G",29,17.9,151,27,124,jp
71,millepiedi,"GRANDMASTER I
G",23,13.9,273,38,235,jp
72,ZmLFs2z,"GRANDMASTER I
G",21,21.8,156,34,122,jp
73,しかめまどか,"GRANDMASTER I
G",20,14.3,1331,191,1140,jp
74,ekollon,"GRANDMASTER I
G",19,17.9,424,76,348,jp
75,モルディ貝,"GRANDMASTER I
G",17,16.2,321,52,269,jp
76,enamel,"GRANDMASTER I
G",16,9.2,368,34,334,jp
77,Caplico,"GRANDMASTER I
G",15,18.1,254,46,208,jp
78,Remixi,"GRANDMASTER I
G",14,12.9,202,26,176,jp
79,MrJefferz,"GRANDMASTER I
G",13,16.2,531,86,445,jp
80,丸の内LOLレイナ,"GRANDMASTER I
G",13,16.1,429,69,360,jp
81,新ふうちゃん,"GRANDMASTER I
G",13,13.3,256,34,222,jp
82,夜空丶,"GRANDMASTER I
G",12,19.8,192,38,154,jp
83,Kuririman,"GRANDMASTER I
G",8,14.9,268,40,228,jp
84,Rhino Cider,"GRANDMASTER I
G",5,12.7,205,26,179,jp
85,admin testuser01,"GRANDMASTER I
G",3,14.8,849,126,723,jp
86,misomega,"GRANDMASTER I
G",1,16.0,406,65,341,jp
87,さとるくん,"GRANDMASTER I
G",1,11.3,459,52,407,jp
88,7zigeN,"GRANDMASTER I
G",0,17.7,1001,177,824,jp
89,にぶさき,"GRANDMASTER I
G",0,15.6,1022,159,863,jp
90,loraplayer,"GRANDMASTER I
G",0,17.3,828,143,685,jp
91,Hermes0,"GRANDMASTER I
G",0,16.3,771,126,645,jp
92,平丼堅,"GRANDMASTER I
G",0,14.8,717,106,611,jp
93,じょん炊いたー,"GRANDMASTER I
G",0,20.8,351,73,278,jp
94,たなってぃ,"GRANDMASTER I
G",0,16.7,437,73,364,jp
95,Shield Samba,"GRANDMASTER I
G",0,13.9,497,69,428,jp
96,nijimuraact2,"GRANDMASTER I
G",0,15.3,445,68,377,jp
97,GoodMannerU5,"GRANDMASTER I
G",0,14.1,439,62,377,jp
98,Worst Takashi JP,"GRANDMASTER I
G",0,12.7,464,59,405,jp
99,tomonar1,"GRANDMASTER I
G",0,14.1,410,58,352,jp
100,此方より彼方まで,"GRANDMASTER I
G",0,16.9,307,52,255,jp
101,tinko irelia,"GRANDMASTER I
G",0,16.7,275,46,229,jp
102,KR blonde lov,"GRANDMASTER I
G",0,20.8,216,45,171,jp
103,ciple753,"GRANDMASTER I
G",0,12.9,317,41,276,jp
104,ポッチャマ,"GRANDMASTER I
G",0,11.9,319,38,281,jp
105,ぜろななにーいち,"GRANDMASTER I
G",0,21.5,172,37,135,jp
106,kotogane411,"GRANDMASTER I
G",0,17.6,210,37,173,jp
107,Ugokeru Debu Bot,"GRANDMASTER I
G",0,16.0,225,36,189,jp
108,はんえつか,"GRANDMASTER I
G",0,16.2,216,35,181,jp
109,曖昧心,"GRANDMASTER I
G",0,14.6,239,35,204,jp
110,tola,"GRANDMASTER I
G",0,14.2,232,33,199,jp
111,ロルから逃げるな,"GRANDMASTER I
G",0,19.4,165,32,133,jp
112,ゲッティスパ美,"GRANDMASTER I
G",0,18.4,163,30,133,jp
113,ぽこくま,"GRANDMASTER I
G",0,17.9,162,29,133,jp
114,マグロマート,"GRANDMASTER I
G",0,18.5,151,28,123,jp
115,涼風あおば,"GRANDMASTER I
G",0,17.3,127,22,105,jp
116,Gafu,MASTER I,26,13.9,864,120,744,jp
117,えんどほーぷ,MASTER I,1,8.9,630,56,574,jp
118,CosplayGirl,DIAMOND I,94,22.7,242,55,187,jp
119,いまのん,DIAMOND I,92,17.8,353,63,290,jp
120,Eidechse,DIAMOND I,91,16.4,220,36,184,jp
121,shuraha3,DIAMOND I,87,16.3,380,62,318,jp
122,チャイコフスキー,DIAMOND I,80,14.2,1059,150,909,jp
123,sack dance,DIAMOND I,78,11.1,1048,116,932,jp
124,askrp,DIAMOND I,75,17.0,569,97,472,jp
125,Raias,DIAMOND I,75,16.3,522,85,437,jp
126,xtc,DIAMOND I,75,17.9,441,79,362,jp
127,Sukizofureni,DIAMOND I,75,13.3,548,73,475,jp
128,lalabybyby,DIAMOND I,75,15.6,461,72,389,jp
129,MichaelChan,DIAMOND I,75,17.7,317,56,261,jp
130,名取ざや,DIAMOND I,75,23.6,229,54,175,jp
131,ap top mom die,DIAMOND I,75,23.3,232,54,178,jp
132,ききちま,DIAMOND I,75,18.2,285,52,233,jp
133,福山はさまるJP,DIAMOND I,75,16.3,307,50,257,jp
134,夏目純夏,DIAMOND I,75,25.1,167,42,125,jp
135,ABEKANZOU,DIAMOND I,75,19.5,210,41,169,jp
136,スルギすき,DIAMOND I,75,16.7,204,34,170,jp
137,オーシャン増永,DIAMOND I,75,18.8,176,33,143,jp
138,クックパッド歩美,DIAMOND I,75,21.1,147,31,116,jp
139,IKUTOMIE,DIAMOND I,75,11.4,228,26,202,jp
140,いけなる,DIAMOND I,74,16.7,798,133,665,jp
141,AikaS,DIAMOND I,74,16.3,728,119,609,jp
142,お前のレベル笑,DIAMOND I,72,20.8,403,84,319,jp
143,日高愛,DIAMOND I,70,15.4,422,65,357,jp
144,くりちゃん大好き,DIAMOND I,69,21.4,159,34,125,jp
145,shuraha4,DIAMOND I,61,13.0,315,41,274,jp
146,1515225,DIAMOND I,59,14.9,376,56,320,jp
147,ゆっちー,DIAMOND I,59,12.3,375,46,329,jp
148,汝何着品如衣,DIAMOND I,59,15.9,232,37,195,jp
149,Jethro Cyrus,DIAMOND I,57,13.9,634,88,546,jp
150,satohige,DIAMOND I,46,16.5,532,88,444,jp
151,Rin09,DIAMOND I,45,14.8,249,37,212,jp
152,mikan0x0,DIAMOND I,42,12.7,764,97,667,jp
153,I DO RAMMUS JUNG,DIAMOND I,42,16.7,329,55,274,jp
154,koogie,DIAMOND I,39,14.3,343,49,294,jp
155,M700LTR,DIAMOND I,37,15.0,294,44,250,jp
156,犬走椛,DIAMOND I,35,19.4,139,27,112,jp
157,foxbaby123b,DIAMOND I,34,13.7,541,74,467,jp
158,forever18,DIAMOND I,32,16.3,361,59,302,jp
159,VTAKU77,DIAMOND I,31,11.2,179,20,159,jp
160,てっくてっく,DIAMOND I,27,17.8,304,54,250,jp
161,Nochita,DIAMOND I,25,11.8,338,40,298,jp
162,ButaDaJoe,DIAMOND I,25,19.5,190,37,153,jp
163,世界詞のキア,DIAMOND I,24,16.7,126,21,105,jp
164,InventusGaming,DIAMOND I,23,10.5,351,37,314,jp
165,うるるる,DIAMOND I,21,21.2,137,29,108,jp
166,hohe,DIAMOND I,20,16.4,627,103,524,jp
167,neetneo,DIAMOND I,16,20.9,210,44,166,jp
168,HitujiDaJoe,DIAMOND I,13,16.4,195,32,163,jp
169,low roller,DIAMOND I,11,17.5,183,32,151,jp
170,ダンボ君,DIAMOND I,11,17.4,161,28,133,jp
171,srinm,DIAMOND I,9,15.3,524,80,444,jp
172,laser501,DIAMOND I,9,16.0,244,39,205,jp
173,XionNoi,DIAMOND I,6,18.1,398,72,326,jp
174,福山はさまるNA,DIAMOND I,5,19.7,147,29,118,jp
175,pano,DIAMOND I,3,17.1,486,83,403,jp
176,エミュー,DIAMOND I,3,14.2,464,66,398,jp
177,アイルー卿,DIAMOND I,2,15.1,365,55,310,jp
178,Why So Serious,DIAMOND I,1,14.7,319,47,272,jp
179,このばかちんがぁ,DIAMOND I,1,14.6,239,35,204,jp
180,ばーじん,DIAMOND I,0,14.8,905,134,771,jp
181,SMA,DIAMOND I,0,12.8,705,90,615,jp
182,gacchapin20,DIAMOND I,0,13.4,649,87,562,jp
183,ーAkiraー,DIAMOND I,0,14.6,405,59,346,jp
184,sasayamavo,DIAMOND I,0,8.1,664,54,610,jp
185,Satolis,DIAMOND I,0,9.8,439,43,396,jp
186,Endcyclone,DIAMOND I,0,27.0,148,40,108,jp
187,IlllIlllIlllI,DIAMOND I,0,20.2,178,36,142,jp
188,siva fes,DIAMOND I,0,12.5,279,35,244,jp
189,キャンディ  猫,DIAMOND I,0,19.6,173,34,139,jp
190,yatsuhashi567,DIAMOND I,0,13.5,251,34,217,jp
191,下了88,DIAMOND I,0,27.6,116,32,84,jp
192,toudoriDX2,DIAMOND I,0,9.9,302,30,272,jp
193,watchhhhhh,DIAMOND I,0,18.5,151,28,123,jp
194,εOnOз,DIAMOND I,0,18.7,139,26,113,jp
195,shinano,DIAMOND I,0,15.2,171,26,145,jp
196,nasyoter,DIAMOND I,0,15.1,139,21,118,jp
197,所念皆星河,DIAMOND II,96,18.7,316,59,257,jp
198,newie,DIAMOND II,94,15.5,328,51,277,jp
199,AHIKJDK,DIAMOND II,92,27.2,103,28,75,jp
200,キイロイトリ3,DIAMOND II,80,13.3,255,34,221,jp
1,AFTV 꼴픽이,CHALLENGER I,1689,19.1,1018,195,823,kr
2,곰과제리2,CHALLENGER I,1585,20.1,314,63,251,kr
3,정동글,CHALLENGER I,1465,18.0,601,108,493,kr
4,김린Or남친,CHALLENGER I,1460,18.8,958,180,778,kr
5,퐈피는잘못없어,CHALLENGER I,1441,17.8,1199,214,985,kr
6,곰과제리,CHALLENGER I,1331,18.6,857,159,698,kr
7,Alle Deli,CHALLENGER I,1318,14.7,511,75,436,kr
8,BAAMM,CHALLENGER I,1312,19.1,1380,263,1117,kr
9,shungjinsoo,CHALLENGER I,1309,17.8,909,162,747,kr
10,스트롱뽀송뽀송,CHALLENGER I,1305,14.9,1010,151,859,kr
11,정동글2,CHALLENGER I,1300,18.2,341,62,279,kr
12,알레 델리,CHALLENGER I,1277,22.2,297,66,231,kr
13,난몰라,CHALLENGER I,1239,17.2,431,74,357,kr
14,바삭한빵,CHALLENGER I,1210,18.6,477,89,388,kr
15,펠새로이,CHALLENGER I,1201,18.1,733,133,600,kr
16,종자잇,CHALLENGER I,1195,16.6,427,71,356,kr
17,체주미,CHALLENGER I,1195,17.7,311,55,256,kr
18,Cherryon,CHALLENGER I,1191,15.5,969,150,819,kr
19,축 꾸,CHALLENGER I,1175,18.1,937,170,767,kr
20,럭키체스777,CHALLENGER I,1165,13.5,726,98,628,kr
21,아기용1,CHALLENGER I,1125,19.8,1618,321,1297,kr
22,AFTV 웃바,CHALLENGER I,1099,18.2,619,113,506,kr
23,난몰라2,CHALLENGER I,1078,12.9,536,69,467,kr
24,귀여운쫑이자나,CHALLENGER I,1073,17.0,895,152,743,kr
25,깽 만,CHALLENGER I,1067,13.3,829,110,719,kr
26,기도메타777,CHALLENGER I,1066,13.9,337,47,290,kr
27,피노키훈,CHALLENGER I,1045,18.4,815,150,665,kr
28,TZ 제리,CHALLENGER I,1045,14.6,608,89,519,kr
29,두니주니,CHALLENGER I,1041,18.4,1336,246,1090,kr
30,알맹승지2,CHALLENGER I,1039,10.8,520,56,464,kr
31,알맹승지,CHALLENGER I,1038,11.9,621,74,547,kr
32,Park Eunbin,CHALLENGER I,1032,17.2,464,80,384,kr
33,왜 나만 운없냐,CHALLENGER I,1030,17.7,362,64,298,kr
34,마스터 3,CHALLENGER I,1018,10.5,850,89,761,kr
35,My Paradise,CHALLENGER I,1017,23.1,763,176,587,kr
36,shungjinsoo2,CHALLENGER I,1016,16.4,495,81,414,kr
37,화살 세례,CHALLENGER I,1008,17.4,706,123,583,kr
38,SanChess,CHALLENGER I,1004,17.1,651,111,540,kr
39,홀애비2,CHALLENGER I,963,18.1,1106,200,906,kr
40,현이야아아,CHALLENGER I,939,13.3,850,113,737,kr
41,곰과제리3,CHALLENGER I,937,16.2,414,67,347,kr
42,끓인사발면,CHALLENGER I,933,19.7,380,75,305,kr
43,김유Or,CHALLENGER I,929,16.9,534,90,444,kr
44,패트롤원툴,CHALLENGER I,922,17.1,642,110,532,kr
45,보이지않는기물,CHALLENGER I,917,18.3,496,91,405,kr
46,초보끼리합시다,CHALLENGER I,916,14.4,800,115,685,kr
47,Fiora TOP,CHALLENGER I,909,12.3,665,82,583,kr
48,카시장인 삿카시,CHALLENGER I,908,14.7,428,63,365,kr
49,이Or름,CHALLENGER I,906,11.4,1083,124,959,kr
50,펠 다,CHALLENGER I,902,23.7,401,95,306,kr
51,푸딩턱털낼름낼름,CHALLENGER I,899,19.9,331,66,265,kr
52,노마딕,CHALLENGER I,889,17.5,693,121,572,kr
53,엠브로돈까스,CHALLENGER I,886,18.1,1559,283,1276,kr
54,안산시청,CHALLENGER I,877,17.2,536,92,444,kr
55,궁뎅크니,CHALLENGER I,872,15.1,779,118,661,kr
56,사랑해꿀아,CHALLENGER I,868,15.0,580,87,493,kr
57,청정민,CHALLENGER I,857,14.0,1372,192,1180,kr
58,노래하는 쭌,CHALLENGER I,856,11.0,916,101,815,kr
59,꽃피그,CHALLENGER I,845,18.2,285,52,233,kr
60,머리한입꼬리한입,CHALLENGER I,843,16.2,1060,172,888,kr
61,버그활용법,CHALLENGER I,843,25.9,286,74,212,kr
62,천득 Youtube,CHALLENGER I,839,16.1,427,69,358,kr
63,천 득,CHALLENGER I,839,14.2,444,63,381,kr
64,내가더사기얍,CHALLENGER I,838,15.8,518,82,436,kr
65,안지영,CHALLENGER I,837,18.1,342,62,280,kr
66,물소타,CHALLENGER I,833,15.1,1013,153,860,kr
67,로자이어,CHALLENGER I,832,12.7,684,87,597,kr
68,쓰레쉬핵초고수,CHALLENGER I,831,14.5,827,120,707,kr
69,lxry,CHALLENGER I,831,13.8,304,42,262,kr
70,삐진범,CHALLENGER I,829,15.0,306,46,260,kr
71,킨드레드블루그린,CHALLENGER I,824,17.1,790,135,655,kr
72,woiwoer12,CHALLENGER I,821,15.8,1026,162,864,kr
73,hiimg4nmi,CHALLENGER I,809,15.1,830,125,705,kr
74,원도깨비,CHALLENGER I,803,14.8,505,75,430,kr
75,호랑이찌찌젖짜기,CHALLENGER I,802,15.3,561,86,475,kr
76,나혼산,CHALLENGER I,799,16.1,347,56,291,kr
77,고유나,CHALLENGER I,798,16.3,424,69,355,kr
78,44990189del,CHALLENGER I,795,19.2,621,119,502,kr
79,바위게줍기장인,CHALLENGER I,791,15.2,875,133,742,kr
80,최killing,CHALLENGER I,789,12.4,774,96,678,kr
81,세번째차인달삼,CHALLENGER I,785,17.7,941,167,774,kr
82,유후a,CHALLENGER I,779,17.2,638,110,528,kr
83,정동기리,CHALLENGER I,773,17.1,339,58,281,kr
84,끓인사발면2,CHALLENGER I,773,23.8,214,51,163,kr
85,롤체고오수,CHALLENGER I,773,16.6,241,40,201,kr
86,롤접으면여친생김,CHALLENGER I,766,16.5,382,63,319,kr
87,Eunso,CHALLENGER I,760,14.7,1052,155,897,kr
88,전설의소라고동,CHALLENGER I,759,15.5,747,116,631,kr
89,종범1,CHALLENGER I,758,17.9,251,45,206,kr
90,Dosu0,CHALLENGER I,757,18.8,240,45,195,kr
91,AFTV 구루루,CHALLENGER I,753,14.8,1402,208,1194,kr
92,체스보이민다빈,CHALLENGER I,747,17.4,1386,241,1145,kr
93,빅머니장사장,CHALLENGER I,747,17.9,448,80,368,kr
94,랑조췻,CHALLENGER I,742,11.8,1523,180,1343,kr
95,Everton FAN,CHALLENGER I,742,11.2,391,44,347,kr
96,옴팡이,CHALLENGER I,741,19.7,1485,292,1193,kr
97,k1moddi,CHALLENGER I,741,18.8,218,41,177,kr
98,Younna,CHALLENGER I,738,21.0,186,39,147,kr
99,개 북,CHALLENGER I,736,17.8,422,75,347,kr
100,AFTV 깔창부린,CHALLENGER I,733,15.9,1866,296,1570,kr
101,AF HappyVirus,CHALLENGER I,733,18.5,292,54,238,kr
102,그레이스바라기,CHALLENGER I,733,14.2,310,44,266,kr
103,90972114del,CHALLENGER I,729,16.0,1008,161,847,kr
104,조치타치,CHALLENGER I,726,10.6,812,86,726,kr
105,줘 너,CHALLENGER I,724,13.4,1046,140,906,kr
106,조치타칫쿵칫타,CHALLENGER I,724,9.2,444,41,403,kr
107,사회관,CHALLENGER I,723,12.4,998,124,874,kr
108,왕 자,CHALLENGER I,722,12.9,611,79,532,kr
109,15조현지,CHALLENGER I,717,22.0,314,69,245,kr
110,혹시그거아냐,CHALLENGER I,716,14.2,393,56,337,kr
111,정밍호짱짱걸,CHALLENGER I,713,14.0,991,139,852,kr
112,오면 딴다,CHALLENGER I,712,13.4,792,106,686,kr
113,Pnaz,CHALLENGER I,709,29.3,225,66,159,kr
114,Gritor,CHALLENGER I,705,15.8,1368,216,1152,kr
115,TZ 제리쌤,CHALLENGER I,705,15.4,317,49,268,kr
116,TFT 너밤,CHALLENGER I,704,18.6,485,90,395,kr
117,Dosu,CHALLENGER I,704,14.1,284,40,244,kr
118,Ignited,CHALLENGER I,702,12.3,568,70,498,kr
119,이딴겜해주지마,CHALLENGER I,698,37.2,137,51,86,kr
120,쪼해피롱,CHALLENGER I,693,18.8,1033,194,839,kr
121,안하기로했자나,CHALLENGER I,687,16.7,372,62,310,kr
122,곽예림,CHALLENGER I,680,12.4,951,118,833,kr
123,last40ne,CHALLENGER I,677,18.8,149,28,121,kr
124,미어캣군,CHALLENGER I,675,13.4,434,58,376,kr
125,연변 소연수,CHALLENGER I,672,15.2,1615,246,1369,kr
126,똥꼬에펜타킬,CHALLENGER I,671,11.7,409,48,361,kr
127,게므론,CHALLENGER I,670,9.8,927,91,836,kr
128,노랑닉,CHALLENGER I,669,17.3,295,51,244,kr
129,쿨한토니,CHALLENGER I,668,15.7,332,52,280,kr
130,Blanker,CHALLENGER I,667,17.5,770,135,635,kr
131,아갈머리를콰악,CHALLENGER I,654,22.4,214,48,166,kr
132,Roik,CHALLENGER I,652,28.0,132,37,95,kr
133,YunHyeonSik,CHALLENGER I,647,13.0,384,50,334,kr
134,천득 fan,CHALLENGER I,645,12.1,1116,135,981,kr
135,봄날이갓두,CHALLENGER I,642,11.7,709,83,626,kr
136,챌린저라닉변함,CHALLENGER I,641,11.6,874,101,773,kr
137,정 장,CHALLENGER I,641,14.6,499,73,426,kr
138,뱅 탁,CHALLENGER I,641,12.4,500,62,438,kr
139,달삼이빡빡라이즈,CHALLENGER I,639,13.8,679,94,585,kr
140,지니쁘미,CHALLENGER I,639,15.5,284,44,240,kr
141,멍청아린,CHALLENGER I,637,14.1,581,82,499,kr
142,주나식,CHALLENGER I,636,17.6,244,43,201,kr
143,WE CAN WlN,CHALLENGER I,635,17.3,538,93,445,kr
144,탑하겠습니다,CHALLENGER I,635,17.8,366,65,301,kr
145,나랑랑이,CHALLENGER I,635,13.8,414,57,357,kr
146,오지마요제발,CHALLENGER I,633,11.5,992,114,878,kr
147,우디르디르,CHALLENGER I,632,15.0,654,98,556,kr
148,TZ 코그멍,CHALLENGER I,632,16.7,430,72,358,kr
149,Schakal,CHALLENGER I,630,13.5,711,96,615,kr
150,땅콩달콤,CHALLENGER I,628,15.2,505,77,428,kr
151,Viento 9,CHALLENGER I,628,13.9,496,69,427,kr
152,proooa,CHALLENGER I,625,16.3,514,84,430,kr
153,콘쓰탄쯔,CHALLENGER I,624,13.0,476,62,414,kr
154,초콜렛공장,CHALLENGER I,622,12.9,355,46,309,kr
155,앗 추워,CHALLENGER I,619,15.1,737,111,626,kr
156,AFTV 제로겟,CHALLENGER I,616,9.4,1835,173,1662,kr
157,2000 11 12,CHALLENGER I,616,17.7,282,50,232,kr
158,참새년,CHALLENGER I,615,13.9,548,76,472,kr
159,남자는코멧,CHALLENGER I,614,13.1,390,51,339,kr
160,illilililli1,CHALLENGER I,614,16.3,252,41,211,kr
161,정 찰 돼,CHALLENGER I,613,12.1,438,53,385,kr
162,possible,CHALLENGER I,611,15.7,534,84,450,kr
163,heals,CHALLENGER I,611,17.0,458,78,380,kr
164,백석대학교,CHALLENGER I,610,16.8,339,57,282,kr
165,EMP 모구,CHALLENGER I,609,15.8,438,69,369,kr
166,정글뭐라하면던짐,CHALLENGER I,607,13.5,919,124,795,kr
167,진이애완동물,CHALLENGER I,607,15.1,490,74,416,kr
168,신낫상우,CHALLENGER I,606,16.7,508,85,423,kr
169,놀릴준비 끝,CHALLENGER I,605,17.2,250,43,207,kr
170,X Videos 방금봄,CHALLENGER I,604,14.5,1025,149,876,kr
171,불꽃자잇 사생팬,CHALLENGER I,604,14.4,422,61,361,kr
172,Trust me only,CHALLENGER I,604,11.0,471,52,419,kr
173,TFT Xion,CHALLENGER I,603,13.8,1164,161,1003,kr
174,Daeju imp,CHALLENGER I,603,10.0,441,44,397,kr
175,s3unguk,CHALLENGER I,602,14.6,547,80,467,kr
176,토토로11,CHALLENGER I,601,11.5,806,93,713,kr
177,대깨포식자,CHALLENGER I,601,13.6,447,61,386,kr
178,V 6 6 V,CHALLENGER I,600,12.3,672,83,589,kr
179,초식판다,CHALLENGER I,597,13.1,881,115,766,kr
180,FateGrand5rder,CHALLENGER I,596,9.1,1159,106,1053,kr
181,베가알쓰리짱,CHALLENGER I,596,13.8,675,93,582,kr
182,오우거 돌주먹,CHALLENGER I,596,15.8,565,89,476,kr
183,눈부신 날,CHALLENGER I,596,15.8,347,55,292,kr
184,족발당수,CHALLENGER I,594,20.0,185,37,148,kr
185,시즌2대한민국1등,CHALLENGER I,593,15.2,611,93,518,kr
186,TFT 1436,CHALLENGER I,592,15.6,289,45,244,kr
187,꼴픽이 Youtube,CHALLENGER I,592,19.6,204,40,164,kr
188,꽝 백,CHALLENGER I,591,15.6,508,79,429,kr
189,미래지향사나이,CHALLENGER I,590,15.8,637,101,536,kr
190,멀보노자슥아,CHALLENGER I,590,13.4,745,100,645,kr
191,미소왕,CHALLENGER I,590,13.8,630,87,543,kr
192,I Go Challenger,CHALLENGER I,590,14.9,369,55,314,kr
193,팬더랑놀자,CHALLENGER I,589,13.9,625,87,538,kr
194,비비고김치,CHALLENGER I,589,8.9,469,42,427,kr
195,최 석,CHALLENGER I,585,22.6,199,45,154,kr
196,23세 홍삼길,CHALLENGER I,584,13.7,692,95,597,kr
197,기생벌레,CHALLENGER I,584,18.6,252,47,205,kr
198,선대군,CHALLENGER I,583,13.5,488,66,422,kr
199,AFTV 진혼곡2,CHALLENGER I,582,17.5,343,60,283,kr
200,깔딱깔딱,CHALLENGER I,581,18.1,786,142,644,kr
1,Líon,CHALLENGER I,1497,21.4,597,128,469,lan
2,Tewesineitor,CHALLENGER I,1473,28.8,312,90,222,lan
3,Rayio,CHALLENGER I,1447,23.3,939,219,720,lan
4,akalyzer,CHALLENGER I,1370,27.1,691,187,504,lan
5,Quantum8,CHALLENGER I,1231,25.5,314,80,234,lan
6,CarryMe Akashi,CHALLENGER I,926,20.2,491,99,392,lan
7,GhoStorm,CHALLENGER I,905,21.0,410,86,324,lan
8,Yami Laicus,CHALLENGER I,851,27.3,308,84,224,lan
9,Cerealito,CHALLENGER I,850,18.4,413,76,337,lan
10,Crycer,CHALLENGER I,848,29.7,310,92,218,lan
11,SákuraHana,CHALLENGER I,831,31.7,230,73,157,lan
12,bite of destiny,CHALLENGER I,763,21.6,569,123,446,lan
13,lmlWarCrY,CHALLENGER I,662,22.0,305,67,238,lan
14,KilljoyMex,CHALLENGER I,659,22.9,249,57,192,lan
15,MyzteryAlex,CHALLENGER I,603,12.5,952,119,833,lan
16,MaRiO bRoS,CHALLENGER I,539,17.8,769,137,632,lan
17,Ch1wy,CHALLENGER I,535,13.8,745,103,642,lan
18,xBjaker,CHALLENGER I,527,21.3,314,67,247,lan
19,Dlanor,CHALLENGER I,525,21.2,448,95,353,lan
20,Slix,CHALLENGER I,493,25.8,190,49,141,lan
21,QuiMi,CHALLENGER I,489,20.4,363,74,289,lan
22,Garto Ward,CHALLENGER I,475,17.6,319,56,263,lan
23,PipoMaster,CHALLENGER I,471,21.9,310,68,242,lan
24,Exus,CHALLENGER I,464,20.7,324,67,257,lan
25,Redmoonwolf,CHALLENGER I,460,11.8,356,42,314,lan
26,2D Jaro,CHALLENGER I,451,23.7,758,180,578,lan
27,andmont,CHALLENGER I,447,19.5,266,52,214,lan
28,TftAcademy,CHALLENGER I,446,12.9,550,71,479,lan
29,Frondavil,CHALLENGER I,440,16.1,436,70,366,lan
30,Quántum,CHALLENGER I,436,23.8,181,43,138,lan
31,Soul 1,CHALLENGER I,435,23.6,259,61,198,lan
32,TheBadMF,CHALLENGER I,430,16.6,355,59,296,lan
33,RiftHerald,CHALLENGER I,429,17.4,212,37,175,lan
34,Siempremuerto,CHALLENGER I,426,15.6,346,54,292,lan
35,AztecMx,CHALLENGER I,424,13.4,246,33,213,lan
36,JOnnyLR,CHALLENGER I,423,17.2,360,62,298,lan
37,oliver10,CHALLENGER I,422,20.1,278,56,222,lan
38,AntonyGamingTFT,CHALLENGER I,419,15.5,510,79,431,lan
39,Vork,CHALLENGER I,419,15.5,471,73,398,lan
40,Garchomp,CHALLENGER I,419,27.6,188,52,136,lan
41,Lysıthea,CHALLENGER I,418,23.4,376,88,288,lan
42,Mr Mugui,CHALLENGER I,417,17.1,1029,176,853,lan
43,Im not villo,CHALLENGER I,408,21.0,367,77,290,lan
44,Ardén,CHALLENGER I,406,12.8,539,69,470,lan
45,Sealcune Mbappé,CHALLENGER I,402,18.9,586,111,475,lan
46,melizaX,CHALLENGER I,390,17.4,338,59,279,lan
47,KiraDessu,CHALLENGER I,389,22.4,411,92,319,lan
48,Hi im Clark,CHALLENGER I,380,22.3,291,65,226,lan
49,Gio9811,CHALLENGER I,362,16.6,253,42,211,lan
50,itken,CHALLENGER I,343,16.5,1031,170,861,lan
51,CrisT1an,"GRANDMASTER I
G",427,23.7,219,52,167,lan
52,diandi,"GRANDMASTER I
G",381,22.4,303,68,235,lan
53,ransabia,"GRANDMASTER I
G",337,14.3,648,93,555,lan
54,Maguita,"GRANDMASTER I
G",327,18.9,359,68,291,lan
55,javia316,"GRANDMASTER I
G",322,15.7,511,80,431,lan
56,Kurokoba,"GRANDMASTER I
G",317,18.5,184,34,150,lan
57,lyonew,"GRANDMASTER I
G",296,14.6,533,78,455,lan
58,PoronghaNegra,"GRANDMASTER I
G",290,17.3,410,71,339,lan
59,Dal,"GRANDMASTER I
G",281,19.0,368,70,298,lan
60,ChinoRobin,"GRANDMASTER I
G",272,23.8,273,65,208,lan
61,warlocksky,"GRANDMASTER I
G",259,14.2,275,39,236,lan
62,shiry,"GRANDMASTER I
G",254,19.2,287,55,232,lan
63,Need more skins,"GRANDMASTER I
G",251,15.4,384,59,325,lan
64,G2 Josar,"GRANDMASTER I
G",250,19.3,353,68,285,lan
65,Nightlover,"GRANDMASTER I
G",247,17.8,349,62,287,lan
66,Marcela Valencia,"GRANDMASTER I
G",243,24.4,209,51,158,lan
67,Xkorzo YT,"GRANDMASTER I
G",242,28.8,104,30,74,lan
68,No soy exoor,"GRANDMASTER I
G",241,24.9,185,46,139,lan
69,Too Sweet,"GRANDMASTER I
G",237,25.3,146,37,109,lan
70,Ucr,"GRANDMASTER I
G",234,16.1,427,69,358,lan
71,Dondenuncias,"GRANDMASTER I
G",233,28.6,168,48,120,lan
72,Aletsis,"GRANDMASTER I
G",225,22.8,162,37,125,lan
73,Rodo TFT,"GRANDMASTER I
G",221,15.9,245,39,206,lan
74,ChupemElPrime,"GRANDMASTER I
G",217,20.1,303,61,242,lan
75,25356,"GRANDMASTER I
G",212,16.8,310,52,258,lan
76,Pompo,"GRANDMASTER I
G",205,18.1,347,63,284,lan
77,Twistä,"GRANDMASTER I
G",205,11.2,358,40,318,lan
78,AbrahamBM,"GRANDMASTER I
G",204,16.8,197,33,164,lan
79,KllK EditZ,"GRANDMASTER I
G",203,17.7,311,55,256,lan
80,Psend,"GRANDMASTER I
G",203,19.1,204,39,165,lan
81,TeversomuchT,"GRANDMASTER I
G",202,13.6,464,63,401,lan
82,XiaoPo06,"GRANDMASTER I
G",200,13.6,642,87,555,lan
83,Awela Requiem,"GRANDMASTER I
G",194,23.4,261,61,200,lan
84,Khorge PN,"GRANDMASTER I
G",194,19.2,219,42,177,lan
85,Cjddd,"GRANDMASTER I
G",194,15.8,221,35,186,lan
86,Vampiro Playero,"GRANDMASTER I
G",192,19.0,327,62,265,lan
87,ExtraWuiller,"GRANDMASTER I
G",183,13.8,254,35,219,lan
88,Gargota,"GRANDMASTER I
G",173,21.0,319,67,252,lan
89,AlXDXD,"GRANDMASTER I
G",170,18.5,227,42,185,lan
90,Main Q,"GRANDMASTER I
G",169,19.9,292,58,234,lan
91,Rcadillo,"GRANDMASTER I
G",164,15.7,867,136,731,lan
92,GS Lancelot,"GRANDMASTER I
G",164,17.5,291,51,240,lan
93,BarbeQ,"GRANDMASTER I
G",162,15.7,575,90,485,lan
94,Chesspants,"GRANDMASTER I
G",158,19.3,202,39,163,lan
95,Cloud strife,"GRANDMASTER I
G",158,16.9,160,27,133,lan
96,Ovejomaru,"GRANDMASTER I
G",156,20.1,319,64,255,lan
97,lkokito,"GRANDMASTER I
G",153,18.1,425,77,348,lan
98,thewghost,"GRANDMASTER I
G",153,23.8,202,48,154,lan
99,TFT Lelouch,"GRANDMASTER I
G",146,13.9,266,37,229,lan
100,ICostDRE,"GRANDMASTER I
G",142,16.0,588,94,494,lan
101,7DS HyperSpace,"GRANDMASTER I
G",140,21.6,1052,227,825,lan
102,KOR Doyong,"GRANDMASTER I
G",140,21.6,157,34,123,lan
103,panchoAngüis,"GRANDMASTER I
G",135,23.4,307,72,235,lan
104,FordHealer,"GRANDMASTER I
G",135,27.0,74,20,54,lan
105,Stuff,"GRANDMASTER I
G",132,14.3,426,61,365,lan
106,Marenn,"GRANDMASTER I
G",128,13.3,292,39,253,lan
107,McGregorr,"GRANDMASTER I
G",127,18.5,426,79,347,lan
108,Jir0,"GRANDMASTER I
G",127,15.6,508,79,429,lan
109,Revengp,"GRANDMASTER I
G",126,20.2,228,46,182,lan
110,OTP Rumble,"GRANDMASTER I
G",126,14.5,172,25,147,lan
111,4manu4,"GRANDMASTER I
G",123,15.4,298,46,252,lan
112,Nebura,"GRANDMASTER I
G",122,19.6,209,41,168,lan
113,Warblo,"GRANDMASTER I
G",121,24.4,406,99,307,lan
114,Don Stban,"GRANDMASTER I
G",119,21.2,137,29,108,lan
115,TrafalgarL4w,"GRANDMASTER I
G",117,20.6,422,87,335,lan
116,Apödaca,"GRANDMASTER I
G",117,25.4,276,70,206,lan
117,God JdGa,"GRANDMASTER I
G",114,23.3,360,84,276,lan
118,TFT Ares,"GRANDMASTER I
G",114,10.9,548,60,488,lan
119,liou,"GRANDMASTER I
G",111,17.4,132,23,109,lan
120,JhonWonka,"GRANDMASTER I
G",110,19.5,246,48,198,lan
121,juandotft,"GRANDMASTER I
G",109,16.5,182,30,152,lan
122,llRyougiShiki,"GRANDMASTER I
G",108,15.7,216,34,182,lan
123,GREIVIN,"GRANDMASTER I
G",108,10.2,293,30,263,lan
124,Pauleandro,"GRANDMASTER I
G",107,8.3,577,48,529,lan
125,Gatito Cósmıco,"GRANDMASTER I
G",106,17.8,241,43,198,lan
126,llArthzll,"GRANDMASTER I
G",105,23.6,339,80,259,lan
127,Archi,"GRANDMASTER I
G",105,12.9,240,31,209,lan
128,BarbieQ,"GRANDMASTER I
G",105,27.3,110,30,80,lan
129,ILY Elena Rubí,"GRANDMASTER I
G",105,23.5,119,28,91,lan
130,Tactics,"GRANDMASTER I
G",104,7.2,923,66,857,lan
131,Souł,"GRANDMASTER I
G",103,15.5,323,50,273,lan
132,Lą Mąscotą,"GRANDMASTER I
G",102,16.2,160,26,134,lan
133,DragoFenix2,"GRANDMASTER I
G",101,15.9,296,47,249,lan
134,FjBlanco,"GRANDMASTER I
G",100,17.8,365,65,300,lan
135,TFTJefe,"GRANDMASTER I
G",99,14.8,284,42,242,lan
136,Wamuu,"GRANDMASTER I
G",97,17.2,400,69,331,lan
137,Putint,"GRANDMASTER I
G",97,19.0,273,52,221,lan
138,YaphetS Karma,"GRANDMASTER I
G",97,23.4,167,39,128,lan
139,Enr1que,"GRANDMASTER I
G",96,11.4,658,75,583,lan
140,Skaaarl,"GRANDMASTER I
G",96,16.2,259,42,217,lan
141,ianakin7,"GRANDMASTER I
G",95,17.9,793,142,651,lan
142,TOMATOFARMER535,"GRANDMASTER I
G",95,9.6,645,62,583,lan
143,TheFenixx,"GRANDMASTER I
G",94,29.4,221,65,156,lan
144,LaGoorda,"GRANDMASTER I
G",91,17.7,164,29,135,lan
145,DLT Macloud,"GRANDMASTER I
G",90,17.0,501,85,416,lan
146,No Mercy,"GRANDMASTER I
G",88,16.9,587,99,488,lan
147,Pedro Bae,"GRANDMASTER I
G",88,24.8,355,88,267,lan
148,Stupefy,"GRANDMASTER I
G",83,13.0,445,58,387,lan
149,DedosLocos7u7,"GRANDMASTER I
G",50,14.3,259,37,222,lan
150,papusmaximus,MASTER I,110,6.4,328,21,307,lan
151,Pushesz,MASTER I,87,18.4,364,67,297,lan
152,Khorge,MASTER I,86,19.0,137,26,111,lan
153,DL DIAMOND DL,MASTER I,78,13.3,294,39,255,lan
154,Danté,MASTER I,77,19.0,347,66,281,lan
155,BlitzDance,MASTER I,68,18.3,153,28,125,lan
156,BoscoBramblefoot,MASTER I,67,19.1,241,46,195,lan
157,LFT Zero,MASTER I,64,16.6,151,25,126,lan
158,Marvelous,MASTER I,57,17.5,263,46,217,lan
159,Moncho,MASTER I,56,12.7,158,20,138,lan
160,Enryu The Red,MASTER I,55,18.4,310,57,253,lan
161,rambo12345678,MASTER I,53,14.7,545,80,465,lan
162,crazy999666,MASTER I,53,16.5,236,39,197,lan
163,marduko,MASTER I,53,11.3,266,30,236,lan
164,TheGearZ,MASTER I,50,12.1,182,22,160,lan
165,socio2k,MASTER I,48,17.4,321,56,265,lan
166,Skan011,MASTER I,48,13.7,241,33,208,lan
167,Surprise lm Back,MASTER I,47,17.1,298,51,247,lan
168,Orange,MASTER I,46,11.9,489,58,431,lan
169,xHeroskillx,MASTER I,46,15.4,246,38,208,lan
170,Ęnder,MASTER I,46,16.0,181,29,152,lan
171,Porygon,MASTER I,46,24.1,112,27,85,lan
172,Sigma the black,MASTER I,42,10.6,302,32,270,lan
173,KidHellion,MASTER I,42,13.2,220,29,191,lan
174,GøldLyon,MASTER I,41,16.4,311,51,260,lan
175,TheOnlyTeddy,MASTER I,41,16.5,267,44,223,lan
176,Sonagi,MASTER I,39,19.0,158,30,128,lan
177,caifas1995,MASTER I,36,18.2,681,124,557,lan
178,El HuachicoIero,MASTER I,36,15.8,95,15,80,lan
179,tommyfosfor1llo,MASTER I,35,20.0,419,84,335,lan
180,scarmg,MASTER I,35,19.5,359,70,289,lan
181,Gallher,MASTER I,33,18.6,495,92,403,lan
182,JONN93,MASTER I,33,12.9,618,80,538,lan
183,Wínter,MASTER I,33,17.6,210,37,173,lan
184,wolfteamx5,MASTER I,32,15.3,652,100,552,lan
185,zeiik,MASTER I,32,16.4,275,45,230,lan
186,jjvanegask77,MASTER I,31,18.9,169,32,137,lan
187,Kestoc,MASTER I,30,16.1,249,40,209,lan
188,Mahito,MASTER I,30,19.2,187,36,151,lan
189,Miguel Aleman,MASTER I,30,16.9,207,35,172,lan
190,Vey,MASTER I,29,16.5,224,37,187,lan
191,Devilx500,MASTER I,28,13.7,497,68,429,lan
192,HECT55,MASTER I,27,16.2,272,44,228,lan
193,Ezcanør,MASTER I,27,13.5,310,42,268,lan
194,TaquitoAIPastor,MASTER I,27,17.9,151,27,124,lan
195,Marrochet,MASTER I,25,11.7,326,38,288,lan
196,SAV Nooba,MASTER I,25,18.4,163,30,133,lan
197,Šęcręt Aurôrą,MASTER I,24,14.1,290,41,249,lan
198,Anivio,MASTER I,23,16.4,292,48,244,lan
199,j41746943J,MASTER I,22,16.0,269,43,226,lan
200,TFT Cadix,MASTER I,20,15.8,468,74,394,lan
1,FaryaAndWoIyo,CHALLENGER I,1776,29.3,352,103,249,las
2,Kłaytøn,CHALLENGER I,1725,25.8,427,110,317,las
3,Shireen4,CHALLENGER I,1523,26.3,525,138,387,las
4,Tolengo73,CHALLENGER I,1335,27.2,529,144,385,las
5,S de Sencillo,CHALLENGER I,1258,18.7,1427,267,1160,las
6,DarksBit,CHALLENGER I,1181,24.8,266,66,200,las
7,Fourloko RX,CHALLENGER I,1031,21.3,310,66,244,las
8,JustDream,CHALLENGER I,989,17.8,922,164,758,las
9,UCH TheLiNe,CHALLENGER I,977,30.4,270,82,188,las
10,No Quarter,CHALLENGER I,904,21.7,392,85,307,las
11,Highroll,CHALLENGER I,895,20.2,703,142,561,las
12,Samenix,CHALLENGER I,868,27.1,292,79,213,las
13,Altenahue,CHALLENGER I,833,22.9,488,112,376,las
14,Priend,CHALLENGER I,784,17.9,627,112,515,las
15,FuryTank,CHALLENGER I,763,20.8,351,73,278,las
16,Fan de la Linea,CHALLENGER I,712,25.4,197,50,147,las
17,CooLDownJJ,CHALLENGER I,702,25.1,299,75,224,las
18,UCH Morfer,CHALLENGER I,613,18.2,296,54,242,las
19,Girlfromnoxuss,CHALLENGER I,576,19.7,654,129,525,las
20,RoSweL TacTicS,CHALLENGER I,573,15.4,963,148,815,las
21,shuuumpy,CHALLENGER I,561,20.1,428,86,342,las
22,LifesBadTFT,CHALLENGER I,555,21.1,285,60,225,las
23,Christus,CHALLENGER I,555,28.8,156,45,111,las
24,Dukie,CHALLENGER I,526,20.3,187,38,149,las
25,404NameeNotFound,CHALLENGER I,503,16.7,534,89,445,las
26,New Stage,CHALLENGER I,503,19.2,328,63,265,las
27,Changuito 10,CHALLENGER I,478,20.4,201,41,160,las
28,Bugame,CHALLENGER I,459,22.5,222,50,172,las
29,Chino Weng TFT,CHALLENGER I,448,22.2,495,110,385,las
30,AUGUSTOMARCO,CHALLENGER I,441,15.0,366,55,311,las
31,Åzok,CHALLENGER I,438,15.9,433,69,364,las
32,Rubik,CHALLENGER I,428,17.3,272,47,225,las
33,Gara Arg,CHALLENGER I,414,18.6,440,82,358,las
34,Jesus,CHALLENGER I,414,22.7,150,34,116,las
35,Hellfire,CHALLENGER I,408,20.8,336,70,266,las
36,Cupiditas,CHALLENGER I,401,20.1,308,62,246,las
37,Greyd0n,CHALLENGER I,400,13.5,415,56,359,las
38,sendohrai,CHALLENGER I,393,17.6,323,57,266,las
39,TFT MMR Perfect,CHALLENGER I,388,16.7,562,94,468,las
40,Lyked,CHALLENGER I,381,25.6,262,67,195,las
41,Raruto,CHALLENGER I,379,14.0,272,38,234,las
42,InvadersMD,CHALLENGER I,378,15.9,800,127,673,las
43,xiomax,CHALLENGER I,369,16.5,334,55,279,las
44,ROH inSec t0,CHALLENGER I,367,14.0,443,62,381,las
45,Emad Joestar,CHALLENGER I,367,17.9,212,38,174,las
46,ANIMEWEEBLORD420,CHALLENGER I,361,26.5,132,35,97,las
47,Don Galli,CHALLENGER I,355,20.0,165,33,132,las
48,Cvictoria Bryant,CHALLENGER I,353,16.0,493,79,414,las
49,Wazapper,CHALLENGER I,322,16.1,323,52,271,las
50,hartung,CHALLENGER I,321,16.1,380,61,319,las
51,iudex Jevic,"GRANDMASTER I
G",380,17.4,758,132,626,las
52,ACÁ MANDO YO,"GRANDMASTER I
G",367,20.4,440,90,350,las
53,Tr1ckster,"GRANDMASTER I
G",354,29.7,118,35,83,las
54,MättZ,"GRANDMASTER I
G",336,11.1,512,57,455,las
55,Desgr4cia,"GRANDMASTER I
G",328,10.2,1063,109,954,las
56,Fradox22,"GRANDMASTER I
G",309,21.2,193,41,152,las
57,ElbalmoR,"GRANDMASTER I
G",303,16.8,298,50,248,las
58,BC Thoryn,"GRANDMASTER I
G",294,21.4,247,53,194,las
59,elPepi,"GRANDMASTER I
G",275,16.2,234,38,196,las
60,Xork,"GRANDMASTER I
G",260,19.7,466,92,374,las
61,Nico Del Baño,"GRANDMASTER I
G",257,25.0,160,40,120,las
62,RNGPDD,"GRANDMASTER I
G",252,23.0,139,32,107,las
63,Ryuuk Kyuu,"GRANDMASTER I
G",237,14.8,176,26,150,las
64,JueguenNormal,"GRANDMASTER I
G",226,14.8,498,74,424,las
65,HeRz BenT,"GRANDMASTER I
G",213,19.5,334,65,269,las
66,MorteMTW,"GRANDMASTER I
G",209,17.0,619,105,514,las
67,SirBłack,"GRANDMASTER I
G",200,16.4,353,58,295,las
68,KTP Yoshi,"GRANDMASTER I
G",199,13.7,452,62,390,las
69,Tob9,"GRANDMASTER I
G",197,22.4,299,67,232,las
70,ChakoPopoco,"GRANDMASTER I
G",194,15.2,486,74,412,las
71,geoffroy123,"GRANDMASTER I
G",186,14.5,145,21,124,las
72,Rekatria,"GRANDMASTER I
G",183,17.8,219,39,180,las
73,Error 402,"GRANDMASTER I
G",182,16.5,236,39,197,las
74,LuckyDuit,"GRANDMASTER I
G",177,16.8,286,48,238,las
75,100cityfico,"GRANDMASTER I
G",173,10.9,494,54,440,las
76,Karnal,"GRANDMASTER I
G",170,14.7,550,81,469,las
77,xXhermaniguiXx,"GRANDMASTER I
G",160,19.6,296,58,238,las
78,Viangrele,"GRANDMASTER I
G",158,24.6,321,79,242,las
79,Dogor,"GRANDMASTER I
G",158,16.1,285,46,239,las
80,Seminare,"GRANDMASTER I
G",155,16.9,319,54,265,las
81,NachoG95,"GRANDMASTER I
G",152,17.0,494,84,410,las
82,skitifornia,"GRANDMASTER I
G",150,14.3,658,94,564,las
83,xaimmer,"GRANDMASTER I
G",143,16.7,510,85,425,las
84,Arizona Zervas,"GRANDMASTER I
G",143,16.1,410,66,344,las
85,ravenoneforeva,"GRANDMASTER I
G",141,20.9,316,66,250,las
86,Peronism,"GRANDMASTER I
G",141,15.1,292,44,248,las
87,Zionooooo,"GRANDMASTER I
G",137,16.0,243,39,204,las
88,Bandalians,"GRANDMASTER I
G",132,14.8,1052,156,896,las
89,Super Carlitos,"GRANDMASTER I
G",119,12.2,563,69,494,las
90,Gaattsu,"GRANDMASTER I
G",116,12.9,535,69,466,las
91,Necroshine77,"GRANDMASTER I
G",114,19.5,375,73,302,las
92,ikarosdesu,"GRANDMASTER I
G",113,18.6,140,26,114,las
93,Danielove,"GRANDMASTER I
G",112,14.1,375,53,322,las
94,BolaDeLomo,"GRANDMASTER I
G",109,15.4,299,46,253,las
95,Sirzechsl,"GRANDMASTER I
G",106,12.9,425,55,370,las
96,Kimarus,"GRANDMASTER I
G",105,20.9,326,68,258,las
97,Orco13,"GRANDMASTER I
G",105,17.6,289,51,238,las
98,TWOEASY,"GRANDMASTER I
G",104,13.3,270,36,234,las
99,ElnicoMata,"GRANDMASTER I
G",100,12.0,691,83,608,las
100,TwitchTVLifesBad,"GRANDMASTER I
G",98,25.9,158,41,117,las
101,animesenpai2,"GRANDMASTER I
G",97,14.3,273,39,234,las
102,Chino Rios,"GRANDMASTER I
G",95,18.2,456,83,373,las
103,CodMeiro,"GRANDMASTER I
G",93,15.0,313,47,266,las
104,TheDanieTFT,"GRANDMASTER I
G",92,13.5,185,25,160,las
105,Ola soi Smurf,"GRANDMASTER I
G",90,32.5,86,28,58,las
106,LOLEROPERONOPACO,"GRANDMASTER I
G",89,19.0,305,58,247,las
107,manuaj97,"GRANDMASTER I
G",89,17.3,196,34,162,las
108,CuriousChameIeon,"GRANDMASTER I
G",88,20.5,415,85,330,las
109,Wolf Bak,"GRANDMASTER I
G",88,15.7,471,74,397,las
110,64 Bits,"GRANDMASTER I
G",88,14.3,238,34,204,las
111,Kraft Tilted,"GRANDMASTER I
G",87,19.6,296,58,238,las
112,IICelesteII,"GRANDMASTER I
G",86,15.7,617,97,520,las
113,Sáyron,"GRANDMASTER I
G",86,13.2,438,58,380,las
114,Jaigesso,"GRANDMASTER I
G",85,15.7,364,57,307,las
115,Hukka,"GRANDMASTER I
G",84,16.8,262,44,218,las
116,Stoned Bulbasaur,"GRANDMASTER I
G",84,14.0,222,31,191,las
117,QT FD,"GRANDMASTER I
G",83,17.7,583,103,480,las
118,dimeloneri,"GRANDMASTER I
G",83,13.1,350,46,304,las
119,xZaMaSx,"GRANDMASTER I
G",82,16.4,397,65,332,las
120,Mid Ghost,"GRANDMASTER I
G",81,13.9,1024,142,882,las
121,p Ø L i,"GRANDMASTER I
G",81,13.8,513,71,442,las
122,ElDryzler,"GRANDMASTER I
G",81,11.8,416,49,367,las
123,HuNnnTeR,"GRANDMASTER I
G",80,16.2,812,132,680,las
124,Xerwell,"GRANDMASTER I
G",80,14.9,415,62,353,las
125,Dycoop,"GRANDMASTER I
G",80,19.2,193,37,156,las
126,UCH Koro,"GRANDMASTER I
G",78,17.5,359,63,296,las
127,Crux,"GRANDMASTER I
G",78,15.4,351,54,297,las
128,alehhhh,"GRANDMASTER I
G",76,17.2,691,119,572,las
129,Dtoke Freestyler,"GRANDMASTER I
G",76,13.9,459,64,395,las
130,Hardcorito Facho,"GRANDMASTER I
G",76,17.4,230,40,190,las
131,TOXIAS,"GRANDMASTER I
G",76,16.6,193,32,161,las
132,Krovsavetik,"GRANDMASTER I
G",74,13.3,301,40,261,las
133,Cupidotas,"GRANDMASTER I
G",74,33.8,74,25,49,las
134,iPurge1,"GRANDMASTER I
G",73,13.7,386,53,333,las
135,TU WAIFU ME AMA,"GRANDMASTER I
G",73,17.7,181,32,149,las
136,Dungeon,"GRANDMASTER I
G",72,16.3,392,64,328,las
137,Lean Live,"GRANDMASTER I
G",71,14.2,332,47,285,las
138,AlcaTeD,"GRANDMASTER I
G",70,14.3,439,63,376,las
139,MaurooCARP,"GRANDMASTER I
G",70,17.7,237,42,195,las
140,n50,"GRANDMASTER I
G",69,18.1,557,101,456,las
141,SlashFullMuteAll,"GRANDMASTER I
G",69,15.3,352,54,298,las
142,KeRikoWisKi,"GRANDMASTER I
G",68,15.4,273,42,231,las
143,LeBlanc Uchiha,"GRANDMASTER I
G",67,14.1,1083,153,930,las
144,Lonkiwi,"GRANDMASTER I
G",66,16.2,438,71,367,las
145,TheClasman,"GRANDMASTER I
G",66,14.6,412,60,352,las
146,WaIter White Jr,"GRANDMASTER I
G",64,13.3,422,56,366,las
147,Berzedker,"GRANDMASTER I
G",59,17.3,312,54,258,las
148,Morochimaru uwu,"GRANDMASTER I
G",56,13.6,191,26,165,las
149,NaynitoKebab,"GRANDMASTER I
G",32,15.5,420,65,355,las
150,Sikolio,"GRANDMASTER I
G",6,18.2,423,77,346,las
151,Caver,MASTER I,97,15.9,264,42,222,las
152,spiirati,MASTER I,81,15.4,461,71,390,las
153,Daian21,MASTER I,79,8.7,427,37,390,las
154,ChitoPampi,MASTER I,64,13.7,365,50,315,las
155,Brooklyn Baby,MASTER I,60,24.7,162,40,122,las
156,Dim4s,MASTER I,60,22.4,143,32,111,las
157,NOSABIAQUEPONE,MASTER I,57,16.8,196,33,163,las
158,toy chikita,MASTER I,55,20.9,211,44,167,las
159,Un Desconocido,MASTER I,53,12.9,309,40,269,las
160,67 iq player,MASTER I,53,20.9,134,28,106,las
161,Leyton0,MASTER I,50,21.1,266,56,210,las
162,Spaark  TFT,MASTER I,49,16.5,194,32,162,las
163,GorrionEnLlamas,MASTER I,48,17.0,188,32,156,las
164,xikhario,MASTER I,46,15.5,368,57,311,las
165,SouLXisT,MASTER I,46,19.7,228,45,183,las
166,Daelon TFT,MASTER I,44,13.1,413,54,359,las
167,Twitch Jaypi9,MASTER I,40,15.8,751,119,632,las
168,Mapachee,MASTER I,39,21.1,380,80,300,las
169,UCH Dario,MASTER I,39,12.0,432,52,380,las
170,LIEUTENANT DAN,MASTER I,36,17.6,273,48,225,las
171,Tortuga Inmortal,MASTER I,35,14.0,494,69,425,las
172,goldcs,MASTER I,33,12.1,546,66,480,las
173,xTato,MASTER I,33,13.7,197,27,170,las
174,Tirale la Ulti,MASTER I,31,11.2,412,46,366,las
175,pancitodemoldee,MASTER I,30,13.6,447,61,386,las
176,ZucaLIVE,MASTER I,30,13.8,391,54,337,las
177,juanferquinterop,MASTER I,30,14.7,251,37,214,las
178,Trimsk,MASTER I,30,14.4,250,36,214,las
179,Haise,MASTER I,30,15.5,206,32,174,las
180,ViruZTS,MASTER I,29,19.0,311,59,252,las
181,Serteck,MASTER I,29,17.1,210,36,174,las
182,elchicolinux,MASTER I,26,16.7,347,58,289,las
183,Tactics iBaggy,MASTER I,26,14.1,241,34,207,las
184,DONBOMBASTIC,MASTER I,23,16.0,294,47,247,las
185,tips best lol,MASTER I,22,15.9,624,99,525,las
186,TFT Skills,MASTER I,21,10.1,583,59,524,las
187,Sadness Xiu,MASTER I,21,12.4,289,36,253,las
188,LL Jhin,MASTER I,21,16.7,192,32,160,las
189,Cifumeta,MASTER I,20,16.4,219,36,183,las
190,Pastero en Bici,MASTER I,19,16.4,395,65,330,las
191,Kiroichy,MASTER I,19,21.2,231,49,182,las
192,MateDeCoco,MASTER I,19,16.8,208,35,173,las
193,Preshelec,MASTER I,18,15.1,185,28,157,las
194,UruSativaCarryJr,MASTER I,17,20.5,215,44,171,las
195,ssbita,MASTER I,16,18.8,309,58,251,las
196,Kozukî Oden,MASTER I,15,12.9,256,33,223,las
197,iEgoist,MASTER I,15,14.1,213,30,183,las
198,Friend Request,MASTER I,15,16.8,137,23,114,las
199,Fuji,MASTER I,13,14.3,245,35,210,las
200,God DMZ,MASTER I,12,16.3,331,54,277,las
1,Angora,CHALLENGER I,1081,26.4,356,94,262,oce
2,vx s5683169,CHALLENGER I,1077,24.3,411,100,311,oce
3,CombatEZ,CHALLENGER I,1049,25.9,197,51,146,oce
4,Steve Lau,CHALLENGER I,1038,22.8,941,215,726,oce
5,KirinSupreme,CHALLENGER I,631,19.2,516,99,417,oce
6,JimJaam,CHALLENGER I,595,18.9,498,94,404,oce
7,yuzhibo777,CHALLENGER I,556,19.9,377,75,302,oce
8,ilikeud,CHALLENGER I,545,22.3,247,55,192,oce
9,dz2,CHALLENGER I,535,13.9,461,64,397,oce
10,stealmybuild TTV,CHALLENGER I,502,16.9,438,74,364,oce
11,1ydia233,CHALLENGER I,499,24.0,183,44,139,oce
12,Blender Main,CHALLENGER I,492,21.2,184,39,145,oce
13,ˇPhoenix,CHALLENGER I,471,23.8,324,77,247,oce
14,HatsuneMik,CHALLENGER I,461,24.4,197,48,149,oce
15,Age of Empires 3,CHALLENGER I,451,14.4,485,70,415,oce
16,jiaonizuodog,CHALLENGER I,442,18.7,664,124,540,oce
17,Bruceissss,CHALLENGER I,425,18.0,538,97,441,oce
18,jffhjjir,CHALLENGER I,424,22.2,203,45,158,oce
19,MYdi,CHALLENGER I,409,17.6,358,63,295,oce
20,Kïng Tryndamere,CHALLENGER I,399,17.9,442,79,363,oce
21,qp9,CHALLENGER I,398,15.0,366,55,311,oce
22,smsqs,CHALLENGER I,395,22.9,323,74,249,oce
23,thedashuaibi,CHALLENGER I,390,19.8,419,83,336,oce
24,fengyingzhong,CHALLENGER I,389,24.8,125,31,94,oce
25,oubo,CHALLENGER I,388,19.8,338,67,271,oce
26,Chatskiiees,CHALLENGER I,386,17.8,534,95,439,oce
27,dodododododododo,CHALLENGER I,381,20.4,1271,260,1011,oce
28,plplplpp,CHALLENGER I,368,22.6,332,75,257,oce
29,Son Chae Young,CHALLENGER I,368,19.3,233,45,188,oce
30,m2att,CHALLENGER I,366,14.9,1032,154,878,oce
31,zofou,CHALLENGER I,366,17.7,424,75,349,oce
32,sorryimlikethis,CHALLENGER I,359,23.6,288,68,220,oce
33,LongYu66,CHALLENGER I,359,18.4,353,65,288,oce
34,WIld Sins Main,CHALLENGER I,357,15.4,331,51,280,oce
35,Zacccccyou,CHALLENGER I,356,21.6,157,34,123,oce
36,Heart1ess,CHALLENGER I,354,20.1,283,57,226,oce
37,MakinSomeBacon,CHALLENGER I,354,14.6,384,56,328,oce
38,Rng28002200,CHALLENGER I,354,20.9,215,45,170,oce
39,Jacky Xie,CHALLENGER I,353,22.5,404,91,313,oce
40,Just Mango,CHALLENGER I,352,21.5,326,70,256,oce
41,heishelifu,CHALLENGER I,352,24.8,222,55,167,oce
42,okhaige,CHALLENGER I,350,14.3,363,52,311,oce
43,ItchyPenitis,CHALLENGER I,345,13.7,584,80,504,oce
44,Maxilees,CHALLENGER I,343,15.8,221,35,186,oce
45,I Want You,CHALLENGER I,342,19.0,601,114,487,oce
46,Escha,CHALLENGER I,341,13.8,623,86,537,oce
47,Dunk xiaolu,CHALLENGER I,340,16.4,469,77,392,oce
48,QWERXF,CHALLENGER I,335,20.3,370,75,295,oce
49,bingmoyan,CHALLENGER I,329,16.7,490,82,408,oce
50,Another3,CHALLENGER I,269,14.5,400,58,342,oce
51,vx1123913246,"GRANDMASTER I
G",361,16.0,551,88,463,oce
52,chinaLZH,"GRANDMASTER I
G",348,22.3,260,58,202,oce
53,samesame,"GRANDMASTER I
G",336,13.6,469,64,405,oce
54,NayiGOJi,"GRANDMASTER I
G",316,19.0,290,55,235,oce
55,Slayer Bo,"GRANDMASTER I
G",315,17.5,308,54,254,oce
56,Last Wh1sper,"GRANDMASTER I
G",314,22.9,170,39,131,oce
57,BeaBear,"GRANDMASTER I
G",313,16.8,339,57,282,oce
58,ccxxcc,"GRANDMASTER I
G",308,20.1,259,52,207,oce
59,TonystarkIRON,"GRANDMASTER I
G",302,26.1,138,36,102,oce
60,Jack Griffin,"GRANDMASTER I
G",301,14.0,308,43,265,oce
61,HaSak1Wang,"GRANDMASTER I
G",301,17.1,152,26,126,oce
62,aksidhhdid,"GRANDMASTER I
G",294,16.1,558,90,468,oce
63,Fischball,"GRANDMASTER I
G",292,19.2,250,48,202,oce
64,Damon989,"GRANDMASTER I
G",290,19.1,199,38,161,oce
65,Moon1,"GRANDMASTER I
G",290,17.1,175,30,145,oce
66,PPAP,"GRANDMASTER I
G",283,14.0,356,50,306,oce
67,qwsxggo,"GRANDMASTER I
G",273,17.8,416,74,342,oce
68,knlght999,"GRANDMASTER I
G",273,20.1,204,41,163,oce
69,hjhukbt,"GRANDMASTER I
G",265,18.0,389,70,319,oce
70,ihjkljg,"GRANDMASTER I
G",264,16.1,248,40,208,oce
71,ggds4y,"GRANDMASTER I
G",259,16.5,455,75,380,oce
72,zhanglan1234,"GRANDMASTER I
G",256,13.7,322,44,278,oce
73,lloydeee,"GRANDMASTER I
G",254,20.5,361,74,287,oce
74,ceeryees,"GRANDMASTER I
G",253,21.2,113,24,89,oce
75,3uphonium,"GRANDMASTER I
G",250,19.9,306,61,245,oce
76,qkkaannuu,"GRANDMASTER I
G",240,13.9,425,59,366,oce
77,3sansansan,"GRANDMASTER I
G",237,18.8,480,90,390,oce
78,jieshao211,"GRANDMASTER I
G",234,17.7,209,37,172,oce
79,Seeyaa,"GRANDMASTER I
G",228,12.2,263,32,231,oce
80,TheExpIosiveTaco,"GRANDMASTER I
G",222,15.2,230,35,195,oce
81,roflwhatever,"GRANDMASTER I
G",221,20.3,217,44,173,oce
82,WU YAN ZZU,"GRANDMASTER I
G",220,14.3,321,46,275,oce
83,HanDaY,"GRANDMASTER I
G",219,18.8,329,62,267,oce
84,CampBishop,"GRANDMASTER I
G",209,21.3,277,59,218,oce
85,Cwute Panda,"GRANDMASTER I
G",208,16.6,489,81,408,oce
86,Cyphos,"GRANDMASTER I
G",207,17.6,425,75,350,oce
87,Law of the few,"GRANDMASTER I
G",206,13.8,675,93,582,oce
88,zhangtao666,"GRANDMASTER I
G",199,22.6,164,37,127,oce
89,GiveMeGunS,"GRANDMASTER I
G",198,14.9,269,40,229,oce
90,xiaocaibiiiii,"GRANDMASTER I
G",195,16.7,288,48,240,oce
91,VNLunar,"GRANDMASTER I
G",189,14.3,384,55,329,oce
92,Reborn Myth,"GRANDMASTER I
G",187,12.3,455,56,399,oce
93,lovestarrysky,"GRANDMASTER I
G",182,16.8,542,91,451,oce
94,orymdzz,"GRANDMASTER I
G",177,17.3,301,52,249,oce
95,heizi22,"GRANDMASTER I
G",177,33.8,77,26,51,oce
96,fanfanbaby,"GRANDMASTER I
G",176,24.6,138,34,104,oce
97,Yuki0720,"GRANDMASTER I
G",172,12.3,413,51,362,oce
98,dxapple,"GRANDMASTER I
G",170,15.6,237,37,200,oce
99,SeaBoss,"GRANDMASTER I
G",169,13.8,392,54,338,oce
100,overwater,"GRANDMASTER I
G",169,21.3,216,46,170,oce
101,free57,"GRANDMASTER I
G",169,31.5,111,35,76,oce
102,chengzai,"GRANDMASTER I
G",163,14.0,286,40,246,oce
103,Whìte,"GRANDMASTER I
G",161,16.4,732,120,612,oce
104,TheRealDirtyDan,"GRANDMASTER I
G",160,10.3,493,51,442,oce
105,yundingle,"GRANDMASTER I
G",159,21.6,194,42,152,oce
106,hemoumouya,"GRANDMASTER I
G",157,27.0,185,50,135,oce
107,CLMEpapa,"GRANDMASTER I
G",153,17.5,325,57,268,oce
108,Thi3ugia98,"GRANDMASTER I
G",153,14.9,355,53,302,oce
109,hourunm,"GRANDMASTER I
G",153,24.0,200,48,152,oce
110,Maraudaur,"GRANDMASTER I
G",151,15.9,564,90,474,oce
111,xinya45,"GRANDMASTER I
G",148,18.7,459,86,373,oce
112,Mounty,"GRANDMASTER I
G",148,12.3,586,72,514,oce
113,ale190190,"GRANDMASTER I
G",147,22.3,166,37,129,oce
114,Rainbow Baby huh,"GRANDMASTER I
G",144,13.6,250,34,216,oce
115,why zyh and pipi,"GRANDMASTER I
G",140,14.2,295,42,253,oce
116,ssjfirzen,"GRANDMASTER I
G",137,11.9,1612,192,1420,oce
117,Umi,"GRANDMASTER I
G",135,15.4,182,28,154,oce
118,sanxingcaixukun,"GRANDMASTER I
G",134,13.1,791,104,687,oce
119,CLUBCANTHANDLEME,"GRANDMASTER I
G",132,16.4,335,55,280,oce
120,Petra,"GRANDMASTER I
G",126,23.9,159,38,121,oce
121,DonAlternate,"GRANDMASTER I
G",125,20.1,348,70,278,oce
122,xg1998,"GRANDMASTER I
G",124,16.7,221,37,184,oce
123,aicmg11111,"GRANDMASTER I
G",123,24.8,121,30,91,oce
124,Mo poisoness,"GRANDMASTER I
G",122,18.1,443,80,363,oce
125,abcd123456789,"GRANDMASTER I
G",121,20.2,173,35,138,oce
126,Fallangle,"GRANDMASTER I
G",119,18.0,233,42,191,oce
127,Dankk,"GRANDMASTER I
G",119,16.5,243,40,203,oce
128,YUKINO013,"GRANDMASTER I
G",118,14.1,348,49,299,oce
129,YILINHHH,"GRANDMASTER I
G",117,15.1,431,65,366,oce
130,Haober,"GRANDMASTER I
G",117,25.3,170,43,127,oce
131,dilisiad,"GRANDMASTER I
G",117,23.3,176,41,135,oce
132,amazingccc,"GRANDMASTER I
G",116,19.5,159,31,128,oce
133,SilencedbymySins,"GRANDMASTER I
G",115,17.7,147,26,121,oce
134,Lethal Zedstarr,"GRANDMASTER I
G",113,11.4,500,57,443,oce
135,Fwuffy Panda,"GRANDMASTER I
G",113,23.4,201,47,154,oce
136,WayneToDieeeeeee,"GRANDMASTER I
G",111,27.2,162,44,118,oce
137,01 04 1999,"GRANDMASTER I
G",111,20.3,202,41,161,oce
138,DegenRolling,"GRANDMASTER I
G",110,32.9,76,25,51,oce
139,821,"GRANDMASTER I
G",108,14.8,357,53,304,oce
140,Heart Doinb,"GRANDMASTER I
G",108,26.8,190,51,139,oce
141,dnn,"GRANDMASTER I
G",107,17.4,593,103,490,oce
142,Laotie Letsgo,"GRANDMASTER I
G",106,24.2,153,37,116,oce
143,huozhigaoxin,"GRANDMASTER I
G",102,16.8,238,40,198,oce
144,omgididit,"GRANDMASTER I
G",98,13.3,307,41,266,oce
145,Dwyan3 Wade,"GRANDMASTER I
G",97,14.8,431,64,367,oce
146,KeyaTFT,"GRANDMASTER I
G",97,25.9,135,35,100,oce
147,Jum,"GRANDMASTER I
G",96,16.8,220,37,183,oce
148,PVC Cai,"GRANDMASTER I
G",95,11.7,420,49,371,oce
149,kuaileyouxi,"GRANDMASTER I
G",92,23.4,167,39,128,oce
150,peanut1999,"GRANDMASTER I
G",92,16.1,124,20,104,oce
151,xiaozhiZP,MASTER I,156,17.1,502,86,416,oce
152,TItto9z,MASTER I,118,15.2,382,58,324,oce
153,wggrggt,MASTER I,114,21.9,137,30,107,oce
154,LiSTang,MASTER I,104,15.5,439,68,371,oce
155,frisco,MASTER I,99,10.5,256,27,229,oce
156,Whisper9897,MASTER I,92,16.1,143,23,120,oce
157,2CBeast,MASTER I,91,11.5,295,34,261,oce
158,Focus More,MASTER I,91,36.2,80,29,51,oce
159,Letme11,MASTER I,89,14.6,329,48,281,oce
160,nimameilwu,MASTER I,88,17.7,243,43,200,oce
161,kaiwen521,MASTER I,88,21.1,109,23,86,oce
162,Camm,MASTER I,87,16.1,791,127,664,oce
163,Resetioiuu,MASTER I,87,17.5,206,36,170,oce
164,ding1978,MASTER I,86,16.5,242,40,202,oce
165,zhuodaye,MASTER I,84,16.6,398,66,332,oce
166,100DJ CaiXuKun,MASTER I,83,19.0,126,24,102,oce
167,sorrybro,MASTER I,81,21.2,113,24,89,oce
168,QiWeiL,MASTER I,80,18.1,254,46,208,oce
169,shencj,MASTER I,80,28.0,107,30,77,oce
170,Jukelord,MASTER I,77,14.1,326,46,280,oce
171,AiryLaMenteuse,MASTER I,77,14.9,208,31,177,oce
172,kickhansass,MASTER I,74,12.2,229,28,201,oce
173,Toby,MASTER I,73,11.3,256,29,227,oce
174,6324ii,MASTER I,72,25.0,184,46,138,oce
175,shangxin0606,MASTER I,72,19.2,161,31,130,oce
176,igjackluv,MASTER I,71,30.2,119,36,83,oce
177,henannanyang,MASTER I,69,13.6,602,82,520,oce
178,xianqishenjiangl,MASTER I,69,17.2,366,63,303,oce
179,Zhiend,MASTER I,68,25.1,215,54,161,oce
180,Ergoudedie,MASTER I,68,11.1,296,33,263,oce
181,dkalRntm,MASTER I,66,14.7,245,36,209,oce
182,111iidj,MASTER I,66,21.7,106,23,83,oce
183,TooBreezy,MASTER I,65,13.4,217,29,188,oce
184,wuzyu123,MASTER I,65,27.5,91,25,66,oce
185,Jenry,MASTER I,64,13.2,190,25,165,oce
186,JH99,MASTER I,62,22.6,186,42,144,oce
187,zhuweiran,MASTER I,61,16.2,444,72,372,oce
188,AWAYmili,MASTER I,61,17.7,277,49,228,oce
189,firstmen,MASTER I,58,16.2,321,52,269,oce
190,xiaobai12131,MASTER I,58,20.0,140,28,112,oce
191,weigaosheng,MASTER I,57,13.0,461,60,401,oce
192,VainF,MASTER I,57,14.4,319,46,273,oce
193,manpede,MASTER I,56,18.0,111,20,91,oce
194,IllIIIll,MASTER I,55,15.9,151,24,127,oce
195,Bma,MASTER I,53,16.4,220,36,184,oce
196,wawkwakw,MASTER I,51,21.3,197,42,155,oce
197,jiushishen,MASTER I,51,19.8,177,35,142,oce
198,baboda,MASTER I,50,11.9,546,65,481,oce
199,rlekfufk,MASTER I,50,12.7,473,60,413,oce
200,chenshaqi,MASTER I,50,17.0,165,28,137,oce
1,Rubic,CHALLENGER I,1622,26.6,673,179,494,tr
2,kinqmusti43,CHALLENGER I,1474,25.5,568,145,423,tr
3,speedruzlol,CHALLENGER I,1120,24.6,448,110,338,tr
4,Benedetto,CHALLENGER I,947,22.1,349,77,272,tr
5,MAD JOSEPH 2,CHALLENGER I,923,23.6,322,76,246,tr
6,Ayenbe,CHALLENGER I,904,26.8,269,72,197,tr
7,MAD JOSEPH,CHALLENGER I,845,19.4,705,137,568,tr
8,Stay ruthless,CHALLENGER I,765,27.6,785,217,568,tr
9,Jok3r xx,CHALLENGER I,590,22.1,308,68,240,tr
10,Perceid TFT,CHALLENGER I,561,26.5,162,43,119,tr
11,keLch,CHALLENGER I,556,22.2,365,81,284,tr
12,bestâ,CHALLENGER I,553,21.3,380,81,299,tr
13,Jenerik,CHALLENGER I,541,22.7,260,59,201,tr
14,GreatEagle,CHALLENGER I,515,19.0,395,75,320,tr
15,Liquidzer,CHALLENGER I,485,18.3,454,83,371,tr
16,Nîtratex,CHALLENGER I,480,10.9,411,45,366,tr
17,Skinner27,CHALLENGER I,476,23.0,152,35,117,tr
18,sefaFluxx,CHALLENGER I,462,19.1,992,190,802,tr
19,MAC MASCARA,CHALLENGER I,462,14.8,600,89,511,tr
20,Waiden,CHALLENGER I,450,18.3,834,153,681,tr
21,ŁuciâN,CHALLENGER I,439,14.2,353,50,303,tr
22,Morte D Amour,CHALLENGER I,436,16.5,653,108,545,tr
23,Daldım Kazdım,CHALLENGER I,435,22.6,292,66,226,tr
24,jan uma,CHALLENGER I,431,22.1,253,56,197,tr
25,Jonas Salk,CHALLENGER I,430,11.8,602,71,531,tr
26,StahpItRito v2,CHALLENGER I,427,22.6,181,41,140,tr
27,lAdastra,CHALLENGER I,419,19.8,550,109,441,tr
28,NİZİPLİİİ,CHALLENGER I,417,21.6,907,196,711,tr
29,Meglendiel,CHALLENGER I,414,17.0,716,122,594,tr
30,11 04 2004,CHALLENGER I,412,14.8,520,77,443,tr
31,Shinzu,CHALLENGER I,407,10.5,513,54,459,tr
32,NEXTENAAA,CHALLENGER I,407,18.7,262,49,213,tr
33,TFT Colorâblê,CHALLENGER I,396,16.7,215,36,179,tr
34,SunChos,CHALLENGER I,394,14.9,988,147,841,tr
35,SİVASLI PONÇİK,CHALLENGER I,394,15.9,339,54,285,tr
36,FeelingTheBlanks,CHALLENGER I,393,11.9,480,57,423,tr
37,TFT Colorâblê v2,CHALLENGER I,392,14.9,235,35,200,tr
38,Troll Bir Nick,CHALLENGER I,385,19.1,878,168,710,tr
39,MUHENDİSBEY TFT,CHALLENGER I,385,17.1,414,71,343,tr
40,Slay,CHALLENGER I,385,21.1,251,53,198,tr
41,mettuzwee,CHALLENGER I,378,25.7,183,47,136,tr
42,Discronatia,CHALLENGER I,372,16.8,328,55,273,tr
43,THE BOSS PALA,CHALLENGER I,372,13.7,364,50,314,tr
44,KR Challenger1,CHALLENGER I,371,32.1,112,36,76,tr
45,Hyperr roll babe,CHALLENGER I,369,21.4,131,28,103,tr
46,Furriya,CHALLENGER I,365,18.1,265,48,217,tr
47,Seyfi Baba QQ,CHALLENGER I,363,18.1,663,120,543,tr
48,zikerr,CHALLENGER I,361,14.8,526,78,448,tr
49,Darksword02,CHALLENGER I,341,16.3,798,130,668,tr
50,9x37,CHALLENGER I,272,14.7,619,91,528,tr
51,w0lverinee,"GRANDMASTER I
G",353,15.8,1111,176,935,tr
52,valiumx,"GRANDMASTER I
G",345,12.2,977,119,858,tr
53,Tasty,"GRANDMASTER I
G",328,18.5,184,34,150,tr
54,clssJaGG,"GRANDMASTER I
G",308,15.1,728,110,618,tr
55,ƒallenGod,"GRANDMASTER I
G",305,20.2,316,64,252,tr
56,ForyuS,"GRANDMASTER I
G",304,11.0,976,107,869,tr
57,StahpItRito,"GRANDMASTER I
G",293,25.1,195,49,146,tr
58,Top 8,"GRANDMASTER I
G",286,24.6,268,66,202,tr
59,canadianturkey,"GRANDMASTER I
G",269,25.6,180,46,134,tr
60,ÇokTaRinTinTinV2,"GRANDMASTER I
G",256,18.6,429,80,349,tr
61,BrushLeee,"GRANDMASTER I
G",237,14.7,197,29,168,tr
62,Phoebe,"GRANDMASTER I
G",216,18.6,413,77,336,tr
63,asvpxtitan,"GRANDMASTER I
G",214,13.9,704,98,606,tr
64,TEOİSTİK,"GRANDMASTER I
G",212,13.3,338,45,293,tr
65,OgUzhan22,"GRANDMASTER I
G",211,14.3,706,101,605,tr
66,caglar128,"GRANDMASTER I
G",206,13.4,232,31,201,tr
67,ŹéÐáñìêłš,"GRANDMASTER I
G",198,13.4,686,92,594,tr
68,Akaki Akakiyeviç,"GRANDMASTER I
G",197,13.2,394,52,342,tr
69,play for a fun,"GRANDMASTER I
G",193,18.6,252,47,205,tr
70,No Life Ceset,"GRANDMASTER I
G",188,17.7,727,129,598,tr
71,Luca Toni,"GRANDMASTER I
G",188,16.7,246,41,205,tr
72,Kral Leonidass,"GRANDMASTER I
G",187,14.2,846,120,726,tr
73,Spanker HS,"GRANDMASTER I
G",184,20.1,566,114,452,tr
74,TFT Ołrïc,"GRANDMASTER I
G",172,13.7,233,32,201,tr
75,EazyPz,"GRANDMASTER I
G",161,22.7,295,67,228,tr
76,Xaviertz,"GRANDMASTER I
G",151,17.4,408,71,337,tr
77,ÇopurBey,"GRANDMASTER I
G",148,11.9,899,107,792,tr
78,Kemal KS,"GRANDMASTER I
G",142,15.9,674,107,567,tr
79,Berke İnan,"GRANDMASTER I
G",142,16.4,274,45,229,tr
80,Bir Spartalı,"GRANDMASTER I
G",138,17.3,272,47,225,tr
81,My0neSS,"GRANDMASTER I
G",137,17.5,867,152,715,tr
82,BeeepbeepimaJeep,"GRANDMASTER I
G",127,15.6,218,34,184,tr
83,Motosho,"GRANDMASTER I
G",126,20.0,250,50,200,tr
84,ATC Bulbasaur,"GRANDMASTER I
G",125,17.1,263,45,218,tr
85,Sayonara Baby,"GRANDMASTER I
G",124,11.8,907,107,800,tr
86,sads,"GRANDMASTER I
G",124,15.7,527,83,444,tr
87,TheBigWal,"GRANDMASTER I
G",121,12.2,229,28,201,tr
88,Jthie,"GRANDMASTER I
G",117,21.0,262,55,207,tr
89,Mavix,"GRANDMASTER I
G",117,19.3,176,34,142,tr
90,ReachijaX,"GRANDMASTER I
G",115,13.2,833,110,723,tr
91,turkuazv2,"GRANDMASTER I
G",110,18.8,288,54,234,tr
92,Riven İs Mine,"GRANDMASTER I
G",109,18.1,276,50,226,tr
93,Boxerli Arap,"GRANDMASTER I
G",108,23.2,284,66,218,tr
94,Jâsper,"GRANDMASTER I
G",107,18.1,182,33,149,tr
95,Ragyo,"GRANDMASTER I
G",104,17.2,835,144,691,tr
96,PrequaL,"GRANDMASTER I
G",103,16.2,637,103,534,tr
97,Plug,"GRANDMASTER I
G",102,16.6,386,64,322,tr
98,serseratx,"GRANDMASTER I
G",101,15.7,255,40,215,tr
99,qR Kai Hiwatari,"GRANDMASTER I
G",101,11.0,346,38,308,tr
100,Sağtık CEBO,"GRANDMASTER I
G",100,11.3,461,52,409,tr
101,HattoriZarbo,"GRANDMASTER I
G",99,16.2,308,50,258,tr
102,JuJuFiFi,"GRANDMASTER I
G",96,13.4,394,53,341,tr
103,Sinjeog Jonjae,"GRANDMASTER I
G",96,20.9,234,49,185,tr
104,DT Escanor,"GRANDMASTER I
G",95,15.4,260,40,220,tr
105,WhackyLuck,"GRANDMASTER I
G",94,15.8,499,79,420,tr
106,SUQ MADİK,"GRANDMASTER I
G",94,18.5,249,46,203,tr
107,slowly sari,"GRANDMASTER I
G",92,17.5,297,52,245,tr
108,xlProDRoMaLlx,"GRANDMASTER I
G",91,15.8,227,36,191,tr
109,MrDdad,"GRANDMASTER I
G",86,20.1,377,76,301,tr
110,AxiBy,"GRANDMASTER I
G",83,15.6,627,98,529,tr
111,Rapscallion FK,"GRANDMASTER I
G",81,21.0,534,112,422,tr
112,ImCurly,"GRANDMASTER I
G",77,16.5,643,106,537,tr
113,Prenses Irelia,"GRANDMASTER I
G",75,13.8,570,79,491,tr
114,Itachi Uchiha,"GRANDMASTER I
G",69,12.1,720,87,633,tr
115,Durp,"GRANDMASTER I
G",62,18.8,165,31,134,tr
116,TFT CEBO,"GRANDMASTER I
G",61,14.2,162,23,139,tr
117,AshleyG,"GRANDMASTER I
G",60,12.5,576,72,504,tr
118,Apo sen misin la,"GRANDMASTER I
G",58,17.2,332,57,275,tr
119,ExeSus v1,"GRANDMASTER I
G",56,14.3,727,104,623,tr
120,Ruheass,"GRANDMASTER I
G",56,17.9,448,80,368,tr
121,THEPRAT,"GRANDMASTER I
G",53,11.7,403,47,356,tr
122,KimbuLeyla,"GRANDMASTER I
G",49,16.8,149,25,124,tr
123,Coria,"GRANDMASTER I
G",48,15.0,373,56,317,tr
124,Nerva,"GRANDMASTER I
G",48,13.9,216,30,186,tr
125,N0NNstar,"GRANDMASTER I
G",47,16.7,442,74,368,tr
126,Reis Back,"GRANDMASTER I
G",47,12.3,341,42,299,tr
127,SSW,"GRANDMASTER I
G",45,13.6,1192,162,1030,tr
128,Rykes,"GRANDMASTER I
G",45,17.0,265,45,220,tr
129,BEN THRESH NABER,"GRANDMASTER I
G",45,13.4,224,30,194,tr
130,itsAƒucknComedy,"GRANDMASTER I
G",44,15.3,267,41,226,tr
131,diwine fish,"GRANDMASTER I
G",40,20.6,165,34,131,tr
132,Usta Splinterr,"GRANDMASTER I
G",40,13.6,228,31,197,tr
133,LA ShootingGuard,"GRANDMASTER I
G",39,16.3,276,45,231,tr
134,Mutsuz,"GRANDMASTER I
G",39,14.3,203,29,174,tr
135,Punaise,"GRANDMASTER I
G",38,12.2,1193,146,1047,tr
136,Plug v2,"GRANDMASTER I
G",37,20.8,159,33,126,tr
137,bunupthedance,"GRANDMASTER I
G",36,31.2,96,30,66,tr
138,Terryfold,"GRANDMASTER I
G",36,24.6,118,29,89,tr
139,MhRayleiphosor,"GRANDMASTER I
G",34,20.8,298,62,236,tr
140,Dr Manhattan,"GRANDMASTER I
G",34,20.6,247,51,196,tr
141,ÜSTADIM,"GRANDMASTER I
G",34,12.0,284,34,250,tr
142,CacaReyiz1907,"GRANDMASTER I
G",32,13.1,726,95,631,tr
143,Pepee16,"GRANDMASTER I
G",30,13.8,866,120,746,tr
144,TR Ryzê,"GRANDMASTER I
G",30,15.5,381,59,322,tr
145,IamSonGoku,"GRANDMASTER I
G",27,13.8,486,67,419,tr
146,bigballsman,"GRANDMASTER I
G",27,32.5,86,28,58,tr
147,Beramusluu TFT,"GRANDMASTER I
G",15,15.2,475,72,403,tr
148,Perceid,"GRANDMASTER I
G",4,18.4,495,91,404,tr
149,AdnantalhaV,"GRANDMASTER I
G",0,21.0,267,56,211,tr
150,ll Mr Yılmâz TFT,MASTER I,111,15.5,420,65,355,tr
151,Kara Sevdalım,MASTER I,90,19.2,707,136,571,tr
152,The lazy Phil,MASTER I,73,17.2,192,33,159,tr
153,SuBA x,MASTER I,58,5.5,730,40,690,tr
154,mFatality,MASTER I,53,12.5,543,68,475,tr
155,ÃŁÞhÃ,MASTER I,53,20.7,208,43,165,tr
156,Boşver,MASTER I,51,17.8,477,85,392,tr
157,Şürkü,MASTER I,40,14.3,629,90,539,tr
158,HGCiko,MASTER I,35,17.2,215,37,178,tr
159,Qyrieq,MASTER I,31,9.0,245,22,223,tr
160,GrevenLosT,MASTER I,26,12.6,612,77,535,tr
161,İqos,MASTER I,25,21.4,322,69,253,tr
162,sabonohiken,MASTER I,25,16.7,126,21,105,tr
163,Marijuaña,MASTER I,24,11.7,881,103,778,tr
164,Beysal,MASTER I,20,23.0,209,48,161,tr
165,Useless Shaco,MASTER I,19,15.3,567,87,480,tr
166,UnknownZ7,MASTER I,17,16.7,203,34,169,tr
167,ArcHaic,MASTER I,16,18.6,231,43,188,tr
168,artyomdh,MASTER I,16,19.9,136,27,109,tr
169,KÓÐ ÃÐI ŻÉÐ,MASTER I,15,16.5,339,56,283,tr
170,Night Train,MASTER I,14,14.7,544,80,464,tr
171,BABALARIN AHMET,MASTER I,14,13.8,470,65,405,tr
172,Speraktif v2,MASTER I,14,19.8,167,33,134,tr
173,Necessarium,MASTER I,11,13.9,237,33,204,tr
174,Rayzet,MASTER I,11,18.4,174,32,142,tr
175,The Ârt of Zed,MASTER I,11,18.8,165,31,134,tr
176,SirSirius,MASTER I,9,25.8,97,25,72,tr
177,Srcnym,MASTER I,8,18.2,285,52,233,tr
178,LeqacyOfKaiN,MASTER I,8,14.5,331,48,283,tr
179,Swarles Barkley,MASTER I,7,27.7,101,28,73,tr
180,cropovez,MASTER I,7,12.6,223,28,195,tr
181,UMP,MASTER I,6,23.5,204,48,156,tr
182,AçılnBenDokturm,MASTER I,6,16.5,261,43,218,tr
183,Alanyalı Efe,MASTER I,6,25.5,157,40,117,tr
184,PARA,MASTER I,6,17.3,225,39,186,tr
185,SCARFÆCE,MASTER I,6,16.1,205,33,172,tr
186,elyêl,MASTER I,5,22.0,499,110,389,tr
187,AcviLion,MASTER I,5,16.6,452,75,377,tr
188,blobfısh,MASTER I,5,14.2,332,47,285,tr
189,Simurg TFT,MASTER I,5,21.6,162,35,127,tr
190,YılanYapKendini,MASTER I,4,10.3,670,69,601,tr
191,Bihter ZiyagiI,MASTER I,3,13.3,622,83,539,tr
192,HaunteD TFT,MASTER I,3,14.1,390,55,335,tr
193,Peredhil,MASTER I,3,12.9,332,43,289,tr
194,TinerShelby,MASTER I,3,15.5,187,29,158,tr
195,IIIMeA CuLpAIII,MASTER I,3,15.8,177,28,149,tr
196,COKKOTUOLDUBU,MASTER I,2,23.9,205,49,156,tr
197,ISGT PeaceI,MASTER I,2,14.6,151,22,129,tr
198,Veichi,MASTER I,1,21.8,349,76,273,tr
199,ILothlórien,MASTER I,1,12.4,442,55,387,tr
200,menaSUVARi,MASTER I,1,15.6,212,33,179,tr
1,KroniiinepTFT,CHALLENGER I,981,27.7,364,101,263,ru
2,chmochma,CHALLENGER I,945,24.0,354,85,269,ru
3,HORNIE MY BABY,CHALLENGER I,839,33.5,266,89,177,ru
4,Nycteus,CHALLENGER I,827,23.8,227,54,173,ru
5,aLeProfane,CHALLENGER I,793,26.0,430,112,318,ru
6,superworldRU,CHALLENGER I,718,19.9,413,82,331,ru
7,kobeyang,CHALLENGER I,696,29.3,604,177,427,ru
8,Dyachello,CHALLENGER I,660,20.4,402,82,320,ru
9,LMS trojancbkui,CHALLENGER I,538,14.7,593,87,506,ru
10,WuHan jiayou,CHALLENGER I,523,27.5,229,63,166,ru
11,МRAZIverniteNICK,CHALLENGER I,425,26.3,357,94,263,ru
12,Theblueboy,CHALLENGER I,397,30.2,215,65,150,ru
13,kiiller,CHALLENGER I,362,18.3,213,39,174,ru
14,Bingo123456,CHALLENGER I,347,17.7,419,74,345,ru
15,Hardrinnz,CHALLENGER I,344,30.3,152,46,106,ru
16,Yablo4niy,CHALLENGER I,341,24.3,189,46,143,ru
17,KENGBI,CHALLENGER I,324,20.6,515,106,409,ru
18,L9 Rengy,CHALLENGER I,324,17.5,543,95,448,ru
19,CNGOOD,CHALLENGER I,317,24.9,261,65,196,ru
20,DrKaktys,CHALLENGER I,317,17.8,202,36,166,ru
21,Zauberbiest,CHALLENGER I,289,18.1,271,49,222,ru
22,DespicabIe,CHALLENGER I,254,25.1,330,83,247,ru
23,NeverTrustSoloQ,CHALLENGER I,250,24.5,212,52,160,ru
24,Тяньци,CHALLENGER I,238,21.6,190,41,149,ru
25,NMЯ NO ИМЯ,CHALLENGER I,230,20.1,318,64,254,ru
26,JoSmog,CHALLENGER I,229,16.0,620,99,521,ru
27,Không Có Link,CHALLENGER I,205,17.5,599,105,494,ru
28,Arclight Panda,CHALLENGER I,196,18.8,398,75,323,ru
29,Светофорчик,CHALLENGER I,196,26.4,250,66,184,ru
30,e 1,CHALLENGER I,196,17.5,359,63,296,ru
31,Sоul Reaver,CHALLENGER I,190,20.6,184,38,146,ru
32,Mark of uroboros,CHALLENGER I,189,21.9,970,212,758,ru
33,Sacred Nоrris,CHALLENGER I,186,14.1,1371,193,1178,ru
34,Авиатор Платонов,CHALLENGER I,180,24.8,339,84,255,ru
35,Iggi 1TrickPferd,CHALLENGER I,169,27.4,175,48,127,ru
36,FIMA,CHALLENGER I,162,21.5,251,54,197,ru
37,Arcade bÔÔbs,CHALLENGER I,159,20.2,554,112,442,ru
38,ENDEAVOUR,CHALLENGER I,156,18.6,307,57,250,ru
39,Юрa,CHALLENGER I,148,15.0,227,34,193,ru
40,Legenda of LOL,CHALLENGER I,145,13.2,340,45,295,ru
41,Кисюня,CHALLENGER I,143,26.4,125,33,92,ru
42,ruComix,CHALLENGER I,140,23.6,220,52,168,ru
43,bingo666fly,CHALLENGER I,134,22.4,214,48,166,ru
44,Kapibaro,CHALLENGER I,125,23.5,345,81,264,ru
45,hornie,CHALLENGER I,125,27.0,148,40,108,ru
46,Paprika,CHALLENGER I,125,20.3,177,36,141,ru
47,Anurion89,CHALLENGER I,121,19.2,334,64,270,ru
48,Long live China,CHALLENGER I,120,18.1,276,50,226,ru
49,fantik999,CHALLENGER I,98,15.8,183,29,154,ru
50,LРL,CHALLENGER I,62,14.4,1153,166,987,ru
51,HMTuanRu,"GRANDMASTER I
G",192,20.8,394,82,312,ru
52,Youbanyouto,"GRANDMASTER I
G",162,19.2,234,45,189,ru
53,NikeIII,"GRANDMASTER I
G",139,29.6,186,55,131,ru
54,Rukashi,"GRANDMASTER I
G",110,31.6,114,36,78,ru
55,Shinkulirion,"GRANDMASTER I
G",97,22.1,380,84,296,ru
56,Kalabaka,"GRANDMASTER I
G",90,27.7,909,252,657,ru
57,Ignotas,"GRANDMASTER I
G",88,21.5,135,29,106,ru
58,Sapfer,"GRANDMASTER I
G",71,16.7,539,90,449,ru
59,VN iRabity,"GRANDMASTER I
G",68,19.4,674,131,543,ru
60,NikolayDjan,"GRANDMASTER I
G",67,18.6,463,86,377,ru
61,BEASTMXDE,"GRANDMASTER I
G",53,17.9,391,70,321,ru
62,Hail of Blades,"GRANDMASTER I
G",53,24.6,167,41,126,ru
63,lza,"GRANDMASTER I
G",52,20.8,207,43,164,ru
64,Cоming Down,"GRANDMASTER I
G",52,17.3,225,39,186,ru
65,K R I P S I,"GRANDMASTER I
G",48,23.7,266,63,203,ru
66,PeiPei,"GRANDMASTER I
G",43,12.9,481,62,419,ru
67,im famous,"GRANDMASTER I
G",42,15.7,230,36,194,ru
68,Morozilkin,"GRANDMASTER I
G",40,22.3,224,50,174,ru
69,lywh,"GRANDMASTER I
G",40,13.2,129,17,112,ru
70,Tâm Luct,"GRANDMASTER I
G",36,17.0,247,42,205,ru
71,LegendsNeverDIE0,"GRANDMASTER I
G",33,23.3,279,65,214,ru
72,ZiGZaG08,"GRANDMASTER I
G",32,16.4,262,43,219,ru
73,The Inspired One,"GRANDMASTER I
G",30,20.3,148,30,118,ru
74,BomBibomXD,"GRANDMASTER I
G",28,12.7,536,68,468,ru
75,ЗабулдыгаНовичёк,"GRANDMASTER I
G",23,10.7,1307,140,1167,ru
76,Ksorn,"GRANDMASTER I
G",23,12.7,213,27,186,ru
77,Th3Gambl3r,"GRANDMASTER I
G",22,19.1,617,118,499,ru
78,Sebastian7,"GRANDMASTER I
G",22,21.9,251,55,196,ru
79,NickDeko,"GRANDMASTER I
G",21,18.9,424,80,344,ru
80,ПаГа,"GRANDMASTER I
G",16,13.7,461,63,398,ru
81,Леди Меламори,"GRANDMASTER I
G",16,14.7,211,31,180,ru
82,ASREN,"GRANDMASTER I
G",14,18.7,155,29,126,ru
83,CapsuleZZZ,"GRANDMASTER I
G",12,16.9,230,39,191,ru
84,royál beggar,"GRANDMASTER I
G",11,20.1,159,32,127,ru
85,Wuaneon,"GRANDMASTER I
G",9,19.9,171,34,137,ru
86,CNGOOD1,"GRANDMASTER I
G",5,20.4,265,54,211,ru
87,Remilia Scarlet,"GRANDMASTER I
G",5,22.0,214,47,167,ru
88,Генерал Docta,"GRANDMASTER I
G",5,29.7,155,46,109,ru
89,AlloC,"GRANDMASTER I
G",3,21.1,199,42,157,ru
90,ropo4ka,"GRANDMASTER I
G",0,17.6,449,79,370,ru
91,Torianos,"GRANDMASTER I
G",0,12.1,618,75,543,ru
92,Жабка Лиска,"GRANDMASTER I
G",0,24.0,300,72,228,ru
93,Hand off 3,"GRANDMASTER I
G",0,20.5,336,69,267,ru
94,Kiss my fizz,"GRANDMASTER I
G",0,20.7,323,67,256,ru
95,Ветра Севера,"GRANDMASTER I
G",0,9.0,566,51,515,ru
96,CK Guard,"GRANDMASTER I
G",0,24.6,187,46,141,ru
97,CuPofCrAcK,"GRANDMASTER I
G",0,11.0,401,44,357,ru
98,nlinhsv21,"GRANDMASTER I
G",0,19.3,192,37,155,ru
99,Programmer,"GRANDMASTER I
G",0,16.1,224,36,188,ru
100,Killl Lov3,"GRANDMASTER I
G",0,23.8,122,29,93,ru
101,Silent Sona,MASTER I,56,19.8,404,80,324,ru
102,Jaguar,MASTER I,20,12.5,272,34,238,ru
103,Kahzoo is KING,MASTER I,12,32.4,105,34,71,ru
104,BrotherFrank,MASTER I,10,27.1,129,35,94,ru
105,Hen predator,MASTER I,5,19.7,340,67,273,ru
106,VN Troll,MASTER I,4,9.2,746,69,677,ru
107,TG Rot Stillness,MASTER I,0,11.6,424,49,375,ru
108,inspekt0r,DIAMOND I,98,18.6,345,64,281,ru
109,СерёгаСПб,DIAMOND I,90,18.9,460,87,373,ru
110,Воруй94,DIAMOND I,86,26.2,141,37,104,ru
111,AeCorah,DIAMOND I,75,25.0,640,160,480,ru
112,thanh169,DIAMOND I,75,22.8,552,126,426,ru
113,TOMSK7777,DIAMOND I,75,23.1,399,92,307,ru
114,ChinaNirvana,DIAMOND I,75,22.3,399,89,310,ru
115,Крада,DIAMOND I,75,12.8,602,77,525,ru
116,Крушитель001,DIAMOND I,75,19.2,369,71,298,ru
117,TFT tsm,DIAMOND I,75,16.2,431,70,361,ru
118,EmperorCHN,DIAMOND I,75,25.4,264,67,197,ru
119,SUSUWE,DIAMOND I,75,17.0,383,65,318,ru
120,Lorraine,DIAMOND I,75,27.0,233,63,170,ru
121,ìnsane,DIAMOND I,75,20.3,300,61,239,ru
122,Eldrax,DIAMOND I,75,13.4,441,59,382,ru
123,lºˆºl,DIAMOND I,75,23.0,248,57,191,ru
124,1348319349,DIAMOND I,75,21.1,270,57,213,ru
125,Джим Рейнор,DIAMOND I,75,17.6,312,55,257,ru
126,Marijuanamama,DIAMOND I,75,15.6,352,55,297,ru
127,AKJSDs,DIAMOND I,75,25.2,206,52,154,ru
128,dyboщит,DIAMOND I,75,18.5,276,51,225,ru
129,blvckboy,DIAMOND I,75,15.3,320,49,271,ru
130,CR0WNZ,DIAMOND I,75,16.0,269,43,226,ru
131,Hoang,DIAMOND I,75,20.9,201,42,159,ru
132,Spring North,DIAMOND I,75,18.0,233,42,191,ru
133,Make me Purr,DIAMOND I,75,20.0,200,40,160,ru
134,dontlookatmepls,DIAMOND I,75,32.2,90,29,61,ru
135,iQuestions,DIAMOND I,75,18.9,132,25,107,ru
136,Just Cancer,DIAMOND I,68,18.3,213,39,174,ru
137,vulcaner,DIAMOND I,66,21.1,185,39,146,ru
138,CN liang,DIAMOND I,63,16.6,440,73,367,ru
139,beznika2,DIAMOND I,61,14.4,215,31,184,ru
140,DuongLan,DIAMOND I,59,16.0,368,59,309,ru
141,Малолетка,DIAMOND I,55,32.9,76,25,51,ru
142,PistolMaravich,DIAMOND I,48,36.0,264,95,169,ru
143,Дрeeейвен,DIAMOND I,48,11.0,662,73,589,ru
144,УРОД,DIAMOND I,48,40.1,177,71,106,ru
145,NorMe,DIAMOND I,46,18.4,152,28,124,ru
146,KissTheStar,DIAMOND I,44,9.2,413,38,375,ru
147,zhangqiling,DIAMOND I,42,16.5,285,47,238,ru
148,junestone,DIAMOND I,41,30.4,214,65,149,ru
149,royál beggar,DIAMOND I,38,23.6,186,44,142,ru
150,mTxFaT,DIAMOND I,37,18.3,901,165,736,ru
151,ReMiXoN007,DIAMOND I,33,22.7,141,32,109,ru
152,8xm12a,DIAMOND I,32,11.6,276,32,244,ru
153,ПоНосик в Одеяле,DIAMOND I,31,27.9,204,57,147,ru
154,Rocket MaRin,DIAMOND I,31,23.5,234,55,179,ru
155,SadSlipperS,DIAMOND I,28,12.6,585,74,511,ru
156,Saitaf,DIAMOND I,25,23.0,226,52,174,ru
157,Dunngarm,DIAMOND I,25,26.3,171,45,126,ru
158,KURISU ТИНА,DIAMOND I,24,19.5,1032,201,831,ru
159,STRMASTER,DIAMOND I,22,24.5,216,53,163,ru
160,Kimchi wang,DIAMOND I,17,34.6,127,44,83,ru
161,КОРОЛЬ БОГ КОСМО,DIAMOND I,15,17.5,679,119,560,ru
162,РОЗБИЙНЫК,DIAMOND I,13,13.6,546,74,472,ru
163,kecodon9x,DIAMOND I,12,18.0,205,37,168,ru
164,Ji Yong,DIAMOND I,11,13.3,279,37,242,ru
165,SorrNyak,DIAMOND I,9,18.3,197,36,161,ru
166,Таксидермист1980,DIAMOND I,4,11.5,512,59,453,ru
167,qsoso,DIAMOND I,4,17.2,303,52,251,ru
168,StaverOk,DIAMOND I,3,21.1,237,50,187,ru
169,ktotamnukogonet,DIAMOND I,3,25.8,128,33,95,ru
170,JusticeNari,DIAMOND I,3,14.7,217,32,185,ru
171,angelys,DIAMOND I,3,10.4,288,30,258,ru
172,VN Error RoLL,DIAMOND I,2,13.5,679,92,587,ru
173,Futaba Sakura,DIAMOND I,1,24.4,131,32,99,ru
174,Trang4438,DIAMOND I,0,19.7,395,78,317,ru
175,Arclight JinBey,DIAMOND I,0,18.6,327,61,266,ru
176,Лёшкина игра,DIAMOND I,0,24.2,231,56,175,ru
177,GEOtiger,DIAMOND I,0,16.7,330,55,275,ru
178,GGJIANG,DIAMOND I,0,19.0,284,54,230,ru
179,Вика Клубника,DIAMOND I,0,21.3,249,53,196,ru
180,sketcheer,DIAMOND I,0,16.9,308,52,256,ru
181,LPL dynasty,DIAMOND I,0,21.7,212,46,166,ru
182,SM2LR,DIAMOND I,0,20.2,228,46,182,ru
183,лесk urself jgl,DIAMOND I,0,19.7,208,41,167,ru
184,Мёртвый принц,DIAMOND I,0,18.1,221,40,181,ru
185,RaNdoOoMuK,DIAMOND I,0,20.4,191,39,152,ru
186,EleemY,DIAMOND I,0,33.0,112,37,75,ru
187,PINCER,DIAMOND I,0,25.6,125,32,93,ru
188,Callsign Kindred,DIAMOND I,0,32.2,90,29,61,ru
189,Дым из трубы,DIAMOND I,0,27.2,103,28,75,ru
190,Tot,DIAMOND I,0,18.6,145,27,118,ru
191,Vladimir Syusin,DIAMOND I,0,11.0,246,27,219,ru
192,Лапки Юми,DIAMOND II,82,15.6,340,53,287,ru
193,GunnerMSK,DIAMOND II,81,20.5,259,53,206,ru
194,Desperateing,DIAMOND II,76,30.8,78,24,54,ru
195,RNGM1xg,DIAMOND II,75,20.7,458,95,363,ru
196,Janelicher,DIAMOND II,75,28.8,208,60,148,ru
197,lanyuheissl55555,DIAMOND II,75,19.9,276,55,221,ru
198,Bushuwotoudehong,DIAMOND II,75,19.9,276,55,221,ru
199,RngUziJianZihao,DIAMOND II,75,18.4,266,49,217,ru
200,Cho Em Mãnh Thú,DIAMOND II,75,16.5,291,48,243,ru
