rank,name,tier,lp,win rate,played,wins,losses,region
1,Mismatched Socks,CHALLENGER I,1541,21.4,494,106,388,na
2,Ms MatchedSocks,CHALLENGER I,1457,21.6,463,100,363,na
3,Salvyyy,CHALLENGER I,1435,26.5,283,75,208,na
4,gv8,CHALLENGER I,1385,21.1,554,117,437,na
5,FluffyHS,CHALLENGER I,1354,18.3,453,83,370,na
6,Kurumx,CHALLENGER I,1291,20.5,596,122,474,na
7,bertasaurus,CHALLENGER I,1241,17.7,943,167,776,na
8,Naturesbf,CHALLENGER I,1238,15.4,934,144,790,na
9,GrandVice8,CHALLENGER I,1206,19.6,743,146,597,na
10,ajmonsta,CHALLENGER I,1105,16.5,533,88,445,na
11,JIGEJIUWO,CHALLENGER I,1076,16.8,524,88,436,na
12,Krmx,CHALLENGER I,1026,20.3,635,129,506,na
13,Cottontail,CHALLENGER I,1026,15.4,689,106,583,na
14,Silliest,CHALLENGER I,1020,25.6,359,92,267,na
15,Hiraino,CHALLENGER I,1018,15.9,895,142,753,na
16,Gunmay,CHALLENGER I,968,11.1,505,56,449,na
17,lLykus,CHALLENGER I,957,16.4,880,144,736,na
18,111094 R,CHALLENGER I,942,13.7,1697,233,1464,na
19,GoyoTV,CHALLENGER I,933,15.8,844,133,711,na
20,HiROKKKKJP,CHALLENGER I,916,16.4,602,99,503,na
21,Old Lodo,CHALLENGER I,915,16.2,406,66,340,na
22,EAOST,CHALLENGER I,884,14.9,563,84,479,na
23,Kiyoon,CHALLENGER I,876,18.6,1004,187,817,na
24,M35S,CHALLENGER I,871,15.3,940,144,796,na
25,Inphinit3,CHALLENGER I,853,16.2,494,80,414,na
26,ttv KitingisHard,CHALLENGER I,843,17.2,956,165,791,na
27,Grillsyy,CHALLENGER I,838,15.7,737,116,621,na
28,Nice Mister Kien,CHALLENGER I,826,16.8,489,82,407,na
29,Agon,CHALLENGER I,818,18.1,808,146,662,na
30,v Köi v,CHALLENGER I,817,21.9,366,80,286,na
31,dowfu ph,CHALLENGER I,817,20.6,267,55,212,na
32,ItzYaBoyBeasty,CHALLENGER I,813,17.1,1014,173,841,na
33,C9 k3soju,CHALLENGER I,811,20.6,1031,213,818,na
34,BIuePrincess,CHALLENGER I,811,18.9,243,46,197,na
35,Live for the Day,CHALLENGER I,809,19.4,839,163,676,na
36,Ripple Overdrive,CHALLENGER I,806,15.3,307,47,260,na
37,enchabi,CHALLENGER I,796,16.2,297,48,249,na
38,Flandre Bot,CHALLENGER I,764,16.9,243,41,202,na
39,TempestLife,CHALLENGER I,754,19.9,282,56,226,na
40,inay,CHALLENGER I,744,16.0,982,157,825,na
41,The Cxk,CHALLENGER I,744,16.5,424,70,354,na
42,Kled Bundy,CHALLENGER I,737,13.6,1363,186,1177,na
43,themackerel,CHALLENGER I,732,13.3,751,100,651,na
44,Ex Railgun,CHALLENGER I,720,16.8,788,132,656,na
45,WhySofaKing,CHALLENGER I,720,14.7,510,75,435,na
46,Fxxx Yaaa,CHALLENGER I,710,18.1,414,75,339,na
47,Wrackle,CHALLENGER I,710,14.0,393,55,338,na
48,Xerluk,CHALLENGER I,705,13.8,671,93,578,na
49,AceofSpadesDAC,CHALLENGER I,704,18.0,668,120,548,na
50,Ol Lodo,CHALLENGER I,704,15.6,468,73,395,na
51,theMaskedPatel,CHALLENGER I,704,16.6,326,54,272,na
52,Eason with U,CHALLENGER I,698,20.7,299,62,237,na
53,wx qq258790278,CHALLENGER I,692,19.3,430,83,347,na
54,influrrier,CHALLENGER I,689,16.1,952,153,799,na
55,pastafartianist,CHALLENGER I,687,22.4,236,53,183,na
56,Souless,CHALLENGER I,684,23.2,185,43,142,na
57,H2211,CHALLENGER I,682,19.9,1192,237,955,na
58,ChrisKillsX,CHALLENGER I,679,20.0,160,32,128,na
59,TheMagykal,CHALLENGER I,678,16.5,932,154,778,na
60,qieqie,CHALLENGER I,678,19.0,541,103,438,na
61,McDull,CHALLENGER I,676,14.6,830,121,709,na
62,Zadust TFT,CHALLENGER I,670,15.7,586,92,494,na
63,Broccóli,CHALLENGER I,669,14.7,518,76,442,na
64,TwitchTV Odyceuz,CHALLENGER I,667,17.7,481,85,396,na
65,wo chi bu pang,CHALLENGER I,666,18.0,294,53,241,na
66,Stompalittle,CHALLENGER I,657,14.6,1277,187,1090,na
67,TFT Parval,CHALLENGER I,654,14.0,527,74,453,na
68,WANG SHUO ZHE,CHALLENGER I,654,18.3,289,53,236,na
69,NA SMURF KEKW,CHALLENGER I,653,17.2,221,38,183,na
70,MaskedPatel,CHALLENGER I,653,15.3,242,37,205,na
71,slippinbug,CHALLENGER I,647,17.4,305,53,252,na
72,Sphinx,CHALLENGER I,642,9.8,755,74,681,na
73,brofael,CHALLENGER I,640,12.9,1208,156,1052,na
74,Akurai,CHALLENGER I,640,18.1,349,63,286,na
75,JayGeBee,CHALLENGER I,634,14.5,656,95,561,na
76,PureAlohaa,CHALLENGER I,634,16.7,383,64,319,na
77,ogapmaler cuck,CHALLENGER I,633,24.2,149,36,113,na
78,Jangsterang,CHALLENGER I,632,15.4,397,61,336,na
79,Xeno,CHALLENGER I,629,20.0,300,60,240,na
80,morellos,CHALLENGER I,629,18.1,265,48,217,na
81,NO MORE WINTRADE,CHALLENGER I,628,16.6,290,48,242,na
82,PockyGom,CHALLENGER I,619,15.6,733,114,619,na
83,Cris,CHALLENGER I,609,14.2,1502,213,1289,na
84,FinaldF,CHALLENGER I,609,13.0,1393,181,1212,na
85,BeIiever,CHALLENGER I,609,21.0,628,132,496,na
86,Mango TheHun,CHALLENGER I,608,17.2,250,43,207,na
87,birdwings,CHALLENGER I,607,13.4,351,47,304,na
88,ME EIGHTH,CHALLENGER I,605,16.5,242,40,202,na
89,firest0ne,CHALLENGER I,604,7.5,1637,123,1514,na
90,enaek,CHALLENGER I,602,20.6,402,83,319,na
91,Ashe The Frost,CHALLENGER I,602,11.3,689,78,611,na
92,Aesah,CHALLENGER I,601,19.2,630,121,509,na
93,OrAnGe JuIc3,CHALLENGER I,600,13.4,403,54,349,na
94,DoraAmon,CHALLENGER I,600,27.4,124,34,90,na
95,DeadlyCO2,CHALLENGER I,598,11.9,537,64,473,na
96,paulhnlee,CHALLENGER I,597,22.1,213,47,166,na
97,Coleman TFT,CHALLENGER I,596,19.1,220,42,178,na
98,TTV Kenya1,CHALLENGER I,595,15.3,705,108,597,na
99,FroSteeMate,CHALLENGER I,594,15.1,1188,179,1009,na
100,qie77777mimi,CHALLENGER I,594,17.9,285,51,234,na
101,iCopyKeane,CHALLENGER I,593,12.1,346,42,304,na
102,P1KACHuuuuuuu,CHALLENGER I,593,31.1,103,32,71,na
103,Turn1Delver,CHALLENGER I,589,14.4,1623,234,1389,na
104,Humilis,CHALLENGER I,585,13.1,291,38,253,na
105,Twitch RayditzFN,CHALLENGER I,583,15.8,1236,195,1041,na
106,Me Predator,CHALLENGER I,583,18.1,320,58,262,na
107,Simple Plan,CHALLENGER I,580,14.1,629,89,540,na
108,Eunwilf,CHALLENGER I,579,18.0,316,57,259,na
109,TTV OmniPieTV,CHALLENGER I,571,16.2,974,158,816,na
110,Nhân tâm TFT,CHALLENGER I,565,18.4,282,52,230,na
111,Kalsuo,CHALLENGER I,563,16.7,888,148,740,na
112,Kira,CHALLENGER I,559,16.6,579,96,483,na
113,Sin 94 ToFu,CHALLENGER I,559,15.1,371,56,315,na
114,TFTbigJB,CHALLENGER I,558,17.0,458,78,380,na
115,Oonnii,CHALLENGER I,558,21.0,353,74,279,na
116,Doublezzzz,CHALLENGER I,555,13.4,691,93,598,na
117,TTV iantyler,CHALLENGER I,555,17.2,349,60,289,na
118,Mean Mister Kien,CHALLENGER I,554,14.4,735,106,629,na
119,RIOT thatsPRIMAL,CHALLENGER I,552,11.2,953,107,846,na
120,Moggy Mako,CHALLENGER I,552,9.0,665,60,605,na
121,DxnTFT,CHALLENGER I,549,15.9,812,129,683,na
122,LGD Wet1less,CHALLENGER I,548,14.8,304,45,259,na
123,Sojin,CHALLENGER I,544,15.5,844,131,713,na
124,Reigncat,CHALLENGER I,543,15.2,303,46,257,na
125,17º C,CHALLENGER I,542,18.4,452,83,369,na
126,Terde,CHALLENGER I,541,17.7,622,110,512,na
127,TheHentaiGod,CHALLENGER I,539,15.8,738,117,621,na
128,Blaim,CHALLENGER I,539,16.2,711,115,596,na
129,enchaB,CHALLENGER I,538,18.2,280,51,229,na
130,RippleOverdrive2,CHALLENGER I,538,21.6,176,38,138,na
131,xplitcit,CHALLENGER I,537,14.7,940,138,802,na
132,Tinkady,CHALLENGER I,537,18.3,591,108,483,na
133,lnaban,CHALLENGER I,537,15.6,675,105,570,na
134,robinsongz,CHALLENGER I,537,15.4,409,63,346,na
135,Scoped32,CHALLENGER I,534,16.1,410,66,344,na
136,birdy511,CHALLENGER I,534,15.4,369,57,312,na
137,NicholasLy6,CHALLENGER I,529,19.8,293,58,235,na
138,VX15152242663,CHALLENGER I,527,19.0,580,110,470,na
139,JinxedJKK,CHALLENGER I,527,16.2,340,55,285,na
140,BlackBigBig,CHALLENGER I,525,18.0,510,92,418,na
141,Kłaytøn,CHALLENGER I,525,15.1,509,77,432,na
142,A shadowy figure,CHALLENGER I,524,15.7,581,91,490,na
143,ttv influrrier,CHALLENGER I,522,14.2,614,87,527,na
144,Dairon TFT,CHALLENGER I,522,16.8,298,50,248,na
145,Eunsol    K,CHALLENGER I,518,14.4,381,55,326,na
146,Jaekun2maX,CHALLENGER I,517,17.8,264,47,217,na
147,douyuTV980762,CHALLENGER I,516,15.2,512,78,434,na
148,Catybear,CHALLENGER I,516,15.1,490,74,416,na
149,BentoBot,CHALLENGER I,515,15.5,689,107,582,na
150,kavan,CHALLENGER I,514,16.1,372,60,312,na
151,eyafeyafeyaf,CHALLENGER I,507,14.2,612,87,525,na
152,Midrash,CHALLENGER I,507,16.0,394,63,331,na
153,NED carry,CHALLENGER I,506,17.5,320,56,264,na
154,piglet2448,CHALLENGER I,505,22.6,181,41,140,na
155,KomradeKush,CHALLENGER I,504,12.0,816,98,718,na
156,lilsteppy,CHALLENGER I,504,20.5,380,78,302,na
157,Jaekun3maX,CHALLENGER I,502,28.6,112,32,80,na
158,Visual,CHALLENGER I,499,16.6,489,81,408,na
159,Lab Member 001,CHALLENGER I,498,15.9,346,55,291,na
160,You MDZZ,CHALLENGER I,498,16.4,310,51,259,na
161,chainpullz,CHALLENGER I,498,13.7,314,43,271,na
162,Humilis TFT,CHALLENGER I,498,19.4,196,38,158,na
163,Elvisbeback,CHALLENGER I,498,10.7,317,34,283,na
164,21 Zsy,CHALLENGER I,497,21.4,495,106,389,na
165,George Brown TFT,CHALLENGER I,496,14.4,492,71,421,na
166,Sun Astronaut,CHALLENGER I,495,13.9,323,45,278,na
167,tomrocks,CHALLENGER I,493,16.7,359,60,299,na
168,Lemon IceCream,CHALLENGER I,492,12.7,754,96,658,na
169,Fountaiin,CHALLENGER I,491,15.3,254,39,215,na
170,Liquid Saint,CHALLENGER I,490,19.2,359,69,290,na
171,TacticalLukarina,CHALLENGER I,488,15.0,840,126,714,na
172,HappyMuffinn,CHALLENGER I,487,18.5,259,48,211,na
173,Wolves Save Me,CHALLENGER I,486,13.0,1029,134,895,na
174,MikeP,CHALLENGER I,484,17.2,151,26,125,na
175,Yondai,CHALLENGER I,483,16.4,481,79,402,na
176,sugasugasofly,CHALLENGER I,483,18.1,387,70,317,na
177,Gurt Games,CHALLENGER I,483,9.1,517,47,470,na
178,AndyofSmurf,CHALLENGER I,483,19.4,180,35,145,na
179,kpopfan7,CHALLENGER I,482,14.1,163,23,140,na
180,BadlandzTV,CHALLENGER I,479,19.5,133,26,107,na
181,the OCE special,CHALLENGER I,478,11.4,844,96,748,na
182,Jaekun4maX,CHALLENGER I,476,22.2,180,40,140,na
183,Muffinn TFT,CHALLENGER I,476,18.3,219,40,179,na
184,chitosechitose,CHALLENGER I,475,14.2,649,92,557,na
185,Mister Lau,CHALLENGER I,474,16.2,808,131,677,na
186,chickensaveme,CHALLENGER I,474,14.9,275,41,234,na
187,DreamErica,CHALLENGER I,473,14.6,1000,146,854,na
188,WafWafWaffle,CHALLENGER I,472,15.6,392,61,331,na
189,zTaidana,CHALLENGER I,472,16.4,354,58,296,na
190,FayeBae,CHALLENGER I,469,14.1,440,62,378,na
191,yyasuooo,CHALLENGER I,469,22.2,144,32,112,na
192,AndyofLove,CHALLENGER I,467,17.2,303,52,251,na
193,blackwhited,CHALLENGER I,465,14.3,441,63,378,na
194,El Conejo Malo,CHALLENGER I,465,20.3,286,58,228,na
195,esportslaw jr,CHALLENGER I,464,23.5,196,46,150,na
196,ootay,CHALLENGER I,461,22.1,316,70,246,na
197,ttvGooGieGaminG,CHALLENGER I,440,13.6,391,53,338,na
198,Cindys Dave,CHALLENGER I,435,15.4,630,97,533,na
199,Garchompro,CHALLENGER I,427,11.7,472,55,417,na
200,Keane fans,CHALLENGER I,392,17.0,1250,213,1037,na
201,Agaze,"GRANDMASTER I
G",598,17.3,231,40,191,na
202,Bulls0717,"GRANDMASTER I
G",524,11.9,502,60,442,na
203,tran98huy,"GRANDMASTER I
G",510,18.6,446,83,363,na
204,RamKev,"GRANDMASTER I
G",508,14.8,832,123,709,na
205,thomas tft,"GRANDMASTER I
G",490,13.1,572,75,497,na
206,eue,"GRANDMASTER I
G",488,11.0,864,95,769,na
207,felice,"GRANDMASTER I
G",485,15.2,184,28,156,na
208,Kintsugí,"GRANDMASTER I
G",458,12.8,852,109,743,na
209,JiaJiaJiaJiaJia,"GRANDMASTER I
G",457,18.8,489,92,397,na
210,NALelouuch,"GRANDMASTER I
G",455,12.8,879,113,766,na
211,x BadlandzTV x,"GRANDMASTER I
G",455,17.9,207,37,170,na
212,TTVHentaiGodTFT,"GRANDMASTER I
G",452,21.7,166,36,130,na
213,buscusu,"GRANDMASTER I
G",450,18.5,804,149,655,na
214,TTV NatrixGGs,"GRANDMASTER I
G",449,12.8,1182,152,1030,na
215,WúJi,"GRANDMASTER I
G",448,17.3,260,45,215,na
216,Lodo,"GRANDMASTER I
G",448,24.2,157,38,119,na
217,2418,"GRANDMASTER I
G",447,14.2,351,50,301,na
218,C9 Khroen,"GRANDMASTER I
G",444,19.2,381,73,308,na
219,tinkady69,"GRANDMASTER I
G",444,16.4,244,40,204,na
220,AlanLube,"GRANDMASTER I
G",437,15.8,183,29,154,na
221,Deleuzer,"GRANDMASTER I
G",432,13.6,514,70,444,na
222,piggy2448,"GRANDMASTER I
G",430,18.5,372,69,303,na
223,Tapaz,"GRANDMASTER I
G",428,25.8,186,48,138,na
224,DouYu 980762,"GRANDMASTER I
G",428,21.6,222,48,174,na
225,Decisivewayy,"GRANDMASTER I
G",425,13.4,732,98,634,na
226,Keane tf,"GRANDMASTER I
G",425,18.8,356,67,289,na
227,ARee,"GRANDMASTER I
G",421,14.0,585,82,503,na
228,TheWaterBearr,"GRANDMASTER I
G",415,13.8,669,92,577,na
229,Jaekun1maX,"GRANDMASTER I
G",415,18.6,253,47,206,na
230,TwTv Funkyyfrog,"GRANDMASTER I
G",415,13.5,349,47,302,na
231,vaIsartan,"GRANDMASTER I
G",414,16.2,470,76,394,na
232,micheIIe obama,"GRANDMASTER I
G",414,12.9,342,44,298,na
233,jwolly,"GRANDMASTER I
G",412,15.1,357,54,303,na
234,tapiokaoisii,"GRANDMASTER I
G",405,11.0,528,58,470,na
235,Dealer Buling,"GRANDMASTER I
G",401,14.5,544,79,465,na
236,TFT TheTian,"GRANDMASTER I
G",401,17.4,259,45,214,na
237,TurboARAM,"GRANDMASTER I
G",395,14.7,531,78,453,na
238,Partnerkiller 02,"GRANDMASTER I
G",390,16.2,439,71,368,na
239,Msquared,"GRANDMASTER I
G",390,14.4,326,47,279,na
240,Fyslexic Duck,"GRANDMASTER I
G",390,15.4,253,39,214,na
241,LEGOGOGO,"GRANDMASTER I
G",390,17.4,184,32,152,na
242,BetOnMe,"GRANDMASTER I
G",388,14.9,409,61,348,na
243,WuHB,"GRANDMASTER I
G",385,17.2,933,161,772,na
244,zugrug,"GRANDMASTER I
G",383,13.5,787,106,681,na
245,WorldFamousFries,"GRANDMASTER I
G",383,18.4,423,78,345,na
246,Pawnup,"GRANDMASTER I
G",381,14.2,346,49,297,na
247,ItzBeastyTFT69,"GRANDMASTER I
G",381,21.3,164,35,129,na
248,Scoped23,"GRANDMASTER I
G",379,20.4,211,43,168,na
249,TheMambaMachine,"GRANDMASTER I
G",375,18.3,579,106,473,na
250,peeba,"GRANDMASTER I
G",371,17.1,1852,317,1535,na
251,DannySaysNo,"GRANDMASTER I
G",371,14.9,585,87,498,na
252,IllllllIIIIlllll,"GRANDMASTER I
G",371,18.4,305,56,249,na
253,Incite,"GRANDMASTER I
G",366,15.6,752,117,635,na
254,Incompl,"GRANDMASTER I
G",365,11.2,453,51,402,na
255,DeIiciousMilfGG,"GRANDMASTER I
G",364,17.7,310,55,255,na
256,ShakeShakeFries,"GRANDMASTER I
G",362,18.6,242,45,197,na
257,emilyywang,"GRANDMASTER I
G",360,13.2,1112,147,965,na
258,WafWafWaf,"GRANDMASTER I
G",354,16.7,347,58,289,na
259,jªrred,"GRANDMASTER I
G",352,14.0,662,93,569,na
260,Flashbâng,"GRANDMASTER I
G",352,8.9,876,78,798,na
261,Tonyoff,"GRANDMASTER I
G",351,17.8,281,50,231,na
262,MegaInfernoBomb,"GRANDMASTER I
G",349,15.6,257,40,217,na
263,mcsorley33,"GRANDMASTER I
G",348,18.6,183,34,149,na
264,Oonii,"GRANDMASTER I
G",347,16.3,485,79,406,na
265,FFception,"GRANDMASTER I
G",347,16.8,273,46,227,na
266,Doril,"GRANDMASTER I
G",346,12.9,1330,172,1158,na
267,Balrox,"GRANDMASTER I
G",346,14.5,186,27,159,na
268,Ayetrix,"GRANDMASTER I
G",344,12.2,745,91,654,na
269,hâppy game,"GRANDMASTER I
G",344,17.0,305,52,253,na
270,YxmNA,"GRANDMASTER I
G",343,15.8,202,32,170,na
271,Purify,"GRANDMASTER I
G",342,13.5,1035,140,895,na
272,DiDiDik,"GRANDMASTER I
G",340,17.9,341,61,280,na
273,LilRoyW,"GRANDMASTER I
G",338,11.1,963,107,856,na
274,L1ssandra,"GRANDMASTER I
G",337,14.5,427,62,365,na
275,best Taro NA,"GRANDMASTER I
G",333,14.9,395,59,336,na
276,anewwplayer,"GRANDMASTER I
G",332,18.0,278,50,228,na
277,a wittle penguin,"GRANDMASTER I
G",331,16.1,267,43,224,na
278,skunkywinn,"GRANDMASTER I
G",328,16.0,520,83,437,na
279,Stonerule,"GRANDMASTER I
G",328,17.7,424,75,349,na
280,NALiocardia,"GRANDMASTER I
G",328,28.3,120,34,86,na
281,TFT Cayrub,"GRANDMASTER I
G",326,14.6,1069,156,913,na
282,02l022,"GRANDMASTER I
G",325,16.0,388,62,326,na
283,dpei,"GRANDMASTER I
G",322,17.1,427,73,354,na
284,Keíko Kubota,"GRANDMASTER I
G",317,20.0,125,25,100,na
285,I Died To A Bard,"GRANDMASTER I
G",311,16.1,542,87,455,na
286,gead813,"GRANDMASTER I
G",311,17.9,440,79,361,na
287,Ricechong,"GRANDMASTER I
G",309,14.1,326,46,280,na
288,MrEllusive,"GRANDMASTER I
G",309,19.6,204,40,164,na
289,4arp,"GRANDMASTER I
G",308,10.0,687,69,618,na
290,KurumsSoreNut,"GRANDMASTER I
G",308,24.4,131,32,99,na
291,1375,"GRANDMASTER I
G",308,22.6,106,24,82,na
292,TTV iGJaeger,"GRANDMASTER I
G",306,19.5,200,39,161,na
293,fast eighth,"GRANDMASTER I
G",304,13.7,219,30,189,na
294,Bonzolo,"GRANDMASTER I
G",303,14.7,817,120,697,na
295,TwTV neekynooky,"GRANDMASTER I
G",302,14.8,1378,204,1174,na
296,Volc4884,"GRANDMASTER I
G",301,18.3,306,56,250,na
297,Qwat02,"GRANDMASTER I
G",300,16.2,1485,241,1244,na
298,JustinPerson,"GRANDMASTER I
G",300,12.5,513,64,449,na
299,wxqq757081727,"GRANDMASTER I
G",299,25.3,154,39,115,na
300,Old dirver Yin,"GRANDMASTER I
G",296,17.0,689,117,572,na
301,zebroe,"GRANDMASTER I
G",294,13.6,711,97,614,na
302,Leii,"GRANDMASTER I
G",294,12.8,610,78,532,na
303,Slooper TFT,"GRANDMASTER I
G",291,27.0,122,33,89,na
304,michhh12,"GRANDMASTER I
G",290,11.8,434,51,383,na
305,Cheney,"GRANDMASTER I
G",290,15.4,266,41,225,na
306,DeliciousMilkGG,"GRANDMASTER I
G",284,25.6,489,125,364,na
307,trade off,"GRANDMASTER I
G",279,15.9,523,83,440,na
308,DocPwn,"GRANDMASTER I
G",279,16.4,409,67,342,na
309,alohu,"GRANDMASTER I
G",279,11.6,447,52,395,na
310,MO LI LV CHA,"GRANDMASTER I
G",275,13.3,503,67,436,na
311,OFF WHITE XLV,"GRANDMASTER I
G",272,10.8,1533,165,1368,na
312,VenusZ,"GRANDMASTER I
G",270,17.5,788,138,650,na
313,markersx TFT,"GRANDMASTER I
G",270,14.8,623,92,531,na
314,Ym444,"GRANDMASTER I
G",270,18.5,232,43,189,na
315,Darthnater,"GRANDMASTER I
G",270,11.6,258,30,228,na
316,matchedsock,"GRANDMASTER I
G",268,18.3,104,19,85,na
317,a speedy boi,"GRANDMASTER I
G",266,17.0,159,27,132,na
318,Dios12138,"GRANDMASTER I
G",265,12.6,348,44,304,na
319,DivìNe,"GRANDMASTER I
G",264,15.8,393,62,331,na
320,ShaftMcBuldge,"GRANDMASTER I
G",264,19.1,283,54,229,na
321,zzzzzzZ7,"GRANDMASTER I
G",263,18.8,240,45,195,na
322,Depew,"GRANDMASTER I
G",262,14.1,354,50,304,na
323,Azcryte,"GRANDMASTER I
G",262,16.5,255,42,213,na
324,Ian952,"GRANDMASTER I
G",261,18.0,478,86,392,na
325,GUAO,"GRANDMASTER I
G",261,14.2,351,50,301,na
326,BlakeAustin,"GRANDMASTER I
G",260,15.0,480,72,408,na
327,Olive JP,"GRANDMASTER I
G",260,14.4,375,54,321,na
328,GIXinGGG,"GRANDMASTER I
G",260,13.8,312,43,269,na
329,TFT Moody,"GRANDMASTER I
G",259,18.1,232,42,190,na
330,JukeYou,"GRANDMASTER I
G",254,17.8,337,60,277,na
331,leepaul,"GRANDMASTER I
G",254,24.2,153,37,116,na
332,running 300golds,"GRANDMASTER I
G",250,18.1,738,134,604,na
333,d u j b,"GRANDMASTER I
G",250,14.3,546,78,468,na
334,Riot C,"GRANDMASTER I
G",250,17.5,292,51,241,na
335,Nhân Tâm,"GRANDMASTER I
G",248,16.5,375,62,313,na
336,ttvidontdocardio,"GRANDMASTER I
G",248,13.5,229,31,198,na
337,Anbicion,"GRANDMASTER I
G",247,12.3,267,33,234,na
338,Binhja,"GRANDMASTER I
G",246,16.2,308,50,258,na
339,thresh hook me,"GRANDMASTER I
G",246,9.5,262,25,237,na
340,Fearcely,"GRANDMASTER I
G",245,18.0,267,48,219,na
341,mawco,"GRANDMASTER I
G",244,15.2,197,30,167,na
342,Lex94wo,"GRANDMASTER I
G",243,16.2,580,94,486,na
343,Cici XD,"GRANDMASTER I
G",242,14.2,572,81,491,na
344,dontbullme,"GRANDMASTER I
G",242,16.1,322,52,270,na
345,Ballhurts,"GRANDMASTER I
G",239,14.6,622,91,531,na
346,garet,"GRANDMASTER I
G",239,13.6,528,72,456,na
347,Goko Ruri,"GRANDMASTER I
G",235,15.5,322,50,272,na
348,nickrystaL,"GRANDMASTER I
G",234,16.3,166,27,139,na
349,TTV TangibleTFT,"GRANDMASTER I
G",233,10.4,574,60,514,na
350,Âzarin,"GRANDMASTER I
G",233,15.3,274,42,232,na
351,CounTerWu,"GRANDMASTER I
G",230,13.4,626,84,542,na
352,Cuan TianhouRRRR,"GRANDMASTER I
G",229,16.4,402,66,336,na
353,HKBag,"GRANDMASTER I
G",229,22.1,149,33,116,na
354,Timmy the Hog,"GRANDMASTER I
G",228,14.0,556,78,478,na
355,Holyfk,"GRANDMASTER I
G",228,20.0,310,62,248,na
356,BKrisz TFT,"GRANDMASTER I
G",227,12.8,560,72,488,na
357,AsianGamer5,"GRANDMASTER I
G",225,17.7,1003,178,825,na
358,OmniPie,"GRANDMASTER I
G",225,13.2,821,108,713,na
359,Genosins,"GRANDMASTER I
G",225,13.8,290,40,250,na
360,PrímeTime,"GRANDMASTER I
G",224,13.3,784,104,680,na
361,C0C0NUT,"GRANDMASTER I
G",224,10.2,361,37,324,na
362,Takes,"GRANDMASTER I
G",224,13.8,189,26,163,na
363,buu buu desu,"GRANDMASTER I
G",223,13.1,792,104,688,na
364,FZY  love,"GRANDMASTER I
G",222,14.6,383,56,327,na
365,Blueeeeeeeeeee2,"GRANDMASTER I
G",222,15.2,328,50,278,na
366,vAhern,"GRANDMASTER I
G",222,22.1,213,47,166,na
367,Zhaosongyanisson,"GRANDMASTER I
G",222,13.7,307,42,265,na
368,2YoHae7,"GRANDMASTER I
G",222,12.7,204,26,178,na
369,WeiXin Jerry79x,"GRANDMASTER I
G",219,21.3,183,39,144,na
370,Bananaramic,"GRANDMASTER I
G",218,10.8,442,48,394,na
371,ChiTown Riven,"GRANDMASTER I
G",218,18.0,161,29,132,na
372,AceKandil,"GRANDMASTER I
G",217,11.5,584,67,517,na
373,lovecyt,"GRANDMASTER I
G",216,14.2,381,54,327,na
374,nMercy Redcode,"GRANDMASTER I
G",216,15.8,317,50,267,na
375,ShineBright,"GRANDMASTER I
G",215,15.8,556,88,468,na
376,Quweuwe,"GRANDMASTER I
G",215,17.7,344,61,283,na
377,QAQ TAT TvT,"GRANDMASTER I
G",214,17.7,231,41,190,na
378,swishersweets1,"GRANDMASTER I
G",212,10.5,773,81,692,na
379,Waifu,"GRANDMASTER I
G",211,28.1,146,41,105,na
380,Nefz7,"GRANDMASTER I
G",211,19.9,161,32,129,na
381,adreh NA,"GRANDMASTER I
G",210,16.5,255,42,213,na
382,The Capsules,"GRANDMASTER I
G",209,16.1,502,81,421,na
383,numanotaihasin,"GRANDMASTER I
G",209,13.5,148,20,128,na
384,Georgetown Siyu,"GRANDMASTER I
G",206,21.7,318,69,249,na
385,Kurumix fangirl,"GRANDMASTER I
G",206,18.9,153,29,124,na
386,Vibrant,"GRANDMASTER I
G",205,15.1,575,87,488,na
387,thi3n,"GRANDMASTER I
G",204,15.0,1480,222,1258,na
388,brknwngs,"GRANDMASTER I
G",204,14.0,1207,169,1038,na
389,Yiggles,"GRANDMASTER I
G",202,15.3,806,123,683,na
390,xin luan le,"GRANDMASTER I
G",202,15.2,395,60,335,na
391,The Man From Far,"GRANDMASTER I
G",201,19.3,197,38,159,na
392,beach body,"GRANDMASTER I
G",200,14.6,309,45,264,na
393,WowSilenceWow,"GRANDMASTER I
G",198,18.1,288,52,236,na
394,Crapchi,"GRANDMASTER I
G",198,19.1,178,34,144,na
395,guru9,"GRANDMASTER I
G",197,17.4,852,148,704,na
396,shireen4,"GRANDMASTER I
G",194,16.2,400,65,335,na
397,paxytft,"GRANDMASTER I
G",193,12.7,1021,130,891,na
398,Nanase wa Kibou,"GRANDMASTER I
G",192,19.2,370,71,299,na
399,nujac,"GRANDMASTER I
G",190,16.8,202,34,168,na
400,George Brown,"GRANDMASTER I
G",189,11.8,644,76,568,na
401,Atherton Wing,"GRANDMASTER I
G",188,15.8,411,65,346,na
402,ObermasteRx,"GRANDMASTER I
G",188,21.8,261,57,204,na
403,DeejGG,"GRANDMASTER I
G",188,12.0,357,43,314,na
404,scrapy90,"GRANDMASTER I
G",187,11.7,857,100,757,na
405,twentyyi,"GRANDMASTER I
G",187,16.8,393,66,327,na
406,VX13120537372,"GRANDMASTER I
G",187,14.2,352,50,302,na
407,zennonlwr,"GRANDMASTER I
G",187,14.0,299,42,257,na
408,Nyghty,"GRANDMASTER I
G",187,12.0,342,41,301,na
409,kentwuhoo,"GRANDMASTER I
G",187,15.3,248,38,210,na
410,captain kookie,"GRANDMASTER I
G",185,11.0,663,73,590,na
411,philôlin,"GRANDMASTER I
G",185,13.5,392,53,339,na
412,lonelyfox803,"GRANDMASTER I
G",185,23.0,217,50,167,na
413,CrazyKoala,"GRANDMASTER I
G",185,16.5,242,40,202,na
414,Michael0107,"GRANDMASTER I
G",182,19.3,327,63,264,na
415,MID NightShadw,"GRANDMASTER I
G",180,15.1,344,52,292,na
416,Ducksquad,"GRANDMASTER I
G",180,15.6,243,38,205,na
417,elusionist,"GRANDMASTER I
G",180,18.6,194,36,158,na
418,Conjugal Panda,"GRANDMASTER I
G",180,15.4,233,36,197,na
419,php and java,"GRANDMASTER I
G",179,19.7,309,61,248,na
420,DokoMoko,"GRANDMASTER I
G",179,10.5,171,18,153,na
421,Pulsefire Jmj,"GRANDMASTER I
G",178,11.8,1224,144,1080,na
422,waiting77777,"GRANDMASTER I
G",178,13.1,466,61,405,na
423,vaziri,"GRANDMASTER I
G",177,13.3,806,107,699,na
424,Nerdong Bukid,"GRANDMASTER I
G",177,15.6,243,38,205,na
425,senorhyder,"GRANDMASTER I
G",176,14.2,751,107,644,na
426,eusouumlucas,"GRANDMASTER I
G",176,13.5,193,26,167,na
427,trísh,"GRANDMASTER I
G",175,12.9,774,100,674,na
428,Smart Muggle,"GRANDMASTER I
G",174,17.5,776,136,640,na
429,Wait for N1ght,"GRANDMASTER I
G",174,20.9,253,53,200,na
430,NutscrackerosTw,"GRANDMASTER I
G",174,10.5,237,25,212,na
431,Mortemo,"GRANDMASTER I
G",173,9.2,1017,94,923,na
432,IG TheWen,"GRANDMASTER I
G",172,22.9,109,25,84,na
433,King Kenneth,"GRANDMASTER I
G",171,13.0,516,67,449,na
434,Subism,"GRANDMASTER I
G",171,12.9,517,67,450,na
435,gunning4you,"GRANDMASTER I
G",170,16.5,437,72,365,na
436,Toast9197,"GRANDMASTER I
G",170,14.3,447,64,383,na
437,xStrangelove,"GRANDMASTER I
G",170,18.2,176,32,144,na
438,showmesomeflash,"GRANDMASTER I
G",170,17.1,170,29,141,na
439,Kyouko Hori,"GRANDMASTER I
G",169,14.7,572,84,488,na
440,freedom sky,"GRANDMASTER I
G",168,16.9,248,42,206,na
441,GGunit,"GRANDMASTER I
G",166,13.4,849,114,735,na
442,nWo Pistola,"GRANDMASTER I
G",166,17.1,245,42,203,na
443,hide on tulsa,"GRANDMASTER I
G",166,22.8,162,37,125,na
444,derajwal,"GRANDMASTER I
G",166,11.7,316,37,279,na
445,Lêe Sin,"GRANDMASTER I
G",165,17.8,338,60,278,na
446,HostyIam,"GRANDMASTER I
G",165,17.4,270,47,223,na
447,7cjk,"GRANDMASTER I
G",165,12.4,209,26,183,na
448,Chikapu,"GRANDMASTER I
G",164,22.9,214,49,165,na
449,Que paso,"GRANDMASTER I
G",164,13.5,363,49,314,na
450,Haí Keyi,"GRANDMASTER I
G",163,15.6,589,92,497,na
451,AhchimCalm,"GRANDMASTER I
G",162,14.8,297,44,253,na
452,Vitamnss,"GRANDMASTER I
G",162,13.8,296,41,255,na
453,Jonghyuk Park,"GRANDMASTER I
G",162,35.0,80,28,52,na
454,Darvinism,"GRANDMASTER I
G",161,13.6,501,68,433,na
455,BBLance,"GRANDMASTER I
G",160,19.0,331,63,268,na
456,PekiM,"GRANDMASTER I
G",159,20.1,134,27,107,na
457,Strangelove TFT,"GRANDMASTER I
G",159,16.2,160,26,134,na
458,trainingacount2,"GRANDMASTER I
G",158,16.3,301,49,252,na
459,Pandana,"GRANDMASTER I
G",156,15.4,351,54,297,na
460,Geadtft,"GRANDMASTER I
G",156,20.2,257,52,205,na
461,The First Robot,"GRANDMASTER I
G",156,23.3,219,51,168,na
462,Markersxx,"GRANDMASTER I
G",155,20.8,120,25,95,na
463,Twitch Sendohrai,"GRANDMASTER I
G",155,17.0,147,25,122,na
464,DEFLECTABLE NA,"GRANDMASTER I
G",154,16.1,155,25,130,na
465,anmin9nb,"GRANDMASTER I
G",153,14.4,465,67,398,na
466,Knight9z2,"GRANDMASTER I
G",153,15.8,419,66,353,na
467,TheArmoredTitant,"GRANDMASTER I
G",152,13.3,683,91,592,na
468,RushWizard,"GRANDMASTER I
G",152,14.5,414,60,354,na
469,SKT T1 Taco Bell,"GRANDMASTER I
G",152,35.4,99,35,64,na
470,ToooCubed,"GRANDMASTER I
G",151,16.5,357,59,298,na
471,mdngplz,"GRANDMASTER I
G",149,9.3,948,88,860,na
472,Chuuper,"GRANDMASTER I
G",149,14.4,492,71,421,na
473,Yoshiwee,"GRANDMASTER I
G",149,19.6,357,70,287,na
474,JellyReturns,"GRANDMASTER I
G",149,16.0,407,65,342,na
475,M2keP,"GRANDMASTER I
G",149,14.7,177,26,151,na
476,jaby4,"GRANDMASTER I
G",148,15.4,664,102,562,na
477,aaronmb2,"GRANDMASTER I
G",148,18.3,415,76,339,na
478,I 1oveMyJG,"GRANDMASTER I
G",148,14.7,334,49,285,na
479,NA Opal,"GRANDMASTER I
G",148,13.1,351,46,305,na
480,BlazeFT,"GRANDMASTER I
G",147,17.4,299,52,247,na
481,Blueeeeeeeeeee,"GRANDMASTER I
G",146,14.1,918,129,789,na
482,T TV bigdirty00,"GRANDMASTER I
G",146,13.7,702,96,606,na
483,DLvx15299128725,"GRANDMASTER I
G",146,19.4,444,86,358,na
484,Athanases,"GRANDMASTER I
G",145,13.8,567,78,489,na
485,TingaTaco,"GRANDMASTER I
G",145,17.6,370,65,305,na
486,Phantom TFT,"GRANDMASTER I
G",143,12.5,777,97,680,na
487,JinxedJK,"GRANDMASTER I
G",143,16.2,463,75,388,na
488,Puppy Astronaut,"GRANDMASTER I
G",143,10.3,406,42,364,na
489,wjlee911,"GRANDMASTER I
G",143,24.1,116,28,88,na
490,DJ NOclue,"GRANDMASTER I
G",142,16.6,507,84,423,na
491,Amasuro,"GRANDMASTER I
G",142,15.6,160,25,135,na
492,atownrocky,"GRANDMASTER I
G",141,16.6,295,49,246,na
493,douyu296806,"GRANDMASTER I
G",141,20.7,203,42,161,na
494,oSkyoo,"GRANDMASTER I
G",140,14.0,1007,141,866,na
495,justsa1yan,"GRANDMASTER I
G",140,13.3,490,65,425,na
496,Botsvar,"GRANDMASTER I
G",140,31.6,76,24,52,na
497,ÐrownedGod,"GRANDMASTER I
G",139,12.4,483,60,423,na
498,Jeï,"GRANDMASTER I
G",139,15.2,367,56,311,na
499,xiaqigaoshou,"GRANDMASTER I
G",139,20.8,178,37,141,na
500,Sıx,"GRANDMASTER I
G",139,16.4,189,31,158,na
1,bruninho sl,CHALLENGER I,1822,21.3,591,126,465,br
2,cuckmyblade,CHALLENGER I,1609,24.4,492,120,372,br
3,Zadust,CHALLENGER I,1606,33.3,339,113,226,br
4,inc mplete,CHALLENGER I,1401,17.3,761,132,629,br
5,techzz,CHALLENGER I,1340,23.7,586,139,447,br
6,eusouolucas,CHALLENGER I,1326,18.0,701,126,575,br
7,Odyceuz,CHALLENGER I,1323,23.8,499,119,380,br
8,FabledDofus,CHALLENGER I,1288,19.8,480,95,385,br
9,Slooper,CHALLENGER I,1242,24.6,366,90,276,br
10,Serask,CHALLENGER I,1195,21.8,541,118,423,br
11,Higuree,CHALLENGER I,1119,21.2,548,116,432,br
12,Paralelepipo,CHALLENGER I,1093,26.0,254,66,188,br
13,BarksdaIe,CHALLENGER I,1068,28.9,239,69,170,br
14,Medico do SUS22,CHALLENGER I,1053,18.5,584,108,476,br
15,ftdrain,CHALLENGER I,1053,29.9,278,83,195,br
16,Archway,CHALLENGER I,1047,17.1,439,75,364,br
17,Gúne,CHALLENGER I,996,23.0,383,88,295,br
18,Dairon,CHALLENGER I,981,21.4,322,69,253,br
19,tartaruguinhas2,CHALLENGER I,977,20.8,558,116,442,br
20,Koala Esbelto,CHALLENGER I,973,20.0,721,144,577,br
21,TG Wed,CHALLENGER I,905,16.9,721,122,599,br
22,m3rdapequena,CHALLENGER I,898,26.1,257,67,190,br
23,Past,CHALLENGER I,836,24.9,473,118,355,br
24,Mierdagrande,CHALLENGER I,816,29.6,213,63,150,br
25,escolinha do inc,CHALLENGER I,806,21.4,420,90,330,br
26,Jael TFT,CHALLENGER I,787,20.7,405,84,321,br
27,Twitch NickTFT,CHALLENGER I,777,21.4,537,115,422,br
28,OOO,CHALLENGER I,775,18.4,515,95,420,br
29,CD ERICK,CHALLENGER I,759,18.5,260,48,212,br
30,Lünna,CHALLENGER I,723,20.1,814,164,650,br
31,ViT4O xD,CHALLENGER I,722,18.4,423,78,345,br
32,Miss Queen,CHALLENGER I,716,12.7,386,49,337,br
33,Haxwei,CHALLENGER I,706,19.1,215,41,174,br
34,mDobZ,CHALLENGER I,700,18.6,253,47,206,br
35,Vowtz,CHALLENGER I,690,16.6,362,60,302,br
36,odyceuZEDeletric,CHALLENGER I,686,43.8,89,39,50,br
37,Neves,CHALLENGER I,684,18.1,371,67,304,br
38,TFT Azura,CHALLENGER I,684,23.5,234,55,179,br
39,RFK Azura,CHALLENGER I,676,26.1,468,122,346,br
40,Levi,CHALLENGER I,668,23.2,435,101,334,br
41,Yvissaur,CHALLENGER I,654,22.0,305,67,238,br
42,Royal Kvasterr,CHALLENGER I,652,14.3,440,63,377,br
43,Nescau Insolúvel,CHALLENGER I,647,19.8,339,67,272,br
44,O HIPER CARRY,CHALLENGER I,643,15.8,507,80,427,br
45,DEZZlN,CHALLENGER I,638,16.7,491,82,409,br
46,MATEUS DO SUS DF,CHALLENGER I,617,16.8,481,81,400,br
47,AdrianoK,CHALLENGER I,612,17.9,340,61,279,br
48,the ego illusion,CHALLENGER I,607,27.1,221,60,161,br
49,Billy Bait,CHALLENGER I,566,16.2,708,115,593,br
50,Kirbyzin,CHALLENGER I,552,16.1,645,104,541,br
51,B Lara,"GRANDMASTER I
G",677,22.4,322,72,250,br
52,Lula Livrão TFT,"GRANDMASTER I
G",633,15.8,430,68,362,br
53,T F Toddy,"GRANDMASTER I
G",608,26.4,148,39,109,br
54,Bioosfera,"GRANDMASTER I
G",602,15.6,481,75,406,br
55,faker indiano,"GRANDMASTER I
G",601,14.9,470,70,400,br
56,TwitchTV Patr0ci,"GRANDMASTER I
G",587,15.5,763,118,645,br
57,Tsuuzaki,"GRANDMASTER I
G",567,20.3,468,95,373,br
58,BlasHelldder,"GRANDMASTER I
G",560,20.1,399,80,319,br
59,CD CFCDuuuuds,"GRANDMASTER I
G",557,14.3,713,102,611,br
60,O HIPER CRIME,"GRANDMASTER I
G",531,14.4,409,59,350,br
61,Nihonjin,"GRANDMASTER I
G",517,18.1,380,69,311,br
62,kirinde,"GRANDMASTER I
G",498,14.9,656,98,558,br
63,Irisdescent,"GRANDMASTER I
G",494,20.7,241,50,191,br
64,Felipolv000,"GRANDMASTER I
G",485,20.7,198,41,157,br
65,Jvão,"GRANDMASTER I
G",470,19.2,526,101,425,br
66,HawkEyeCs7,"GRANDMASTER I
G",461,16.9,679,115,564,br
67,R Angra,"GRANDMASTER I
G",460,17.5,280,49,231,br
68,Encatroll é trix,"GRANDMASTER I
G",459,16.7,282,47,235,br
69,ego illusions,"GRANDMASTER I
G",453,20.9,253,53,200,br
70,Bandu,"GRANDMASTER I
G",446,17.9,521,93,428,br
71,Ezo,"GRANDMASTER I
G",438,16.9,516,87,429,br
72,É o tal do Lula,"GRANDMASTER I
G",435,27.0,318,86,232,br
73,Allahu TK,"GRANDMASTER I
G",419,11.6,868,101,767,br
74,Mon Nom,"GRANDMASTER I
G",413,15.4,654,101,553,br
75,SÄNT hyun,"GRANDMASTER I
G",406,13.1,794,104,690,br
76,tft igor18,"GRANDMASTER I
G",398,21.7,175,38,137,br
77,xCyborg,"GRANDMASTER I
G",373,19.5,328,64,264,br
78,Tallis Sauro,"GRANDMASTER I
G",361,18.2,346,63,283,br
79,TFT Médico,"GRANDMASTER I
G",360,20.9,167,35,132,br
80,haveaboavida,"GRANDMASTER I
G",354,25.6,164,42,122,br
81,Shinobu300,"GRANDMASTER I
G",353,19.0,358,68,290,br
82,TWITCHTV Stykr,"GRANDMASTER I
G",352,21.0,338,71,267,br
83,Goiano,"GRANDMASTER I
G",351,15.2,368,56,312,br
84,twitch narkesh1,"GRANDMASTER I
G",350,19.8,328,65,263,br
85,Batata Rufles,"GRANDMASTER I
G",348,18.2,274,50,224,br
86,itzzLara,"GRANDMASTER I
G",343,16.7,221,37,184,br
87,Eu só jogo TFT,"GRANDMASTER I
G",336,17.5,578,101,477,br
88,l Hyper Carry,"GRANDMASTER I
G",333,16.9,1024,173,851,br
89,Melança,"GRANDMASTER I
G",330,16.2,661,107,554,br
90,dG Fuhrmann,"GRANDMASTER I
G",330,25.6,262,67,195,br
91,Siilent,"GRANDMASTER I
G",329,14.4,660,95,565,br
92,Garras of Rivia,"GRANDMASTER I
G",319,21.8,229,50,179,br
93,ttvSidekool,"GRANDMASTER I
G",316,13.7,532,73,459,br
94,Sènna,"GRANDMASTER I
G",311,10.4,413,43,370,br
95,Royalzito,"GRANDMASTER I
G",305,17.6,450,79,371,br
96,MonteiroLombrado,"GRANDMASTER I
G",305,14.4,443,64,379,br
97,MominhoGameplays,"GRANDMASTER I
G",303,17.8,398,71,327,br
98,SannTFT,"GRANDMASTER I
G",297,18.8,373,70,303,br
99,Titos,"GRANDMASTER I
G",294,16.8,392,66,326,br
100,Duest,"GRANDMASTER I
G",294,18.9,206,39,167,br
101,RafaStark,"GRANDMASTER I
G",292,18.1,281,51,230,br
102,LosAngelesLakers,"GRANDMASTER I
G",288,20.5,156,32,124,br
103,Flangonator,"GRANDMASTER I
G",286,16.4,519,85,434,br
104,Doutor Wily,"GRANDMASTER I
G",281,24.4,295,72,223,br
105,maça docinha,"GRANDMASTER I
G",279,16.5,266,44,222,br
106,SKT1 RyuZUU,"GRANDMASTER I
G",278,13.9,237,33,204,br
107,NeeverGiveUp,"GRANDMASTER I
G",276,14.0,477,67,410,br
108,Hisekken,"GRANDMASTER I
G",276,16.4,389,64,325,br
109,jelly roll blues,"GRANDMASTER I
G",275,15.1,469,71,398,br
110,y Satsue,"GRANDMASTER I
G",275,13.7,139,19,120,br
111,CD Noah Hunter,"GRANDMASTER I
G",271,15.4,351,54,297,br
112,Warrior Lulis,"GRANDMASTER I
G",264,20.8,221,46,175,br
113,Smurf divino Jax,"GRANDMASTER I
G",263,20.8,236,49,187,br
114,Ovas de Peixe,"GRANDMASTER I
G",262,14.9,584,87,497,br
115,Daníela,"GRANDMASTER I
G",256,17.4,224,39,185,br
116,Edinaldo Safadão,"GRANDMASTER I
G",252,14.7,292,43,249,br
117,divino Jax JG,"GRANDMASTER I
G",250,11.0,1038,114,924,br
118,vcs sao pateta,"GRANDMASTER I
G",249,12.7,646,82,564,br
119,San Smurf,"GRANDMASTER I
G",247,17.7,283,50,233,br
120,huggz,"GRANDMASTER I
G",243,17.9,896,160,736,br
121,BARbahh,"GRANDMASTER I
G",241,15.1,324,49,275,br
122,Beastar,"GRANDMASTER I
G",240,17.4,305,53,252,br
123,Walladi,"GRANDMASTER I
G",240,16.0,194,31,163,br
124,xXperrsonXx,"GRANDMASTER I
G",239,19.2,276,53,223,br
125,DonCrazy,"GRANDMASTER I
G",238,12.3,813,100,713,br
126,HeathClyff,"GRANDMASTER I
G",237,19.0,247,47,200,br
127,MittCrowen,"GRANDMASTER I
G",237,17.8,230,41,189,br
128,SKEPET,"GRANDMASTER I
G",235,12.0,559,67,492,br
129,GarrastaClean,"GRANDMASTER I
G",233,19.8,248,49,199,br
130,Paciente67,"GRANDMASTER I
G",229,24.4,127,31,96,br
131,Zamora Lindão,"GRANDMASTER I
G",228,11.4,422,48,374,br
132,Greafen,"GRANDMASTER I
G",226,17.7,571,101,470,br
133,Don Batatone,"GRANDMASTER I
G",225,12.2,221,27,194,br
134,Numb3r2,"GRANDMASTER I
G",223,17.8,366,65,301,br
135,Crackudo Pistola,"GRANDMASTER I
G",222,15.6,294,46,248,br
136,ZaionShow,"GRANDMASTER I
G",217,14.5,296,43,253,br
137,JhoyLow,"GRANDMASTER I
G",217,21.2,193,41,152,br
138,twí,"GRANDMASTER I
G",216,15.4,311,48,263,br
139,TAKOKUCHEIROSO,"GRANDMASTER I
G",216,17.0,235,40,195,br
140,Djcaveira TFT,"GRANDMASTER I
G",215,17.4,637,111,526,br
141,Arckie,"GRANDMASTER I
G",214,19.6,362,71,291,br
142,ViroseMata,"GRANDMASTER I
G",213,21.1,265,56,209,br
143,maçãcomcanela,"GRANDMASTER I
G",210,13.2,470,62,408,br
144,StrongAndFlowers,"GRANDMASTER I
G",209,14.4,292,42,250,br
145,CD Bruel,"GRANDMASTER I
G",208,13.8,419,58,361,br
146,anuib,"GRANDMASTER I
G",202,9.1,916,83,833,br
147,Vampyrus,"GRANDMASTER I
G",160,17.3,874,151,723,br
148,JahBullOn,"GRANDMASTER I
G",152,12.3,350,43,307,br
149,Tuiu ZX,"GRANDMASTER I
G",94,11.3,203,23,180,br
150,deiSHA COmigo rs,"GRANDMASTER I
G",91,11.4,751,86,665,br
151,Yuu Better,MASTER I,280,13.1,1396,183,1213,br
152,CD Koiti,MASTER I,263,17.0,264,45,219,br
153,LOVER 97,MASTER I,218,16.7,162,27,135,br
154,gazzsinhoxD,MASTER I,216,16.6,253,42,211,br
155,RyüZU,MASTER I,209,12.1,480,58,422,br
156,killua do rj,MASTER I,203,12.1,687,83,604,br
157,Ahri FIiperama,MASTER I,198,16.1,566,91,475,br
158,l HaX l,MASTER I,198,11.6,541,63,478,br
159,RESIDENT DA ESCS,MASTER I,195,13.9,791,110,681,br
160,haze is vibing,MASTER I,190,17.2,494,85,409,br
161,X Yudi,MASTER I,185,14.5,420,61,359,br
162,Rubimhood 2,MASTER I,179,18.6,161,30,131,br
163,Noé Mechanics,MASTER I,177,12.3,367,45,322,br
164,JUJU DO TFT,MASTER I,170,8.1,1073,87,986,br
165,BieuL,MASTER I,168,18.5,287,53,234,br
166,Adboy,MASTER I,167,19.4,268,52,216,br
167,FrostxD1,MASTER I,164,12.5,1033,129,904,br
168,RoronoaVinny,MASTER I,160,18.8,717,135,582,br
169,Jokerrx,MASTER I,159,15.9,208,33,175,br
170,NgMartins,MASTER I,157,13.3,548,73,475,br
171,Kamimurathan,MASTER I,155,12.3,628,77,551,br
172,Deyrot,MASTER I,150,21.9,196,43,153,br
173,Terror16,MASTER I,147,13.9,724,101,623,br
174,Ruivão,MASTER I,147,21.5,219,47,172,br
175,ivelthin2,MASTER I,138,14.5,221,32,189,br
176,D A M N    777,MASTER I,137,12.0,815,98,717,br
177,FunEngine,MASTER I,137,13.9,301,42,259,br
178,XebeckX3,MASTER I,136,17.2,314,54,260,br
179,Gorila Quevoa,MASTER I,133,15.5,827,128,699,br
180,brnztz,MASTER I,133,15.2,362,55,307,br
181,Guizi16,MASTER I,132,23.2,198,46,152,br
182,King Vinon,MASTER I,132,17.0,153,26,127,br
183,Tarky,MASTER I,131,22.0,558,123,435,br
184,xShanks,MASTER I,129,13.0,253,33,220,br
185,War Lambari,MASTER I,127,16.6,367,61,306,br
186,zMysto,MASTER I,126,12.2,188,23,165,br
187,Mino Th,MASTER I,124,19.5,154,30,124,br
188,Interplanetário,MASTER I,124,13.9,201,28,173,br
189,Feedei no Ferro4,MASTER I,123,13.2,521,69,452,br
190,Batooré,MASTER I,120,22.1,213,47,166,br
191,the little gab,MASTER I,118,18.5,189,35,154,br
192,Bruno Raposo,MASTER I,118,11.8,194,23,171,br
193,xOgunx,MASTER I,117,22.0,241,53,188,br
194,GlaucondE,MASTER I,116,12.3,171,21,150,br
195,dedinho do lula,MASTER I,115,12.6,285,36,249,br
196,JoliasJolaias,MASTER I,114,13.5,193,26,167,br
197,pedinshow,MASTER I,113,14.6,342,50,292,br
198,Sonsa Esterco,MASTER I,113,15.8,133,21,112,br
199,Kovah,MASTER I,110,13.3,195,26,169,br
200,Kvrão,MASTER I,109,48.7,78,38,40,br
201,bom coração,MASTER I,108,15.1,298,45,253,br
202,Shugas,MASTER I,107,14.7,395,58,337,br
203,HIGOR HIGOR TFT,MASTER I,106,18.9,344,65,279,br
204,guuih7,MASTER I,106,17.6,205,36,169,br
205,MarkLinv,MASTER I,104,19.5,220,43,177,br
206,Dani Dani TFT,MASTER I,103,16.6,308,51,257,br
207,Behold Imperius,MASTER I,102,28.3,145,41,104,br
208,xOnlyx,MASTER I,101,17.9,425,76,349,br
209,AugustoKyouma,MASTER I,101,11.5,260,30,230,br
210,BRTitan,MASTER I,99,15.9,251,40,211,br
211,Satyr1,MASTER I,98,13.4,514,69,445,br
212,Djanz,MASTER I,98,16.8,304,51,253,br
213,Roubaram o meu,MASTER I,98,14.9,168,25,143,br
214,TAKOKUFEDENO,MASTER I,96,30.2,96,29,67,br
215,Jarvan IV Jungle,MASTER I,93,13.1,505,66,439,br
216,07031997,MASTER I,92,15.4,376,58,318,br
217,MAMILOENDURECIDO,MASTER I,91,15.5,614,95,519,br
218,CapelaOMeior,MASTER I,91,15.5,515,80,435,br
219,dereguejhon,MASTER I,90,22.1,412,91,321,br
220,Dede1 TFT,MASTER I,90,19.4,253,49,204,br
221,Dézim TFT,MASTER I,89,18.3,164,30,134,br
222,NXL Phoenix,MASTER I,87,11.8,398,47,351,br
223,mitastico,MASTER I,86,15.7,312,49,263,br
224,Giovanni Toth,MASTER I,83,14.1,725,102,623,br
225,sir blackpwner,MASTER I,83,10.5,607,64,543,br
226,AdminDiego,MASTER I,82,14.0,730,102,628,br
227,CygnusReborn,MASTER I,82,9.4,469,44,425,br
228,soares novo,MASTER I,82,24.1,108,26,82,br
229,LeMort,MASTER I,80,12.8,273,35,238,br
230,DeBitous,MASTER I,79,14.9,562,84,478,br
231,Eddie Jr,MASTER I,78,20.1,422,85,337,br
232,BixoCarpado,MASTER I,77,14.4,167,24,143,br
233,Marketeiro,MASTER I,76,17.4,293,51,242,br
234,Padawan p1,MASTER I,76,7.5,386,29,357,br
235,Major Tactics,MASTER I,75,14.8,431,64,367,br
236,Rafinha TheExile,MASTER I,74,17.4,218,38,180,br
237,PheonixS W,MASTER I,73,18.4,380,70,310,br
238,SpotNik,MASTER I,71,18.6,129,24,105,br
239,Nelpike,MASTER I,69,15.4,299,46,253,br
240,Park Ro Jin,MASTER I,69,13.8,289,40,249,br
241,Fayer,MASTER I,69,13.6,250,34,216,br
242,nao bane heimer,MASTER I,66,8.3,372,31,341,br
243,A Bia me Come,MASTER I,65,13.7,388,53,335,br
244,MAMI TIROTEIO,MASTER I,63,18.8,176,33,143,br
245,Kawori Miyazono,MASTER I,62,9.4,1092,103,989,br
246,PolariZed,MASTER I,62,30.8,65,20,45,br
247,sakatoba,MASTER I,61,16.9,373,63,310,br
248,TFT Ryok,MASTER I,61,21.8,133,29,104,br
249,merymy,MASTER I,60,9.3,591,55,536,br
250,Lipex,MASTER I,60,20.9,167,35,132,br
251,Gama Goblins,MASTER I,58,22.3,139,31,108,br
252,Cheleia,MASTER I,57,13.2,257,34,223,br
253,A CABEÇA,MASTER I,56,18.7,428,80,348,br
254,Guiczar,MASTER I,56,11.9,596,71,525,br
255,MNK Talrand,MASTER I,53,18.0,405,73,332,br
256,Weiro,MASTER I,53,19.5,149,29,120,br
257,Pagnig0d,MASTER I,52,15.7,293,46,247,br
258,Bad TFT playerr,MASTER I,49,20.4,113,23,90,br
259,Fã da Gal Gadot,MASTER I,48,14.2,463,66,397,br
260,RV Thrash,MASTER I,47,17.2,122,21,101,br
261,LeleoBlindãoTFT,MASTER I,46,18.9,281,53,228,br
262,chemistryMAN,MASTER I,45,15.2,237,36,201,br
263,xewelzer,MASTER I,44,23.8,353,84,269,br
264,Strixy,MASTER I,44,16.5,394,65,329,br
265,LEONERIX,MASTER I,44,12.8,359,46,313,br
266,TFT ATEU FALIDO,MASTER I,43,9.6,675,65,610,br
267,RamonRF,MASTER I,42,15.9,605,96,509,br
268,IntoxiG,MASTER I,42,15.8,486,77,409,br
269,Buttenbender TFT,MASTER I,42,11.4,559,64,495,br
270,XebeckX1,MASTER I,42,15.5,238,37,201,br
271,Inside Digitally,MASTER I,42,20.8,154,32,122,br
272,Ieko,MASTER I,41,17.5,342,60,282,br
273,Carinha de Raiva,MASTER I,41,19.1,246,47,199,br
274,Heathcote,MASTER I,41,15.6,199,31,168,br
275,BtG Wonderweiss,MASTER I,39,14.2,435,62,373,br
276,Gabymar10,MASTER I,39,14.9,361,54,307,br
277,RehDuarte,MASTER I,39,14.1,370,52,318,br
278,Big beijo pra vc,MASTER I,39,15.1,299,45,254,br
279,HohenshaoBanshoo,MASTER I,39,19.7,147,29,118,br
280,Somos OM,MASTER I,38,14.2,479,68,411,br
281,Cornélio69,MASTER I,38,23.9,247,59,188,br
282,Wyzer,MASTER I,38,14.5,325,47,278,br
283,Policial boa,MASTER I,38,18.7,171,32,139,br
284,Draicker,MASTER I,38,16.6,145,24,121,br
285,Odiparoanaiel,MASTER I,38,12.4,194,24,170,br
286,Okabuloz,MASTER I,37,13.2,1269,168,1101,br
287,Viking Vaporuub,MASTER I,37,18.7,225,42,183,br
288,Zamora TFT,MASTER I,37,15.3,157,24,133,br
289,TFT Jorjão 1v7,MASTER I,36,19.6,158,31,127,br
290,Mitsuzord TFT,MASTER I,36,17.0,176,30,146,br
291,Ulth,MASTER I,35,18.4,565,104,461,br
292,zDaimon,MASTER I,35,17.9,246,44,202,br
293,Sina TFT,MASTER I,34,27.7,101,28,73,br
294,xLosTxSouLx TFT,MASTER I,34,18.1,127,23,104,br
295,FLIPEZERA,MASTER I,33,18.8,208,39,169,br
296,DobZ,MASTER I,33,30.2,119,36,83,br
297,Vermiliom,MASTER I,33,10.9,247,27,220,br
298,Allpale,MASTER I,32,19.1,345,66,279,br
299,Diegocosta28,MASTER I,32,14.4,348,50,298,br
300,mateuslanhoso,MASTER I,32,20.4,142,29,113,br
301,Bronze,MASTER I,32,14.9,194,29,165,br
302,SNEPIN DOG,MASTER I,31,16.0,692,111,581,br
303,Hadex666,MASTER I,31,19.3,486,94,392,br
304,Tiagod Rx,MASTER I,31,15.1,271,41,230,br
305,I just play TFT,MASTER I,31,26.5,132,35,97,br
306,Urde,MASTER I,30,11.1,962,107,855,br
307,Infestissumam,MASTER I,30,15.4,584,90,494,br
308,Darth Hergeir,MASTER I,30,12.9,472,61,411,br
309,SMURF BIG BEIJO,MASTER I,30,15.4,317,49,268,br
310,CHON5,MASTER I,29,22.6,301,68,233,br
311,Yellow Umbrella,MASTER I,29,14.9,403,60,343,br
312,Boludo Aweonado,MASTER I,28,15.9,420,67,353,br
313,TFT Dage,MASTER I,28,17.3,179,31,148,br
314,bora demoção,MASTER I,28,16.4,189,31,158,br
315,sup sem chat,MASTER I,28,27.5,109,30,79,br
316,Maestoso,MASTER I,27,17.8,439,78,361,br
317,Tony o Motoboy,MASTER I,27,13.2,355,47,308,br
318,Vermei,MASTER I,27,12.8,321,41,280,br
319,Unfinished song,MASTER I,27,24.0,104,25,79,br
320,Fragile Armor,MASTER I,26,16.4,397,65,332,br
321,Amon TFT,MASTER I,26,12.3,512,63,449,br
322,Sir Ferreira,MASTER I,26,20.1,189,38,151,br
323,Allancar,MASTER I,26,27.5,131,36,95,br
324,Citric,MASTER I,26,22.1,131,29,102,br
325,Sukesvs,MASTER I,25,14.4,908,131,777,br
326,Smurf do Vovo,MASTER I,24,20.6,155,32,123,br
327,lBulleTT,MASTER I,23,20.0,195,39,156,br
328,FoxYin,MASTER I,23,20.4,186,38,148,br
329,MiragePH,MASTER I,23,13.2,166,22,144,br
330,Mitsuzord,MASTER I,22,9.0,810,73,737,br
331,Vixabali,MASTER I,21,12.6,486,61,425,br
332,CADU xTFTx,MASTER I,21,11.2,402,45,357,br
333,xSoulsuke,MASTER I,21,13.7,219,30,189,br
334,nolliA,MASTER I,21,28.6,70,20,50,br
335,Aillon,MASTER I,21,19.4,98,19,79,br
336,1 2 3 4 5 6 7,MASTER I,20,20.6,335,69,266,br
337,Kayle RXSL,MASTER I,20,17.4,361,63,298,br
338,BuGad0 TFT,MASTER I,20,10.6,321,34,287,br
339,Gerson bombeiro,MASTER I,19,16.1,336,54,282,br
340,Volt TFT,MASTER I,19,15.5,239,37,202,br
341,BiscoitoS2,MASTER I,18,18.6,338,63,275,br
342,DoctorMadeira2,MASTER I,18,11.8,322,38,284,br
343,i9Sedex,MASTER I,17,22.3,273,61,212,br
344,Aphroddi,MASTER I,17,17.1,286,49,237,br
345,twt sirius,MASTER I,17,16.0,244,39,205,br
346,FelixBarboza,MASTER I,16,19.0,462,88,374,br
347,miIes halter,MASTER I,16,15.4,505,78,427,br
348,Ralmico,MASTER I,16,20.3,374,76,298,br
349,Lucas reformado,MASTER I,16,17.5,366,64,302,br
350,KidoSuno,MASTER I,16,12.8,376,48,328,br
351,Ryok,MASTER I,16,15.6,218,34,184,br
352,É o Rauzitus né,MASTER I,16,22.5,142,32,110,br
353,Meu nome é isso,MASTER I,16,15.5,168,26,142,br
354,KingLordz1,MASTER I,15,11.0,937,103,834,br
355,bluish flame,MASTER I,15,13.5,355,48,307,br
356,Zesizeru,MASTER I,15,18.2,220,40,180,br
357,Rubimhood,MASTER I,15,11.5,304,35,269,br
358,Le ismym4in,MASTER I,15,13.1,198,26,172,br
359,Cyber Legacy,MASTER I,14,18.4,282,52,230,br
360,TeMameiAjoelhado,MASTER I,14,26.1,184,48,136,br
361,Cavalo Gaúcho,MASTER I,14,11.8,372,44,328,br
362,znx,MASTER I,14,14.1,256,36,220,br
363,Eu amo mt ela,MASTER I,14,24.0,121,29,92,br
364,kratos2123,MASTER I,14,20.3,133,27,106,br
365,Criisto,MASTER I,13,14.4,438,63,375,br
366,Ana Beatriz,MASTER I,13,19.5,277,54,223,br
367,xDCariocaxD,MASTER I,13,20.2,193,39,154,br
368,JV O Pendante,MASTER I,13,14.5,200,29,171,br
369,Kh1laf,MASTER I,12,17.2,437,75,362,br
370,l  DoctoR  l,MASTER I,12,19.0,327,62,265,br
371,xLosTxSouLx,MASTER I,12,16.2,315,51,264,br
372,Peepo Happy,MASTER I,12,10.2,470,48,422,br
373,I Vayu I,MASTER I,12,12.3,348,43,305,br
374,Dogue,MASTER I,12,21.1,156,33,123,br
375,Wertech,MASTER I,12,20.6,155,32,123,br
376,Robot29,MASTER I,12,19.7,147,29,118,br
377,Gonzalez666,MASTER I,11,10.9,475,52,423,br
378,SweGGRED,MASTER I,11,19.9,231,46,185,br
379,WL Arthurzinho,MASTER I,11,17.4,218,38,180,br
380,Stephen Hawkings,MASTER I,11,13.0,276,36,240,br
381,MisakaS2,MASTER I,11,18.3,175,32,143,br
382,Pathelli,MASTER I,11,16.5,164,27,137,br
383,Chera meu shacco,MASTER I,10,17.7,559,99,460,br
384,TFT JV,MASTER I,10,16.0,407,65,342,br
385,JãoZao13,MASTER I,10,11.2,556,62,494,br
386,AerialBoy,MASTER I,10,14.6,404,59,345,br
387,Ratochinski,MASTER I,10,14.7,265,39,226,br
388,O Tal do Cabeça,MASTER I,10,12.7,299,38,261,br
389,MC Ainzinho,MASTER I,10,13.6,273,37,236,br
390,NARNIANOjr,MASTER I,10,11.9,251,30,221,br
391,Lucin do TFT,MASTER I,9,15.4,492,76,416,br
392,Riconss,MASTER I,9,21.7,272,59,213,br
393,Maiyinha,MASTER I,9,20.6,282,58,224,br
394,Urso Árabe,MASTER I,9,21.5,246,53,193,br
395,I John l,MASTER I,9,14.7,319,47,272,br
396,Joe Fury,MASTER I,9,17.0,253,43,210,br
397,MC Ana Raio,MASTER I,9,23.7,173,41,132,br
398,Tequilera,MASTER I,9,15.6,224,35,189,br
399,vo pro dofus,MASTER I,9,27.6,87,24,63,br
400,telessena,MASTER I,8,22.4,313,70,243,br
401,FawZer,MASTER I,8,17.7,373,66,307,br
402,Guiziin,MASTER I,8,17.7,311,55,256,br
403,Devil1,MASTER I,7,24.2,252,61,191,br
404,Eduu,MASTER I,7,16.7,342,57,285,br
405,WUK EPICURISTA,MASTER I,7,12.7,379,48,331,br
406,Lombrah,MASTER I,7,15.4,221,34,187,br
407,Macaonn,MASTER I,6,12.7,613,78,535,br
408,Krobalto,MASTER I,6,12.7,464,59,405,br
409,Vladinhomir,MASTER I,6,19.3,290,56,234,br
410,Kidzinho,MASTER I,6,14.1,391,55,336,br
411,Sydney Cole,MASTER I,6,19.0,268,51,217,br
412,Until i Die,MASTER I,5,10.9,705,77,628,br
413,MBokos,MASTER I,5,18.6,392,73,319,br
414,l Floky l,MASTER I,5,25.0,236,59,177,br
415,Valor is my main,MASTER I,5,23.9,180,43,137,br
416,Mathsilver,MASTER I,5,15.1,272,41,231,br
417,Mr Kappa,MASTER I,5,23.0,174,40,134,br
418,IG Balzana,MASTER I,5,18.6,177,33,144,br
419,SpaCeZark,MASTER I,5,17.5,183,32,151,br
420,Chimarraio,MASTER I,5,14.8,210,31,179,br
421,Pessoinha101,MASTER I,5,19.5,154,30,124,br
422,alvesjp,MASTER I,5,16.2,148,24,124,br
423,Amo um Palhaço,MASTER I,4,18.9,334,63,271,br
424,Death Aragorn,MASTER I,4,26.2,164,43,121,br
425,Golden Wings,MASTER I,4,15.8,272,43,229,br
426,ALFA,MASTER I,4,16.1,174,28,146,br
427,swear on styx,MASTER I,4,15.6,160,25,135,br
428,ReiCasca,MASTER I,3,13.0,516,67,449,br
429,xDuracelx,MASTER I,3,17.3,323,56,267,br
430,Excelsior XD,MASTER I,3,22.3,224,50,174,br
431,Mãe da Karma,MASTER I,3,18.7,235,44,191,br
432,FLA chips,MASTER I,3,16.8,250,42,208,br
433,Pusk,MASTER I,3,21.8,174,38,136,br
434,Äyrton Senna,MASTER I,3,17.7,203,36,167,br
435,Goiano3Estrelas,MASTER I,3,16.0,219,35,184,br
436,Vïni,MASTER I,3,10.3,302,31,271,br
437,germanTFT,MASTER I,3,22.2,135,30,105,br
438,FireDiamond,MASTER I,3,17.5,160,28,132,br
439,NORVAK,MASTER I,3,17.0,135,23,112,br
440,Little Yumie,MASTER I,2,8.3,879,73,806,br
441,Gahilan,MASTER I,2,14.8,487,72,415,br
442,Feeddersticks,MASTER I,2,24.4,279,68,211,br
443,Billy Bat,MASTER I,2,11.3,577,65,512,br
444,2v2,MASTER I,2,11.1,579,64,515,br
445,smurf cadu xTFTx,MASTER I,2,16.4,383,63,320,br
446,Lermi,MASTER I,2,13.9,446,62,384,br
447,Mestre no TFT,MASTER I,2,17.5,292,51,241,br
448,BestOne,MASTER I,2,14.4,118,17,101,br
449,KaiSadaw,MASTER I,1,15.1,491,74,417,br
450,DETETIVE ALINE,MASTER I,1,18.7,363,68,295,br
451,SaudosaMaloca,MASTER I,1,15.0,406,61,345,br
452,iCorry,MASTER I,1,22.4,201,45,156,br
453,Beach Goth,MASTER I,1,10.4,404,42,362,br
454,Niicoso,MASTER I,1,12.7,205,26,179,br
455,cythtei,MASTER I,1,22.3,112,25,87,br
456,LyrikGG,MASTER I,0,15.8,660,104,556,br
457,TFT Win,MASTER I,0,14.6,630,92,538,br
458,Oliver FAR,MASTER I,0,11.5,793,91,702,br
459,FBC é Muito Zika,MASTER I,0,16.7,474,79,395,br
460,SilverSoldier,MASTER I,0,22.0,354,78,276,br
461,Marlboro IceMint,MASTER I,0,21.1,356,75,281,br
462,Totto,MASTER I,0,15.1,497,75,422,br
463,C Marighella,MASTER I,0,19.0,389,74,315,br
464,Dérp,MASTER I,0,13.3,547,73,474,br
465,ArenaBulldog TFT,MASTER I,0,15.4,441,68,373,br
466,its doomed,MASTER I,0,20.4,329,67,262,br
467,PinGuim Eu Sou,MASTER I,0,15.9,408,65,343,br
468,TFT Japalterado,MASTER I,0,17.1,368,63,305,br
469,SpeIIman,MASTER I,0,22.5,275,62,213,br
470,FLA Visconde,MASTER I,0,18.6,328,61,267,br
471,nyaw,MASTER I,0,16.1,367,59,308,br
472,Balalaika Pura,MASTER I,0,20.7,280,58,222,br
473,MinoThalysson,MASTER I,0,22.2,243,54,189,br
474,iEnergy,MASTER I,0,14.9,356,53,303,br
475,ÖDlN,MASTER I,0,17.4,287,50,237,br
476,felipeeanjos,MASTER I,0,15.9,296,47,249,br
477,Iorek TFT,MASTER I,0,16.4,275,45,230,br
478,Cadê a namorada,MASTER I,0,11.3,390,44,346,br
479,GadaoDeDeus,MASTER I,0,15.5,278,43,235,br
480,Yninjabrasil,MASTER I,0,27.8,144,40,104,br
481,O Bessa,MASTER I,0,21.7,184,40,144,br
482,Letacio,MASTER I,0,18.3,213,39,174,br
483,RoyallBurN,MASTER I,0,13.6,287,39,248,br
484,Grakehall,MASTER I,0,12.1,321,39,282,br
485,Daemonfeuer,MASTER I,0,16.0,237,38,199,br
486,Pabloht,MASTER I,0,12.5,295,37,258,br
487,Adellos,MASTER I,0,11.6,319,37,282,br
488,Bettina,MASTER I,0,26.5,136,36,100,br
489,BADBatavo TFT,MASTER I,0,21.1,166,35,131,br
490,Caesar Clown,MASTER I,0,17.7,198,35,163,br
491,DSM CallMeGod,MASTER I,0,14.5,241,35,206,br
492,TA IN SHOCK KK,MASTER I,0,9.8,358,35,323,br
493,Tryndamere King,MASTER I,0,18.1,188,34,154,br
494,AtomicFinger26,MASTER I,0,16.2,210,34,176,br
495,Rendras,MASTER I,0,18.0,183,33,150,br
496,PouWalki,MASTER I,0,17.6,182,32,150,br
497,bshow,MASTER I,0,13.7,234,32,202,br
498,Krayvhus Luvith,MASTER I,0,11.1,288,32,256,br
499,H1p3rioN,MASTER I,0,24.2,128,31,97,br
500,Hater De Kpoper,MASTER I,0,14.4,215,31,184,br
1,DaSaEbaVMo6niq,CHALLENGER I,1811,25.6,441,113,328,eune
2,TFT Hadaf,CHALLENGER I,1529,26.5,442,117,325,eune
3,Chinese Superbot,CHALLENGER I,1176,25.0,711,178,533,eune
4,Deepityy,CHALLENGER I,1171,26.6,282,75,207,eune
5,Hi Im Hadaf,CHALLENGER I,1131,21.7,281,61,220,eune
6,Deepityyy,CHALLENGER I,1115,29.4,282,83,199,eune
7,nuenueyouyuegou,CHALLENGER I,1009,31.0,229,71,158,eune
8,Barbalofono,CHALLENGER I,988,14.2,544,77,467,eune
9,qqqwwweeerrrttt,CHALLENGER I,942,27.5,309,85,224,eune
10,Spatula Rasa,CHALLENGER I,929,12.6,1015,128,887,eune
11,ShayonZ,CHALLENGER I,923,24.1,398,96,302,eune
12,yingyi,CHALLENGER I,871,24.9,189,47,142,eune
13,Kier0n,CHALLENGER I,818,24.7,247,61,186,eune
14,kocham michasia,CHALLENGER I,789,33.0,215,71,144,eune
15,Ambitious Noob,CHALLENGER I,779,21.7,355,77,278,eune
16,Kumihowo,CHALLENGER I,777,27.2,184,50,134,eune
17,Quevash,CHALLENGER I,755,21.5,242,52,190,eune
18,BBit,CHALLENGER I,752,26.1,161,42,119,eune
19,End of The Line,CHALLENGER I,728,15.5,1085,168,917,eune
20,Abo Sreee3,CHALLENGER I,704,25.6,320,82,238,eune
21,Sting Youclif,CHALLENGER I,680,19.6,214,42,172,eune
22,Fadder,CHALLENGER I,677,18.1,485,88,397,eune
23,Cebo v9,CHALLENGER I,665,23.1,182,42,140,eune
24,Maro0N,CHALLENGER I,650,25.8,155,40,115,eune
25,shonun,CHALLENGER I,641,27.4,135,37,98,eune
26,WP Szati,CHALLENGER I,617,20.2,317,64,253,eune
27,Tokuchi Toua,CHALLENGER I,616,18.5,249,46,203,eune
28,longlive,CHALLENGER I,615,13.7,343,47,296,eune
29,Bardton Senna,CHALLENGER I,612,17.6,330,58,272,eune
30,acoj,CHALLENGER I,611,16.5,248,41,207,eune
31,Sesard,CHALLENGER I,598,16.6,295,49,246,eune
32,Strikerko,CHALLENGER I,591,19.5,620,121,499,eune
33,Endø,CHALLENGER I,591,17.0,300,51,249,eune
34,Freak Simba,CHALLENGER I,588,13.1,419,55,364,eune
35,Daniels sagor,CHALLENGER I,586,19.4,222,43,179,eune
36,pjsaig,CHALLENGER I,565,31.2,125,39,86,eune
37,SnailDaddy,CHALLENGER I,556,15.5,592,92,500,eune
38,DIV Fortanu,CHALLENGER I,548,17.9,341,61,280,eune
39,Brynool,CHALLENGER I,544,22.0,241,53,188,eune
40,Άνεργος,CHALLENGER I,535,14.5,366,53,313,eune
41,rngshinyruo,CHALLENGER I,535,25.0,176,44,132,eune
42,Tw1stedFate1,CHALLENGER I,532,28.6,154,44,110,eune
43,Swimmable Toast,CHALLENGER I,526,27.2,136,37,99,eune
44,Im Sneaky,CHALLENGER I,524,16.7,592,99,493,eune
45,Tryndabeard TTV,CHALLENGER I,523,21.2,189,40,149,eune
46,jakecn,CHALLENGER I,522,18.7,203,38,165,eune
47,No Ragrets,CHALLENGER I,518,20.1,304,61,243,eune
48,BillKong,CHALLENGER I,514,20.1,284,57,227,eune
49,SB CCisMyCounter,CHALLENGER I,509,18.3,301,55,246,eune
50,SaintBlacky,CHALLENGER I,508,13.2,626,83,543,eune
51,masterboi,"GRANDMASTER I
G",525,12.9,466,60,406,eune
52,4NDI,"GRANDMASTER I
G",506,20.0,690,138,552,eune
53,MosPeΙeush,"GRANDMASTER I
G",498,17.1,210,36,174,eune
54,tokkila,"GRANDMASTER I
G",493,17.9,340,61,279,eune
55,ŹZ ZZ ZZ ZZ ZZ,"GRANDMASTER I
G",492,15.3,976,149,827,eune
56,Redundancia,"GRANDMASTER I
G",489,25.5,298,76,222,eune
57,Cuudi,"GRANDMASTER I
G",482,17.3,398,69,329,eune
58,Brixilolzsk,"GRANDMASTER I
G",449,16.9,445,75,370,eune
59,earlyheart,"GRANDMASTER I
G",447,25.7,144,37,107,eune
60,RaVen v1,"GRANDMASTER I
G",446,21.6,217,47,170,eune
61,Electrolyze,"GRANDMASTER I
G",445,20.5,254,52,202,eune
62,malac1,"GRANDMASTER I
G",434,14.5,338,49,289,eune
63,aal233,"GRANDMASTER I
G",430,16.5,400,66,334,eune
64,abe the savior,"GRANDMASTER I
G",427,15.8,632,100,532,eune
65,lBigossl,"GRANDMASTER I
G",412,11.8,355,42,313,eune
66,JointBongo,"GRANDMASTER I
G",411,25.9,135,35,100,eune
67,Epitheoritiς,"GRANDMASTER I
G",406,15.7,306,48,258,eune
68,LuQ876,"GRANDMASTER I
G",396,14.2,738,105,633,eune
69,ARNOLD,"GRANDMASTER I
G",394,15.6,754,118,636,eune
70,Kőrean Jungler,"GRANDMASTER I
G",387,16.4,800,131,669,eune
71,RNGuziuziuzi,"GRANDMASTER I
G",373,30.1,126,38,88,eune
72,Slanof,"GRANDMASTER I
G",369,15.4,389,60,329,eune
73,kEEN v7,"GRANDMASTER I
G",368,21.2,137,29,108,eune
74,MLxDDD,"GRANDMASTER I
G",361,18.1,380,69,311,eune
75,tftsoftexe,"GRANDMASTER I
G",357,19.2,318,61,257,eune
76,forever52,"GRANDMASTER I
G",356,23.9,167,40,127,eune
77,qiqi277,"GRANDMASTER I
G",356,28.1,121,34,87,eune
78,tousinimab,"GRANDMASTER I
G",352,18.1,299,54,245,eune
79,Nevilter,"GRANDMASTER I
G",349,13.7,313,43,270,eune
80,citrusZZ,"GRANDMASTER I
G",336,17.1,292,50,242,eune
81,qaqqqqq,"GRANDMASTER I
G",330,17.5,206,36,170,eune
82,youzaifanfu,"GRANDMASTER I
G",325,19.8,419,83,336,eune
83,dendek,"GRANDMASTER I
G",325,20.8,317,66,251,eune
84,deqiang,"GRANDMASTER I
G",325,19.7,259,51,208,eune
85,Id sex me,"GRANDMASTER I
G",325,36.8,117,43,74,eune
86,wangweichuizi,"GRANDMASTER I
G",318,14.9,221,33,188,eune
87,yyyyyye,"GRANDMASTER I
G",314,19.8,400,79,321,eune
88,OFC Cute,"GRANDMASTER I
G",314,14.5,448,65,383,eune
89,xiaozhuhuijie,"GRANDMASTER I
G",313,19.8,187,37,150,eune
90,victor victoris,"GRANDMASTER I
G",312,13.2,506,67,439,eune
91,VERONICA RUN RUN,"GRANDMASTER I
G",311,25.5,239,61,178,eune
92,Chieftan Nessus,"GRANDMASTER I
G",310,14.7,197,29,168,eune
93,Riku Na,"GRANDMASTER I
G",299,30.8,117,36,81,eune
94,Laamakuiskaaja,"GRANDMASTER I
G",298,11.7,633,74,559,eune
95,Nickon,"GRANDMASTER I
G",296,16.8,381,64,317,eune
96,qwbctyz,"GRANDMASTER I
G",292,29.6,135,40,95,eune
97,Cynamon TFT,"GRANDMASTER I
G",283,13.8,650,90,560,eune
98,LyAmAm,"GRANDMASTER I
G",283,22.8,149,34,115,eune
99,Fine11,"GRANDMASTER I
G",282,15.4,518,80,438,eune
100,yuquan,"GRANDMASTER I
G",276,22.6,350,79,271,eune
101,In Too Deep,"GRANDMASTER I
G",275,14.8,748,111,637,eune
102,MaKharg JG,"GRANDMASTER I
G",275,17.6,426,75,351,eune
103,MARStoiAN,"GRANDMASTER I
G",271,11.1,559,62,497,eune
104,For chr1st sake,"GRANDMASTER I
G",268,11.1,721,80,641,eune
105,FENG13144,"GRANDMASTER I
G",267,25.3,249,63,186,eune
106,hemourenya,"GRANDMASTER I
G",265,19.8,257,51,206,eune
107,Ο Β Ε Υ,"GRANDMASTER I
G",263,17.3,306,53,253,eune
108,Baschtian,"GRANDMASTER I
G",262,26.5,151,40,111,eune
109,Efrebee,"GRANDMASTER I
G",262,22.9,131,30,101,eune
110,Ih8java,"GRANDMASTER I
G",260,18.5,552,102,450,eune
111,Challenger Heart,"GRANDMASTER I
G",258,20.1,179,36,143,eune
112,Cerebel22,"GRANDMASTER I
G",257,14.5,242,35,207,eune
113,xiaofeng998,"GRANDMASTER I
G",255,24.3,136,33,103,eune
114,drma330,"GRANDMASTER I
G",253,16.4,293,48,245,eune
115,SKT Mexes,"GRANDMASTER I
G",252,15.3,229,35,194,eune
116,SeekN7eak,"GRANDMASTER I
G",249,18.0,1180,212,968,eune
117,DarkSynapse,"GRANDMASTER I
G",248,11.6,1009,117,892,eune
118,TheLazyBastard,"GRANDMASTER I
G",248,22.6,159,36,123,eune
119,Boudist,"GRANDMASTER I
G",245,16.8,285,48,237,eune
120,ZBlang,"GRANDMASTER I
G",245,29.5,95,28,67,eune
121,maurhapilhGR,"GRANDMASTER I
G",244,16.9,249,42,207,eune
122,Wykonc,"GRANDMASTER I
G",242,17.2,244,42,202,eune
123,tinmar,"GRANDMASTER I
G",241,16.6,325,54,271,eune
124,K3NNY1337,"GRANDMASTER I
G",241,14.1,347,49,298,eune
125,Darosch,"GRANDMASTER I
G",241,13.4,276,37,239,eune
126,CHINCZYQ,"GRANDMASTER I
G",240,16.2,136,22,114,eune
127,huyabinzi,"GRANDMASTER I
G",238,18.6,221,41,180,eune
128,klausrofl twitch,"GRANDMASTER I
G",236,13.5,356,48,308,eune
129,wenfan,"GRANDMASTER I
G",236,22.1,154,34,120,eune
130,božský tureto,"GRANDMASTER I
G",235,13.5,245,33,212,eune
131,ETSIDETHABENEIS,"GRANDMASTER I
G",234,16.6,337,56,281,eune
132,mozhili,"GRANDMASTER I
G",233,17.5,428,75,353,eune
133,sfedis,"GRANDMASTER I
G",232,15.1,365,55,310,eune
134,duange666,"GRANDMASTER I
G",232,24.3,136,33,103,eune
135,Pana2525,"GRANDMASTER I
G",231,21.1,265,56,209,eune
136,aosjsjz,"GRANDMASTER I
G",231,22.0,177,39,138,eune
137,nayemnau,"GRANDMASTER I
G",230,19.3,300,58,242,eune
138,Ćelestial,"GRANDMASTER I
G",228,15.4,410,63,347,eune
139,jiaozhiaini,"GRANDMASTER I
G",228,17.3,243,42,201,eune
140,KREATOPITA,"GRANDMASTER I
G",228,15.8,228,36,192,eune
141,onik1997,"GRANDMASTER I
G",227,40.0,100,40,60,eune
142,Cebanthon,"GRANDMASTER I
G",226,26.0,177,46,131,eune
143,Th3 Mask,"GRANDMASTER I
G",225,18.9,535,101,434,eune
144,kuaileFN666,"GRANDMASTER I
G",224,29.6,189,56,133,eune
145,DcStarz,"GRANDMASTER I
G",224,19.4,252,49,203,eune
146,Donger Bonger,"GRANDMASTER I
G",223,31.0,113,35,78,eune
147,Tiro X Eqt,"GRANDMASTER I
G",221,13.8,267,37,230,eune
148,kecsketej5,"GRANDMASTER I
G",220,19.4,396,77,319,eune
149,Žiks,"GRANDMASTER I
G",220,19.8,212,42,170,eune
150,gyybtomorrow,"GRANDMASTER I
G",220,18.2,198,36,162,eune
151,Lucifer Junior,MASTER I,219,18.5,400,74,326,eune
152,NBDandan,MASTER I,218,17.1,170,29,141,eune
153,Lil Vayne J7,MASTER I,217,19.0,716,136,580,eune
154,fangshen,MASTER I,217,17.9,218,39,179,eune
155,Chinese0008,MASTER I,216,25.4,110,28,82,eune
156,LeBronze Jàmes,MASTER I,213,19.8,490,97,393,eune
157,lordpepigz,MASTER I,212,15.2,309,47,262,eune
158,harimania,MASTER I,210,24.2,153,37,116,eune
159,Unlucky Team,MASTER I,209,16.0,187,30,157,eune
160,TFT Poulaki,MASTER I,208,14.6,707,103,604,eune
161,KarnageTheCrane,MASTER I,208,13.3,285,38,247,eune
162,tiaotiao111,MASTER I,204,16.0,219,35,184,eune
163,BarneyStinsonGG,MASTER I,203,16.8,493,83,410,eune
164,islam alghoul,MASTER I,203,15.3,267,41,226,eune
165,o kalos NOE,MASTER I,201,19.5,302,59,243,eune
166,sdR,MASTER I,196,18.6,440,82,358,eune
167,SS Srpska Mafija,MASTER I,189,6.5,888,58,830,eune
168,rekklescranetail,MASTER I,187,28.4,141,40,101,eune
169,OSG Legend,MASTER I,187,16.4,225,37,188,eune
170,0rchide,MASTER I,186,14.0,444,62,382,eune
171,qiong1v7,MASTER I,185,24.5,192,47,145,eune
172,shenchao1,MASTER I,184,21.5,228,49,179,eune
173,shalockkrie,MASTER I,181,19.3,176,34,142,eune
174,baobaowo,MASTER I,177,13.0,238,31,207,eune
175,l StreamR l,MASTER I,175,17.4,478,83,395,eune
176,tego typu,MASTER I,174,21.5,149,32,117,eune
177,FuriatZ,MASTER I,172,20.2,242,49,193,eune
178,laonazaici,MASTER I,170,14.9,228,34,194,eune
179,Hari,MASTER I,167,16.9,136,23,113,eune
180,ziyoumowang,MASTER I,163,28.4,141,40,101,eune
181,Biaaaaaaaatch,MASTER I,162,13.7,380,52,328,eune
182,YhongL,MASTER I,161,12.2,253,31,222,eune
183,asd110,MASTER I,159,15.8,595,94,501,eune
184,jijn3rj4j,MASTER I,159,23.2,138,32,106,eune
185,Razyo,MASTER I,157,16.5,273,45,228,eune
186,LTUGAMER,MASTER I,154,15.9,226,36,190,eune
187,Smith 40i4,MASTER I,152,15.4,389,60,329,eune
188,jg díff,MASTER I,152,20.3,261,53,208,eune
189,Alfa Bard,MASTER I,151,24.0,146,35,111,eune
190,huawuyan,MASTER I,150,16.0,169,27,142,eune
191,Mattinyehedarhed,MASTER I,149,24.2,157,38,119,eune
192,plotak,MASTER I,147,20.5,185,38,147,eune
193,1Hadez2,MASTER I,147,16.1,205,33,172,eune
194,sixoutofsix,MASTER I,147,15.7,198,31,167,eune
195,Lethal Presencee,MASTER I,143,15.3,418,64,354,eune
196,CoLdQQ,MASTER I,139,15.8,152,24,128,eune
197,The Balla,MASTER I,138,13.1,404,53,351,eune
198,Tizy,MASTER I,138,19.8,258,51,207,eune
199,Life Priority,MASTER I,132,17.1,204,35,169,eune
200,dapianke,MASTER I,132,18.1,149,27,122,eune
201,Caramyx,MASTER I,131,14.0,444,62,382,eune
202,Szymán,MASTER I,130,15.2,230,35,195,eune
203,theshy1994,MASTER I,129,20.7,135,28,107,eune
204,IceButcher,MASTER I,127,13.7,255,35,220,eune
205,Hajzen ˉ,MASTER I,127,28.0,107,30,77,eune
206,PantherBlood,MASTER I,126,15.2,534,81,453,eune
207,chaojisaiyaren,MASTER I,126,23.3,163,38,125,eune
208,wiiiii,MASTER I,126,12.0,259,31,228,eune
209,Saimonald,MASTER I,125,16.8,274,46,228,eune
210,ALEXPOTTERZ,MASTER I,125,15.4,195,30,165,eune
211,xieming999,MASTER I,125,15.2,184,28,156,eune
212,vghjkijnm,MASTER I,125,30.6,85,26,59,eune
213,ffqaqpp,MASTER I,123,15.7,229,36,193,eune
214,Krecik x13,MASTER I,122,17.9,145,26,119,eune
215,Apa,MASTER I,121,13.8,181,25,156,eune
216,Mesh Shayfak,MASTER I,118,15.1,674,102,572,eune
217,BT Treide1,MASTER I,118,16.6,283,47,236,eune
218,shou7810,MASTER I,118,17.1,152,26,126,eune
219,tiesIgnas,MASTER I,117,12.1,521,63,458,eune
220,Ginoooooo,MASTER I,117,16.7,204,34,170,eune
221,Ex Samurai,MASTER I,114,20.0,370,74,296,eune
222,felicia999,MASTER I,114,20.7,174,36,138,eune
223,Sbgogogo,MASTER I,112,22.4,165,37,128,eune
224,MiNo22,MASTER I,112,14.8,244,36,208,eune
225,D1e With Me,MASTER I,110,14.3,441,63,378,eune
226,Mingminghenaini,MASTER I,110,25.4,110,28,82,eune
227,Czo Tén Master,MASTER I,109,14.2,197,28,169,eune
228,Bluntzkri3g420,MASTER I,108,15.6,397,62,335,eune
229,Jiangyw888,MASTER I,105,14.1,377,53,324,eune
230,Paljo,MASTER I,105,17.8,163,29,134,eune
231,johnniedrake,MASTER I,104,23.2,586,136,450,eune
232,Voltisz,MASTER I,104,14.2,444,63,381,eune
233,Foreverstar2,MASTER I,104,23.0,239,55,184,eune
234,Ykxnbo,MASTER I,103,18.9,217,41,176,eune
235,Stavv,MASTER I,103,18.5,216,40,176,eune
236,dlskssss,MASTER I,103,26.9,115,31,84,eune
237,Mvp UnFeeLer,MASTER I,101,20.8,265,55,210,eune
238,china55open,MASTER I,100,31.8,107,34,73,eune
239,JaguarKWT,MASTER I,100,12.6,159,20,139,eune
240,ShadoωMoon,MASTER I,99,15.3,412,63,349,eune
241,songtongyu,MASTER I,97,19.9,141,28,113,eune
242,Jeckey Chen,MASTER I,93,17.8,569,101,468,eune
243,LetoMallory7,MASTER I,93,12.8,615,79,536,eune
244,Petrusxa030,MASTER I,93,16.5,303,50,253,eune
245,the blackcok,MASTER I,93,21.1,227,48,179,eune
246,xia555,MASTER I,93,14.9,195,29,166,eune
247,mosszhou,MASTER I,92,16.6,350,58,292,eune
248,Aethna,MASTER I,90,13.0,832,108,724,eune
249,zongliang,MASTER I,90,24.6,114,28,86,eune
250,hi8823,MASTER I,90,19.6,117,23,94,eune
251,llllllssh,MASTER I,89,23.4,274,64,210,eune
252,Kayle Upton,MASTER I,89,10.0,408,41,367,eune
253,hucanwei,MASTER I,88,24.7,223,55,168,eune
254,MiNo21,MASTER I,85,17.4,288,50,238,eune
255,faker1209,MASTER I,84,18.8,436,82,354,eune
256,KombaTeH,MASTER I,84,20.0,350,70,280,eune
257,pujsapepa,MASTER I,83,21.7,360,78,282,eune
258,Róach,MASTER I,83,18.1,364,66,298,eune
259,yundingfapaiyuan,MASTER I,83,16.1,267,43,224,eune
260,Irôn Sägitta,MASTER I,83,28.3,92,26,66,eune
261,17zhangpaiNMW,MASTER I,82,18.2,121,22,99,eune
262,lizhijian,MASTER I,82,17.0,112,19,93,eune
263,WojtoszGG,MASTER I,81,17.1,492,84,408,eune
264,haopi99,MASTER I,80,19.3,202,39,163,eune
265,Sòt,MASTER I,79,19.5,210,41,169,eune
266,Hemaaa,MASTER I,79,27.4,102,28,74,eune
267,dang23,MASTER I,79,20.8,130,27,103,eune
268,zhukerong111,MASTER I,78,19.3,243,47,196,eune
269,fange666,MASTER I,78,23.4,107,25,82,eune
270,Erik0 MDMA,MASTER I,76,18.4,434,80,354,eune
271,CW Arrow,MASTER I,75,25.7,144,37,107,eune
272,defouy,MASTER I,75,18.5,157,29,128,eune
273,ghostcc,MASTER I,74,18.5,260,48,212,eune
274,joy761c,MASTER I,74,21.2,203,43,160,eune
275,lplGOOD,MASTER I,74,16.4,232,38,194,eune
276,SupriZ,MASTER I,74,13.8,247,34,213,eune
277,wanbaoliu,MASTER I,72,16.7,311,52,259,eune
278,lidayea,MASTER I,72,14.6,267,39,228,eune
279,mid łane banter,MASTER I,71,21.7,226,49,177,eune
280,ssssyu,MASTER I,70,17.9,268,48,220,eune
281,GetHoooked,MASTER I,70,12.6,277,35,242,eune
282,fts21,MASTER I,69,19.5,334,65,269,eune
283,Niziurski,MASTER I,69,13.8,341,47,294,eune
284,qp2o2oqp,MASTER I,68,22.5,111,25,86,eune
285,loveLD,MASTER I,68,25.5,94,24,70,eune
286,chuangzao0o,MASTER I,67,20.7,150,31,119,eune
287,PIka pUUU,MASTER I,66,13.7,300,41,259,eune
288,theq123,MASTER I,66,17.7,164,29,135,eune
289,Blackspy48,MASTER I,66,14.8,183,27,156,eune
290,nóChance,MASTER I,65,15.2,433,66,367,eune
291,axuandog,MASTER I,65,28.6,98,28,70,eune
292,Q6r,MASTER I,64,16.5,678,112,566,eune
293,kobe24and8,MASTER I,63,16.0,381,61,320,eune
294,522131,MASTER I,63,21.2,151,32,119,eune
295,haaaayugcr,MASTER I,63,16.3,190,31,159,eune
296,WarlordVengeance,MASTER I,62,13.3,233,31,202,eune
297,Bad High Roller,MASTER I,61,9.5,221,21,200,eune
298,SP00KK,MASTER I,60,15.6,681,106,575,eune
299,uzirrr,MASTER I,59,17.7,249,44,205,eune
300,LEonnaxi,MASTER I,58,20.3,256,52,204,eune
301,icehit,MASTER I,57,13.4,999,134,865,eune
302,RRandomNoob,MASTER I,57,19.8,303,60,243,eune
303,aerodynamicc,MASTER I,57,18.8,288,54,234,eune
304,gvfgrh4,MASTER I,57,18.3,213,39,174,eune
305,Neebo,MASTER I,57,17.8,219,39,180,eune
306,Tarosch,MASTER I,56,16.9,171,29,142,eune
307,PigvCarry,MASTER I,56,11.7,248,29,219,eune
308,Maaczka,MASTER I,55,15.1,318,48,270,eune
309,YanYanzzZ,MASTER I,55,22.2,185,41,144,eune
310,AllSkillNoLuck8,MASTER I,55,18.6,156,29,127,eune
311,dafengxiongdi,MASTER I,55,21.4,98,21,77,eune
312,shaodong,MASTER I,54,13.4,321,43,278,eune
313,darksin555,MASTER I,53,15.7,331,52,279,eune
314,Zz52000,MASTER I,53,19.3,166,32,134,eune
315,Hi Im Laure,MASTER I,53,17.6,182,32,150,eune
316,854576720,MASTER I,53,22.1,140,31,109,eune
317,IonlyPlayEvelynn,MASTER I,53,36.7,79,29,50,eune
318,Dethrook,MASTER I,52,22.1,357,79,278,eune
319,OGoneas1sas,MASTER I,52,31.1,74,23,51,eune
320,NguyenAn,MASTER I,50,21.3,437,93,344,eune
321,muppymupp,MASTER I,50,22.8,149,34,115,eune
322,bukzna,MASTER I,50,17.6,136,24,112,eune
323,kongchao123,MASTER I,48,14.5,310,45,265,eune
324,helllok,MASTER I,48,21.1,194,41,153,eune
325,manancasuflete,MASTER I,47,17.1,338,58,280,eune
326,douyu696,MASTER I,47,21.7,184,40,144,eune
327,Sói Ca,MASTER I,46,17.4,275,48,227,eune
328,caixukun777,MASTER I,46,15.1,318,48,270,eune
329,rainisnice,MASTER I,46,16.4,231,38,193,eune
330,Monkey D Luf,MASTER I,45,18.8,224,42,182,eune
331,Hamootz,MASTER I,44,24.9,329,82,247,eune
332,Eyez On mE,MASTER I,43,18.3,574,105,469,eune
333,ACIDONIN,MASTER I,43,18.9,233,44,189,eune
334,penxuel,MASTER I,42,17.0,394,67,327,eune
335,zyfather,MASTER I,42,13.9,345,48,297,eune
336,BesJhin,MASTER I,42,24.8,121,30,91,eune
337,Wacho,MASTER I,41,19.4,485,94,391,eune
338,kasux,MASTER I,41,26.1,211,55,156,eune
339,wangyinghui,MASTER I,41,23.6,93,22,71,eune
340,SER,MASTER I,40,16.0,363,58,305,eune
341,fortepiańino,MASTER I,40,26.0,146,38,108,eune
342,huanghaitao,MASTER I,40,14.9,141,21,120,eune
343,EDwarDOG,MASTER I,39,20.4,265,54,211,eune
344,AJunii,MASTER I,38,19.9,156,31,125,eune
345,ImmolatePL,MASTER I,37,17.0,412,70,342,eune
346,sowilo,MASTER I,37,13.9,287,40,247,eune
347,lyy0202,MASTER I,37,14.5,227,33,194,eune
348,nibuxiang,MASTER I,37,12.2,147,18,129,eune
349,Høwto1v9,MASTER I,37,10.2,157,16,141,eune
350,linyinyin,MASTER I,35,11.7,477,56,421,eune
351,UbicaHer0 No1,MASTER I,35,15.6,211,33,178,eune
352,playgosha,MASTER I,34,12.8,758,97,661,eune
353,SoJeon,MASTER I,34,8.4,639,54,585,eune
354,Aryasfanboy,MASTER I,34,13.2,357,47,310,eune
355,ST oRO,MASTER I,34,12.3,261,32,229,eune
356,chinajiangliuer,MASTER I,34,23.4,124,29,95,eune
357,petskuthuder,MASTER I,33,16.1,509,82,427,eune
358,liminghui,MASTER I,33,18.3,273,50,223,eune
359,Zsoltikawa,MASTER I,33,11.0,390,43,347,eune
360,justgomidlane,MASTER I,33,11.7,307,36,271,eune
361,wojiu20limi,MASTER I,32,22.0,186,41,145,eune
362,Kubańczy,MASTER I,32,18.4,223,41,182,eune
363,nousernamesleft,MASTER I,31,15.7,287,45,242,eune
364,nikollaje,MASTER I,30,21.1,397,84,313,eune
365,xxN0N4M3xx,MASTER I,30,24.4,238,58,180,eune
366,IchibanEnjo,MASTER I,30,15.2,178,27,151,eune
367,Su6699,MASTER I,29,14.0,236,33,203,eune
368,Marker775,MASTER I,29,15.9,170,27,143,eune
369,Yuu Noya,MASTER I,29,28.0,75,21,54,eune
370,Champzyme,MASTER I,28,17.0,482,82,400,eune
371,Ròot,MASTER I,28,10.2,439,45,394,eune
372,Tsükuyomi,MASTER I,28,13.4,276,37,239,eune
373,PoistMussy,MASTER I,27,22.5,240,54,186,eune
374,Leaguereaper,MASTER I,27,15.8,310,49,261,eune
375,abclulu,MASTER I,27,23.1,130,30,100,eune
376,Thrae,MASTER I,26,23.3,493,115,378,eune
377,mxdzxx,MASTER I,26,17.5,314,55,259,eune
378,SmolFeetTopDif,MASTER I,26,17.6,210,37,173,eune
379,Mr Hops,MASTER I,26,7.6,475,36,439,eune
380,Mikæla,MASTER I,26,22.8,149,34,115,eune
381,uzi1213800,MASTER I,26,31.4,86,27,59,eune
382,FL Baby xQi,MASTER I,26,15.0,180,27,153,eune
383,Th3 Kiling Jok3r,MASTER I,25,18.0,416,75,341,eune
384,fix this bug pls,MASTER I,25,15.4,324,50,274,eune
385,Xilzao,MASTER I,25,19.2,224,43,181,eune
386,Eldhrimr,MASTER I,25,17.0,218,37,181,eune
387,pig8trotters,MASTER I,25,20.1,179,36,143,eune
388,Lord of jugle,MASTER I,25,10.1,286,29,257,eune
389,Mine is Bigger,MASTER I,25,21.9,96,21,75,eune
390,Abed,MASTER I,24,13.6,572,78,494,eune
391,lourio,MASTER I,24,13.8,522,72,450,eune
392,EG Tropical,MASTER I,24,17.3,404,70,334,eune
393,wj111999,MASTER I,24,18.7,332,62,270,eune
394,withboy,MASTER I,24,11.0,508,56,452,eune
395,qwer2e3,MASTER I,24,20.5,185,38,147,eune
396,Jollteon,MASTER I,23,14.8,541,80,461,eune
397,timifater,MASTER I,23,11.4,298,34,264,eune
398,laughinglx,MASTER I,23,16.7,198,33,165,eune
399,UNleash the Fury,MASTER I,23,17.4,149,26,123,eune
400,Achy88,MASTER I,22,14.0,494,69,425,eune
401,shenchao6666,MASTER I,22,25.2,147,37,110,eune
402,Yulicc,MASTER I,22,17.9,173,31,142,eune
403,Houziee,MASTER I,22,20.7,145,30,115,eune
404,Joul,MASTER I,22,13.4,201,27,174,eune
405,zuandiyishangdan,MASTER I,22,19.5,133,26,107,eune
406,Female XD,MASTER I,21,16.0,642,103,539,eune
407,Nyxfire,MASTER I,21,17.4,373,65,308,eune
408,JustÁbro,MASTER I,21,20.8,288,60,228,eune
409,ThinkGlobal,MASTER I,21,15.5,386,60,326,eune
410,one shot shaco,MASTER I,21,16.5,328,54,274,eune
411,Disguised omak,MASTER I,21,16.5,267,44,223,eune
412,Zivotinja,MASTER I,21,14.8,277,41,236,eune
413,MoNtEnEgReEn,MASTER I,21,16.1,242,39,203,eune
414,Dominator17,MASTER I,21,14.3,231,33,198,eune
415,xiaotian1,MASTER I,21,23.5,136,32,104,eune
416,songlinglu,MASTER I,21,27.6,105,29,76,eune
417,ValkyrieSHD,MASTER I,21,15.3,176,27,149,eune
418,BlackCats,MASTER I,20,13.9,517,72,445,eune
419,laiwanwano,MASTER I,20,16.0,412,66,346,eune
420,Stephen Càrry,MASTER I,20,17.6,227,40,187,eune
421,Shean19,MASTER I,19,11.1,570,63,507,eune
422,Mr Freskos,MASTER I,19,14.1,347,49,298,eune
423,Keres Heres,MASTER I,19,10.3,448,46,402,eune
424,maxiaohui,MASTER I,19,15.4,214,33,181,eune
425,K1nGsane,MASTER I,18,28.8,226,65,161,eune
426,wddmw111,MASTER I,18,19.7,228,45,183,eune
427,xiaoshirui,MASTER I,18,22.4,161,36,125,eune
428,vvloveyping,MASTER I,18,24.6,122,30,92,eune
429,jhghgh,MASTER I,18,22.4,125,28,97,eune
430,Hulanka Esport,MASTER I,18,13.0,184,24,160,eune
431,xiaoxuanl,MASTER I,18,19.5,118,23,95,eune
432,xinku1e,MASTER I,17,18.2,181,33,148,eune
433,callmezd,MASTER I,17,15.1,152,23,129,eune
434,Tuken19,MASTER I,16,20.2,198,40,158,eune
435,haonaodan,MASTER I,16,16.9,172,29,143,eune
436,LcS MiRiFiQuE,MASTER I,15,13.2,521,69,452,eune
437,xRaTaTA,MASTER I,15,22.4,236,53,183,eune
438,WildWestCactus,MASTER I,15,10.1,525,53,472,eune
439,dreamslang,MASTER I,15,16.6,205,34,171,eune
440,szTFTko,MASTER I,15,15.6,173,27,146,eune
441,1122334466,MASTER I,15,17.7,147,26,121,eune
442,Archmage,MASTER I,15,29.1,79,23,56,eune
443,VermilIion,MASTER I,14,16.2,234,38,196,eune
444,LuZErTX,MASTER I,14,16.3,129,21,108,eune
445,kunxiang1028,MASTER I,13,20.2,208,42,166,eune
446,Vicvicv,MASTER I,13,33.3,114,38,76,eune
447,douyuaqiu,MASTER I,12,16.8,292,49,243,eune
448,AnubiS Inpu,MASTER I,12,11.7,402,47,355,eune
449,nononoling,MASTER I,12,19.0,126,24,102,eune
450,Poporori,MASTER I,11,12.0,593,71,522,eune
451,Dark of Death,MASTER I,11,17.5,343,60,283,eune
452,Rank1OrDeath,MASTER I,11,14.5,345,50,295,eune
453,Nikumarekko,MASTER I,11,17.9,262,47,215,eune
454,AntiExodia,MASTER I,11,14.9,261,39,222,eune
455,7454088,MASTER I,11,26.9,108,29,79,eune
456,morzers,MASTER I,11,25.5,98,25,73,eune
457,To Mauro Louki,MASTER I,10,12.3,616,76,540,eune
458,hdjehhdjw,MASTER I,10,18.0,233,42,191,eune
459,Erøs,MASTER I,10,17.4,235,41,194,eune
460,suoliyaketong,MASTER I,10,15.8,234,37,197,eune
461,2D over 3D,MASTER I,10,11.8,288,34,254,eune
462,YshenA,MASTER I,10,18.4,158,29,129,eune
463,iPolaczek,MASTER I,10,11.1,190,21,169,eune
464,fuki30,MASTER I,10,10.8,195,21,174,eune
465,Cant Touch Dis,MASTER I,9,17.1,591,101,490,eune
466,suhaidashuaige,MASTER I,9,21.9,379,83,296,eune
467,IasikI,MASTER I,9,18.1,369,67,302,eune
468,Cazamatu,MASTER I,9,16.6,229,38,191,eune
469,Cpt Sonny,MASTER I,9,16.4,214,35,179,eune
470,cff1234,MASTER I,9,16.3,215,35,180,eune
471,LegìtJJ,MASTER I,9,18.1,171,31,140,eune
472,HzTeiry,MASTER I,9,12.3,252,31,221,eune
473,BixLegolas21,MASTER I,9,16.5,121,20,101,eune
474,Torgo Nudho,MASTER I,8,15.4,1133,175,958,eune
475,Trix4Loki,MASTER I,8,14.9,571,85,486,eune
476,Napaljenko,MASTER I,8,16.2,432,70,362,eune
477,NewFlopy,MASTER I,8,11.8,591,70,521,eune
478,Spirit Devilll,MASTER I,8,18.2,263,48,215,eune
479,bibibiubiu,MASTER I,8,13.5,245,33,212,eune
480,zhazhahui,MASTER I,8,20.9,148,31,117,eune
481,kepikarios,MASTER I,8,15.9,157,25,132,eune
482,gladiator3828,MASTER I,7,12.4,787,98,689,eune
483,SoloAlistarOnly,MASTER I,7,13.1,579,76,503,eune
484,nano9B,MASTER I,7,13.3,218,29,189,eune
485,dadal0ng,MASTER I,7,16.2,173,28,145,eune
486,moving300money,MASTER I,7,16.8,143,24,119,eune
487,Keri,MASTER I,6,16.7,492,82,410,eune
488,BobboViking,MASTER I,6,17.8,398,71,327,eune
489,cy9696,MASTER I,6,23.2,142,33,109,eune
490,Starbestol,MASTER I,6,20.2,163,33,130,eune
491,nidebabaOO,MASTER I,5,28.3,184,52,132,eune
492,Cormag,MASTER I,5,21.3,211,45,166,eune
493,My E Doesnt Work,MASTER I,5,15.9,282,45,237,eune
494,zizixixi,MASTER I,5,18.1,237,43,194,eune
495,liushuai2020,MASTER I,5,13.7,291,40,251,eune
496,Axiuww,MASTER I,5,22.6,168,38,130,eune
497,moli1996,MASTER I,5,20.3,172,35,137,eune
498,Hivcii,MASTER I,5,18.5,157,29,128,eune
499,AImiao,MASTER I,5,21.7,115,25,90,eune
500,spasa016,MASTER I,4,19.6,290,57,233,eune
1,Deis1k,CHALLENGER I,1710,21.4,639,137,502,euw
2,Salvyyy,CHALLENGER I,1672,23.8,282,67,215,euw
3,Salvyyy TFT,CHALLENGER I,1645,24.9,382,95,287,euw
4,DarkHighroll,CHALLENGER I,1556,22.8,429,98,331,euw
5,l2yKo,CHALLENGER I,1552,21.8,1241,270,971,euw
6,DarkHydra,CHALLENGER I,1378,21.3,582,124,458,euw
7,SwellerTiger,CHALLENGER I,1327,19.1,387,74,313,euw
8,Gìngg,CHALLENGER I,1322,25.1,327,82,245,euw
9,Leon Trotskij,CHALLENGER I,1269,24.0,338,81,257,euw
10,Voltariusx,CHALLENGER I,1242,18.4,429,79,350,euw
11,GingGG,CHALLENGER I,1232,22.1,742,164,578,euw
12,SwellerTigerTFT,CHALLENGER I,1197,13.2,646,85,561,euw
13,ImSøFresh,CHALLENGER I,1191,17.7,879,156,723,euw
14,Lallana,CHALLENGER I,1179,18.7,369,69,300,euw
15,Hotline ming,CHALLENGER I,1165,16.0,782,125,657,euw
16,Tcejer,CHALLENGER I,1158,21.0,352,74,278,euw
17,Kagerou OwO,CHALLENGER I,1148,21.2,430,91,339,euw
18,fan2Kstagne,CHALLENGER I,1137,22.6,195,44,151,euw
19,Luque,CHALLENGER I,1077,17.4,803,140,663,euw
20,Un33d,CHALLENGER I,1070,17.4,674,117,557,euw
21,Sunny Lu,CHALLENGER I,1030,17.8,951,169,782,euw
22,Qetzer,CHALLENGER I,1025,15.5,670,104,566,euw
23,FluffyHS,CHALLENGER I,1024,17.1,392,67,325,euw
24,Liquid Tabzz,CHALLENGER I,1012,22.0,558,123,435,euw
25,Lipo Razak,CHALLENGER I,1010,16.6,547,91,456,euw
26,Phbl,CHALLENGER I,1007,14.1,679,96,583,euw
27,Voltariux,CHALLENGER I,997,17.3,508,88,420,euw
28,Sologesang,CHALLENGER I,988,14.9,583,87,496,euw
29,Sñus,CHALLENGER I,985,18.6,1185,221,964,euw
30,Pazi4S,CHALLENGER I,961,12.2,484,59,425,euw
31,Wet Jungler,CHALLENGER I,957,15.0,686,103,583,euw
32,Phabal,CHALLENGER I,955,14.3,657,94,563,euw
33,RyKo v2,CHALLENGER I,944,25.5,322,82,240,euw
34,Sbstn TFT,CHALLENGER I,926,14.5,537,78,459,euw
35,BozzBrain v2,CHALLENGER I,896,14.7,340,50,290,euw
36,AceofSpadesITA,CHALLENGER I,886,19.0,348,66,282,euw
37,Lev D Trotskij,CHALLENGER I,872,17.8,517,92,425,euw
38,Deisik,CHALLENGER I,870,18.9,364,69,295,euw
39,BenVK,CHALLENGER I,869,16.3,619,101,518,euw
40,SmileyCereal,CHALLENGER I,856,17.5,1096,192,904,euw
41,Raizuken,CHALLENGER I,856,18.4,370,68,302,euw
42,kassellen,CHALLENGER I,839,13.4,958,128,830,euw
43,sayvallahbru,CHALLENGER I,829,14.7,387,57,330,euw
44,TSM Guillosko,CHALLENGER I,828,15.6,868,135,733,euw
45,Magarky,CHALLENGER I,818,16.3,503,82,421,euw
46,Iunci,CHALLENGER I,817,17.7,215,38,177,euw
47,ahuia,CHALLENGER I,814,20.3,217,44,173,euw
48,ll TFT KEKW ll,CHALLENGER I,804,14.1,432,61,371,euw
49,slime03,CHALLENGER I,803,17.4,535,93,442,euw
50,MogamboDTB,CHALLENGER I,798,12.7,276,35,241,euw
51,TFT ArKoK,CHALLENGER I,793,15.7,889,140,749,euw
52,Zididi,CHALLENGER I,789,15.9,1477,235,1242,euw
53,IBRAHIMOVIĆ777,CHALLENGER I,788,26.1,211,55,156,euw
54,lsochan,CHALLENGER I,787,16.7,281,47,234,euw
55,Monphis,CHALLENGER I,785,16.4,1208,198,1010,euw
56,Sizm,CHALLENGER I,781,19.5,727,142,585,euw
57,outplayingmyself,CHALLENGER I,781,17.4,454,79,375,euw
58,iHG Tuttek,CHALLENGER I,778,16.2,734,119,615,euw
59,BALOTELLI777,CHALLENGER I,777,18.8,522,98,424,euw
60,lucky smile boy,CHALLENGER I,770,15.7,1191,187,1004,euw
61,rare not nice,CHALLENGER I,769,15.5,575,89,486,euw
62,Sparakay TFT,CHALLENGER I,766,15.6,262,41,221,euw
63,PonRoo,CHALLENGER I,761,12.5,1025,128,897,euw
64,RICH H0MIE QUAN,CHALLENGER I,753,15.0,286,43,243,euw
65,Doud78,CHALLENGER I,752,17.9,324,58,266,euw
66,TFT Buttons,CHALLENGER I,744,16.0,581,93,488,euw
67,Bèst Heca EUW,CHALLENGER I,743,17.9,1329,238,1091,euw
68,Just so xi so,CHALLENGER I,738,18.8,313,59,254,euw
69,BeasTFT2,CHALLENGER I,732,19.7,203,40,163,euw
70,Kezman,CHALLENGER I,731,19.7,340,67,273,euw
71,Zyriosly,CHALLENGER I,725,16.7,902,151,751,euw
72,Tits,CHALLENGER I,719,24.3,230,56,174,euw
73,ajoe1231,CHALLENGER I,718,17.5,810,142,668,euw
74,Khristor,CHALLENGER I,716,14.9,397,59,338,euw
75,Lorus,CHALLENGER I,715,9.1,737,67,670,euw
76,RazakTFT,CHALLENGER I,713,15.0,1067,160,907,euw
77,TehSilli,CHALLENGER I,712,19.2,400,77,323,euw
78,JdnTagNovoline,CHALLENGER I,712,20.6,194,40,154,euw
79,Banisher95,CHALLENGER I,711,13.5,488,66,422,euw
80,dknsbs,CHALLENGER I,708,15.9,552,88,464,euw
81,Palaloa,CHALLENGER I,708,16.6,241,40,201,euw
82,Göl D Roger,CHALLENGER I,704,12.7,805,102,703,euw
83,iamTLT,CHALLENGER I,696,12.5,313,39,274,euw
84,Sayorï best girl,CHALLENGER I,695,17.4,242,42,200,euw
85,Palaloa TFT,CHALLENGER I,686,13.0,470,61,409,euw
86,LeDuck TFT,CHALLENGER I,683,17.0,1137,193,944,euw
87,Cachual,CHALLENGER I,679,25.5,216,55,161,euw
88,Can I mock you,CHALLENGER I,679,29.6,135,40,95,euw
89,Freezzette,CHALLENGER I,677,12.1,638,77,561,euw
90,BALOTELLI777 TFT,CHALLENGER I,676,15.9,447,71,376,euw
91,PUNISH1nG,CHALLENGER I,676,18.1,281,51,230,euw
92,o0OLyReO0o,CHALLENGER I,675,20.1,288,58,230,euw
93,Némaïdès,CHALLENGER I,668,14.2,612,87,525,euw
94,TarteMan TFT,CHALLENGER I,667,14.9,455,68,387,euw
95,Xeno TFTx,CHALLENGER I,666,10.3,778,80,698,euw
96,NinjaPavels,CHALLENGER I,662,17.4,299,52,247,euw
97,Rïft,CHALLENGER I,660,16.1,224,36,188,euw
98,Bränk,CHALLENGER I,659,15.8,456,72,384,euw
99,Un11d,CHALLENGER I,657,17.9,340,61,279,euw
100,Suisaiga 2,CHALLENGER I,651,17.3,415,72,343,euw
101,Jedi Master AK,CHALLENGER I,649,16.4,938,154,784,euw
102,Drünkiris,CHALLENGER I,646,19.4,427,83,344,euw
103,5454,CHALLENGER I,645,14.9,510,76,434,euw
104,Gôn Freeçss,CHALLENGER I,645,20.9,273,57,216,euw
105,Itario,CHALLENGER I,645,12.8,446,57,389,euw
106,Vicer v2,CHALLENGER I,644,15.1,304,46,258,euw
107,Waazabii,CHALLENGER I,641,19.9,191,38,153,euw
108,Can I trust you,CHALLENGER I,640,20.1,279,56,223,euw
109,Adonis17,CHALLENGER I,638,16.7,774,129,645,euw
110,Oooouuiiiiiiii,CHALLENGER I,638,16.6,529,88,441,euw
111,OnlyBetter,CHALLENGER I,638,10.0,411,41,370,euw
112,iPoPz v2,CHALLENGER I,637,19.0,210,40,170,euw
113,MCMCinITALY,CHALLENGER I,635,18.6,490,91,399,euw
114,Yanís,CHALLENGER I,635,16.1,409,66,343,euw
115,TFT Enzosexe,CHALLENGER I,629,12.2,878,107,771,euw
116,Doud TFT,CHALLENGER I,629,20.7,232,48,184,euw
117,JedenTagNovoline,CHALLENGER I,626,23.6,191,45,146,euw
118,IceLoom,CHALLENGER I,625,17.8,241,43,198,euw
119,AmuuMuu,CHALLENGER I,623,12.0,1054,127,927,euw
120,Drunkiris,CHALLENGER I,613,19.7,299,59,240,euw
121,LeDuck v2,CHALLENGER I,612,15.4,436,67,369,euw
122,AKA magic,CHALLENGER I,611,12.9,751,97,654,euw
123,BenVK TFT,CHALLENGER I,610,17.1,321,55,266,euw
124,I R INVINC1BLE,CHALLENGER I,608,15.1,735,111,624,euw
125,Kjekken123,CHALLENGER I,606,19.9,508,101,407,euw
126,hyuII,CHALLENGER I,605,16.7,670,112,558,euw
127,Kÿu,CHALLENGER I,604,17.4,403,70,333,euw
128,Zebra TFT,CHALLENGER I,604,17.8,163,29,134,euw
129,always be hape,CHALLENGER I,602,17.5,378,66,312,euw
130,TFTits,CHALLENGER I,601,20.2,178,36,142,euw
131,dirtyspear,CHALLENGER I,598,15.4,481,74,407,euw
132,Ev4ngelion,CHALLENGER I,597,16.4,697,114,583,euw
133,Skiizield,CHALLENGER I,596,13.4,982,132,850,euw
134,Lornyk,CHALLENGER I,596,14.2,911,129,782,euw
135,Subahibi,CHALLENGER I,596,14.8,433,64,369,euw
136,Nutscrackeros,CHALLENGER I,594,15.3,229,35,194,euw
137,kacpersky191TFT,CHALLENGER I,593,14.2,856,122,734,euw
138,idlemonk TFT,CHALLENGER I,593,10.8,617,67,550,euw
139,HASHIDA,CHALLENGER I,592,14.0,722,101,621,euw
140,Bersa TFT,CHALLENGER I,591,15.9,515,82,433,euw
141,KlimA,CHALLENGER I,588,16.1,466,75,391,euw
142,ABEL748,CHALLENGER I,587,12.9,418,54,364,euw
143,Nescro,CHALLENGER I,586,15.7,407,64,343,euw
144,Xerxan,CHALLENGER I,584,15.1,670,101,569,euw
145,Warmeur le vrai,CHALLENGER I,582,22.9,223,51,172,euw
146,LIPO Absykos,CHALLENGER I,581,14.7,401,59,342,euw
147,Racklure,CHALLENGER I,580,14.4,909,131,778,euw
148,zomgowy,CHALLENGER I,578,17.7,232,41,191,euw
149,stayl23,CHALLENGER I,573,13.8,478,66,412,euw
150,męntal,CHALLENGER I,572,13.3,539,72,467,euw
151,hongmorongguang,CHALLENGER I,570,18.2,352,64,288,euw
152,YowiTFT,CHALLENGER I,569,20.3,246,50,196,euw
153,Nyan Zebra,CHALLENGER I,568,16.4,250,41,209,euw
154,NouLTerass,CHALLENGER I,561,16.8,232,39,193,euw
155,TFT Emperador,CHALLENGER I,560,13.3,887,118,769,euw
156,TeemoDaSlayer420,CHALLENGER I,560,20.9,177,37,140,euw
157,gluteus maxímus,CHALLENGER I,558,16.4,385,63,322,euw
158,Liber8 Hong Kong,CHALLENGER I,557,17.5,485,85,400,euw
159,Bersalis,CHALLENGER I,557,15.9,326,52,274,euw
160,Summuner Name,CHALLENGER I,556,19.4,289,56,233,euw
161,Kenopsia,CHALLENGER I,554,10.1,882,89,793,euw
162,VicerTFT,CHALLENGER I,554,15.6,443,69,374,euw
163,Futaken,CHALLENGER I,554,16.7,257,43,214,euw
164,5454XD,CHALLENGER I,552,16.9,544,92,452,euw
165,Zaratuska,CHALLENGER I,552,16.1,448,72,376,euw
166,G2 ReventXz,CHALLENGER I,552,20.8,303,63,240,euw
167,Esel51,CHALLENGER I,549,11.7,386,45,341,euw
168,The Gay Minion,CHALLENGER I,547,13.5,636,86,550,euw
169,Kirbes,CHALLENGER I,545,14.9,435,65,370,euw
170,Miiouw,CHALLENGER I,544,14.4,513,74,439,euw
171,zoomgowy,CHALLENGER I,543,19.4,221,43,178,euw
172,Sløt,CHALLENGER I,541,17.5,315,55,260,euw
173,Whiteyeas,CHALLENGER I,536,14.7,339,50,289,euw
174,YowiTFT2,CHALLENGER I,536,21.0,219,46,173,euw
175,JollyFaker777,CHALLENGER I,534,16.1,355,57,298,euw
176,ziro1997,CHALLENGER I,531,16.7,347,58,289,euw
177,Shσtgun,CHALLENGER I,530,15.6,778,121,657,euw
178,A French Rat,CHALLENGER I,530,15.9,472,75,397,euw
179,At The Gates,CHALLENGER I,529,20.7,300,62,238,euw
180,WINZEEER,CHALLENGER I,527,14.7,721,106,615,euw
181,Whiteyeas2,CHALLENGER I,527,18.2,176,32,144,euw
182,Gunmay,CHALLENGER I,525,9.7,784,76,708,euw
183,R1CH HOM1E QUAN,CHALLENGER I,518,18.1,215,39,176,euw
184,TXK9z,CHALLENGER I,517,13.0,662,86,576,euw
185,iPoPz,CHALLENGER I,513,16.4,549,90,459,euw
186,yooog,CHALLENGER I,511,14.1,547,77,470,euw
187,Lonnen,CHALLENGER I,510,14.0,535,75,460,euw
188,WawaTatata,CHALLENGER I,509,13.7,554,76,478,euw
189,Ougie Boogie,CHALLENGER I,507,12.8,618,79,539,euw
190,birdyrrr,CHALLENGER I,506,18.6,242,45,197,euw
191,FengXiaoQiLing,CHALLENGER I,503,23.0,261,60,201,euw
192,San Jomian,CHALLENGER I,502,13.1,733,96,637,euw
193,Funkfreed,CHALLENGER I,501,16.1,336,54,282,euw
194,Gilozinho,CHALLENGER I,500,13.3,906,121,785,euw
195,EnlèveTesMoufles,CHALLENGER I,498,17.3,294,51,243,euw
196,RaveeOnTFT,CHALLENGER I,497,12.6,547,69,478,euw
197,Riƒt,CHALLENGER I,496,13.3,714,95,619,euw
198,OxygenWhiite,CHALLENGER I,494,15.5,291,45,246,euw
199,Banisher95 TFT,CHALLENGER I,493,12.0,443,53,390,euw
200,PITICHI,CHALLENGER I,491,13.8,1076,149,927,euw
201,Pray to RNG god,CHALLENGER I,491,12.8,296,38,258,euw
202,Wholean,CHALLENGER I,490,12.3,520,64,456,euw
203,bstln2,CHALLENGER I,490,24.3,251,61,190,euw
204,TFTACKK,CHALLENGER I,490,26.2,179,47,132,euw
205,Ranceta,CHALLENGER I,488,11.4,554,63,491,euw
206,DrGreenthumb0,CHALLENGER I,487,13.8,435,60,375,euw
207,Sτοrm,CHALLENGER I,486,14.9,736,110,626,euw
208,SKT Help Me,CHALLENGER I,485,16.4,512,84,428,euw
209,MapleKK,CHALLENGER I,482,19.7,188,37,151,euw
210,diabifleur,CHALLENGER I,480,14.4,596,86,510,euw
211,Sir Bobz,CHALLENGER I,480,10.6,442,47,395,euw
212,Lahar04,CHALLENGER I,479,18.6,215,40,175,euw
213,ShinoPavels,CHALLENGER I,478,17.4,602,105,497,euw
214,dameoiseau,CHALLENGER I,477,12.3,267,33,234,euw
215,LittlePiggyBF,CHALLENGER I,473,12.4,630,78,552,euw
216,TheAware,CHALLENGER I,473,12.7,553,70,483,euw
217,AquareIIe,CHALLENGER I,473,16.9,325,55,270,euw
218,Genotik,CHALLENGER I,472,13.3,465,62,403,euw
219,1puRe Clinton,CHALLENGER I,471,15.2,552,84,468,euw
220,birdy513,CHALLENGER I,468,16.2,678,110,568,euw
221,S6767,CHALLENGER I,468,15.0,654,98,556,euw
222,Lelouuch,CHALLENGER I,468,16.6,313,52,261,euw
223,Sparakay,CHALLENGER I,468,13.9,310,43,267,euw
224,Tschabading,CHALLENGER I,467,13.6,858,117,741,euw
225,UnbornYordle,CHALLENGER I,467,17.8,488,87,401,euw
226,RaveeOn,CHALLENGER I,463,13.2,478,63,415,euw
227,OxygenWhiteTFT,CHALLENGER I,463,25.4,177,45,132,euw
228,KAD Mason,CHALLENGER I,462,16.2,278,45,233,euw
229,Smokesick,CHALLENGER I,461,17.0,294,50,244,euw
230,Suriyargh,CHALLENGER I,458,12.4,1317,164,1153,euw
231,Tatufo,CHALLENGER I,458,13.7,577,79,498,euw
232,Warmeur TFT,CHALLENGER I,458,18.1,359,65,294,euw
233,Rehnz,CHALLENGER I,457,14.7,730,107,623,euw
234,Woaigouge,CHALLENGER I,456,15.6,752,117,635,euw
235,shiromonster000,CHALLENGER I,456,18.2,385,70,315,euw
236,Stonyy v1,CHALLENGER I,454,14.8,535,79,456,euw
237,Maxwellβoltzman,CHALLENGER I,453,17.1,252,43,209,euw
238,AieZen 2,CHALLENGER I,452,10.1,276,28,248,euw
239,TNG Lucy Chan,CHALLENGER I,451,11.2,908,102,806,euw
240,YPRN Chwbk,CHALLENGER I,451,18.2,313,57,256,euw
241,DRLAMER,CHALLENGER I,450,17.8,1179,210,969,euw
242,Sweet Nydre,CHALLENGER I,449,19.4,139,27,112,euw
243,justinng,CHALLENGER I,447,17.6,386,68,318,euw
244,MuttaGanero,CHALLENGER I,446,16.0,451,72,379,euw
245,hi im hochin,CHALLENGER I,446,16.9,314,53,261,euw
246,Maxobido,CHALLENGER I,445,8.2,1333,110,1223,euw
247,Naotan Mid,CHALLENGER I,445,18.3,317,58,259,euw
248,chainpullzEU,CHALLENGER I,445,15.9,170,27,143,euw
249,Sheriff1903,CHALLENGER I,443,11.4,686,78,608,euw
250,Emoktua,CHALLENGER I,442,19.5,457,89,368,euw
251,Alpha Player 2,CHALLENGER I,442,15.7,464,73,391,euw
252,TheUnbornYordle,CHALLENGER I,440,13.3,346,46,300,euw
253,Warmeur,CHALLENGER I,439,16.2,402,65,337,euw
254,DatSharzy,CHALLENGER I,439,14.1,433,61,372,euw
255,Benger923,CHALLENGER I,438,14.2,337,48,289,euw
256,redbyte7GR,CHALLENGER I,438,17.4,259,45,214,euw
257,Snoodyboo,CHALLENGER I,437,14.3,631,90,541,euw
258,BKrisz,CHALLENGER I,437,12.6,642,81,561,euw
259,xXD4rkN412uT0Xx,CHALLENGER I,436,24.8,165,41,124,euw
260,ÃFG,CHALLENGER I,435,10.7,531,57,474,euw
261,Undercoverism,CHALLENGER I,434,15.2,394,60,334,euw
262,Fairy Breeder,CHALLENGER I,433,15.3,476,73,403,euw
263,Douyu4228274,CHALLENGER I,433,16.8,316,53,263,euw
264,Love anime boy,CHALLENGER I,432,14.5,476,69,407,euw
265,Wedra TF,CHALLENGER I,432,18.0,189,34,155,euw
266,WalktheGangplank,CHALLENGER I,429,12.2,302,37,265,euw
267,TwTv T3BY,CHALLENGER I,429,14.8,230,34,196,euw
268,MrKok0,CHALLENGER I,427,11.9,644,77,567,euw
269,IWannaRideMyPyke,CHALLENGER I,427,14.1,283,40,243,euw
270,Strawberry fish,CHALLENGER I,426,19.7,350,69,281,euw
271,Ferra4Fun,CHALLENGER I,425,10.2,1201,122,1079,euw
272,luffy57773,CHALLENGER I,425,14.1,745,105,640,euw
273,IIDyonisosII,CHALLENGER I,425,13.4,538,72,466,euw
274,Mediaboy 2,CHALLENGER I,425,15.7,300,47,253,euw
275,mastameow,CHALLENGER I,424,15.4,299,46,253,euw
276,Nyu Zmurf,CHALLENGER I,424,13.1,337,44,293,euw
277,HagbardSolo,CHALLENGER I,424,20.7,116,24,92,euw
278,simplywojtek tft,CHALLENGER I,423,20.6,213,44,169,euw
279,Paradise For All,CHALLENGER I,422,17.8,382,68,314,euw
280,VAieZen,CHALLENGER I,422,12.1,481,58,423,euw
281,VegaHD,CHALLENGER I,422,12.8,376,48,328,euw
282,TwSS Flash,CHALLENGER I,421,16.7,610,102,508,euw
283,Gelado de Buceta,CHALLENGER I,421,16.3,484,79,405,euw
284,Xarizzz,CHALLENGER I,421,14.1,397,56,341,euw
285,Razayel,CHALLENGER I,419,14.2,451,64,387,euw
286,Rioe,CHALLENGER I,419,16.4,299,49,250,euw
287,Ujo,CHALLENGER I,419,15.5,271,42,229,euw
288,Fofo x jisoo,CHALLENGER I,418,14.9,495,74,421,euw
289,Lowlander,CHALLENGER I,413,15.7,293,46,247,euw
290,spongebob smiley,CHALLENGER I,392,16.7,408,68,340,euw
291,Sirfetchd,CHALLENGER I,388,9.9,293,29,264,euw
292,TarteMan,CHALLENGER I,379,17.8,320,57,263,euw
293,Virfel,CHALLENGER I,372,13.5,875,118,757,euw
294,mixer Alx2020,CHALLENGER I,367,13.9,531,74,457,euw
295,Drazar,CHALLENGER I,344,10.6,767,81,686,euw
296,Tonsof,CHALLENGER I,328,20.2,124,25,99,euw
297,White biubiu,CHALLENGER I,265,18.9,185,35,150,euw
298,DianaEatme,CHALLENGER I,241,12.6,868,109,759,euw
299,0chl0,CHALLENGER I,222,19.9,695,138,557,euw
300,MaCkTFT,CHALLENGER I,208,12.4,1509,188,1321,euw
301,Cry M0re Plz,"GRANDMASTER I
G",503,17.8,647,115,532,euw
302,Le inter masqué,"GRANDMASTER I
G",460,16.3,325,53,272,euw
303,TAKETHEHONKPILL,"GRANDMASTER I
G",451,12.9,481,62,419,euw
304,sun666shine,"GRANDMASTER I
G",437,18.4,336,62,274,euw
305,Cute Crab,"GRANDMASTER I
G",425,15.5,219,34,185,euw
306,Korra HD,"GRANDMASTER I
G",415,26.0,127,33,94,euw
307,YourLifeisMineEU,"GRANDMASTER I
G",413,13.8,1080,149,931,euw
308,Alrevan TFT,"GRANDMASTER I
G",413,12.5,343,43,300,euw
309,Fein7,"GRANDMASTER I
G",412,16.4,816,134,682,euw
310,Smartwings,"GRANDMASTER I
G",410,17.5,685,120,565,euw
311,Lammendam,"GRANDMASTER I
G",410,12.2,540,66,474,euw
312,ZèRô,"GRANDMASTER I
G",409,12.9,734,95,639,euw
313,ahlinswag,"GRANDMASTER I
G",408,15.9,346,55,291,euw
314,Nydre,"GRANDMASTER I
G",407,19.2,172,33,139,euw
315,Nutinut,"GRANDMASTER I
G",404,18.8,1091,205,886,euw
316,Qetzz,"GRANDMASTER I
G",397,22.2,153,34,119,euw
317,Döbereiner,"GRANDMASTER I
G",396,15.8,603,95,508,euw
318,MarooNTFT,"GRANDMASTER I
G",396,18.1,193,35,158,euw
319,dimaar,"GRANDMASTER I
G",394,13.6,619,84,535,euw
320,Dandoo,"GRANDMASTER I
G",390,11.5,401,46,355,euw
321,iLLuuu TFT,"GRANDMASTER I
G",387,13.8,494,68,426,euw
322,KLeMx,"GRANDMASTER I
G",386,17.9,441,79,362,euw
323,TFT Mikkus,"GRANDMASTER I
G",386,11.6,586,68,518,euw
324,Dedicasse Fahd,"GRANDMASTER I
G",385,16.2,594,96,498,euw
325,ttv NevyPT,"GRANDMASTER I
G",378,15.8,380,60,320,euw
326,Archie Stõne,"GRANDMASTER I
G",376,15.2,282,43,239,euw
327,Skipper173,"GRANDMASTER I
G",375,10.3,301,31,270,euw
328,zoro5773,"GRANDMASTER I
G",365,12.9,831,107,724,euw
329,Galoubi,"GRANDMASTER I
G",364,17.3,496,86,410,euw
330,Furriya,"GRANDMASTER I
G",364,16.0,219,35,184,euw
331,Summer Influenza,"GRANDMASTER I
G",360,14.4,459,66,393,euw
332,OnlyEloBoost,"GRANDMASTER I
G",360,20.3,187,38,149,euw
333,Shielded,"GRANDMASTER I
G",359,11.9,595,71,524,euw
334,Marcoyoung4ever,"GRANDMASTER I
G",359,18.8,192,36,156,euw
335,Arestidios,"GRANDMASTER I
G",356,14.5,242,35,207,euw
336,LOLsPresident,"GRANDMASTER I
G",353,19.6,419,82,337,euw
337,Mynameisdodi,"GRANDMASTER I
G",353,9.4,551,52,499,euw
338,HypnoHS,"GRANDMASTER I
G",352,14.9,571,85,486,euw
339,Afase,"GRANDMASTER I
G",349,18.1,210,38,172,euw
340,Torlk,"GRANDMASTER I
G",348,14.3,1087,156,931,euw
341,ShowYourDonger,"GRANDMASTER I
G",348,14.1,306,43,263,euw
342,Billgax,"GRANDMASTER I
G",346,13.6,500,68,432,euw
343,TalexPrime,"GRANDMASTER I
G",345,11.6,1037,120,917,euw
344,KRIMEN,"GRANDMASTER I
G",345,11.0,793,87,706,euw
345,you wont win xd,"GRANDMASTER I
G",345,20.3,143,29,114,euw
346,daveblue3,"GRANDMASTER I
G",344,20.7,261,54,207,euw
347,Scafista,"GRANDMASTER I
G",344,15.8,246,39,207,euw
348,SirLowk,"GRANDMASTER I
G",343,11.8,422,50,372,euw
349,Boguetta,"GRANDMASTER I
G",342,18.5,249,46,203,euw
350,Oririi,"GRANDMASTER I
G",341,8.7,575,50,525,euw
351,TFT IlIIIllIIlIl,"GRANDMASTER I
G",339,22.4,152,34,118,euw
352,swaqt,"GRANDMASTER I
G",337,20.9,320,67,253,euw
353,Tonichoux,"GRANDMASTER I
G",335,20.2,243,49,194,euw
354,Hua Kai Hui Luo,"GRANDMASTER I
G",334,12.6,597,75,522,euw
355,kaiio,"GRANDMASTER I
G",332,12.9,248,32,216,euw
356,Liocardia TFT,"GRANDMASTER I
G",330,27.2,81,22,59,euw
357,Molarck,"GRANDMASTER I
G",326,15.8,317,50,267,euw
358,Ryuk DTB,"GRANDMASTER I
G",325,11.3,664,75,589,euw
359,iAFG,"GRANDMASTER I
G",324,11.3,318,36,282,euw
360,yoqueloque,"GRANDMASTER I
G",323,18.4,245,45,200,euw
361,Ernilol,"GRANDMASTER I
G",321,14.8,223,33,190,euw
362,Elisav,"GRANDMASTER I
G",321,18.4,125,23,102,euw
363,Adastraa,"GRANDMASTER I
G",320,14.8,209,31,178,euw
364,Les collègues,"GRANDMASTER I
G",319,15.7,166,26,140,euw
365,Lost in ur smile,"GRANDMASTER I
G",318,13.6,705,96,609,euw
366,GRIEFER XDDD,"GRANDMASTER I
G",315,19.0,195,37,158,euw
367,HeadButtAlistar,"GRANDMASTER I
G",313,13.1,726,95,631,euw
368,Garen03,"GRANDMASTER I
G",311,12.4,516,64,452,euw
369,Bananana,"GRANDMASTER I
G",310,14.9,697,104,593,euw
370,BKrisz TFT,"GRANDMASTER I
G",310,21.8,119,26,93,euw
371,Le Grand Palmier,"GRANDMASTER I
G",308,14.6,576,84,492,euw
372,lovingmyplant,"GRANDMASTER I
G",307,16.6,229,38,191,euw
373,Danguardians,"GRANDMASTER I
G",307,13.5,282,38,244,euw
374,IamnotTLT,"GRANDMASTER I
G",305,14.4,334,48,286,euw
375,Consistent luck,"GRANDMASTER I
G",304,19.4,206,40,166,euw
376,Liocardia,"GRANDMASTER I
G",301,20.7,116,24,92,euw
377,sklzzkt,"GRANDMASTER I
G",300,14.8,366,54,312,euw
378,Bren0,"GRANDMASTER I
G",297,18.4,185,34,151,euw
379,Zyríos,"GRANDMASTER I
G",296,14.1,455,64,391,euw
380,Magnificent Feta,"GRANDMASTER I
G",295,14.3,300,43,257,euw
381,Sit Sit,"GRANDMASTER I
G",295,15.9,145,23,122,euw
382,amneLOL,"GRANDMASTER I
G",291,12.7,442,56,386,euw
383,TaKK TFT,"GRANDMASTER I
G",289,14.7,531,78,453,euw
384,vickytchii,"GRANDMASTER I
G",288,10.3,971,100,871,euw
385,Gryffus01,"GRANDMASTER I
G",288,12.8,533,68,465,euw
386,aristocrat,"GRANDMASTER I
G",288,16.7,270,45,225,euw
387,OOF MACHINE,"GRANDMASTER I
G",288,20.4,206,42,164,euw
388,Dinomies,"GRANDMASTER I
G",284,12.5,736,92,644,euw
389,barryflashxxxxx,"GRANDMASTER I
G",284,22.8,241,55,186,euw
390,Lux al 7,"GRANDMASTER I
G",281,13.2,347,46,301,euw
391,PAISTI,"GRANDMASTER I
G",280,11.8,861,102,759,euw
392,ChiIlman,"GRANDMASTER I
G",279,17.3,179,31,148,euw
393,Jeon Soyeon,"GRANDMASTER I
G",277,12.9,548,71,477,euw
394,Tâp Quên Ði,"GRANDMASTER I
G",277,17.5,251,44,207,euw
395,Picikutyus192,"GRANDMASTER I
G",277,16.7,168,28,140,euw
396,Higa,"GRANDMASTER I
G",276,17.2,528,91,437,euw
397,Towati,"GRANDMASTER I
G",275,13.6,638,87,551,euw
398,Êxii,"GRANDMASTER I
G",275,14.8,453,67,386,euw
399,JollyFaker,"GRANDMASTER I
G",274,14.9,475,71,404,euw
400,1027,"GRANDMASTER I
G",273,16.3,282,46,236,euw
401,ninthie,"GRANDMASTER I
G",270,17.8,326,58,268,euw
402,Azershiit,"GRANDMASTER I
G",268,9.5,461,44,417,euw
403,Hynan,"GRANDMASTER I
G",267,15.9,673,107,566,euw
404,Pure B1ue,"GRANDMASTER I
G",267,14.1,377,53,324,euw
405,N3m3s1X,"GRANDMASTER I
G",265,14.1,623,88,535,euw
406,TheLudensEkko,"GRANDMASTER I
G",265,14.6,260,38,222,euw
407,castoro alfa,"GRANDMASTER I
G",265,16.6,199,33,166,euw
408,YxmEU,"GRANDMASTER I
G",264,18.5,157,29,128,euw
409,FollowYourShadow,"GRANDMASTER I
G",263,14.3,984,141,843,euw
410,Morcovell,"GRANDMASTER I
G",263,15.8,468,74,394,euw
411,Kizhh,"GRANDMASTER I
G",263,17.1,234,40,194,euw
412,Rhow,"GRANDMASTER I
G",261,16.6,319,53,266,euw
413,FearTorgun,"GRANDMASTER I
G",261,16.2,240,39,201,euw
414,MALODORAN,"GRANDMASTER I
G",260,12.8,383,49,334,euw
415,SachenPro,"GRANDMASTER I
G",260,11.9,261,31,230,euw
416,TwoBiers TFT,"GRANDMASTER I
G",259,15.4,371,57,314,euw
417,N3m3s1XSmrf,"GRANDMASTER I
G",259,21.1,190,40,150,euw
418,grLdIbkqhU,"GRANDMASTER I
G",259,19.3,181,35,146,euw
419,irrelevant RoIe,"GRANDMASTER I
G",257,18.1,271,49,222,euw
420,YuukiSamuse,"GRANDMASTER I
G",257,20.5,161,33,128,euw
421,Chepe Santacruz,"GRANDMASTER I
G",256,13.5,334,45,289,euw
422,TheInvinc1ble,"GRANDMASTER I
G",255,12.8,319,41,278,euw
423,DevilDream II,"GRANDMASTER I
G",254,15.3,275,42,233,euw
424,XINGXXLXX,"GRANDMASTER I
G",252,12.2,443,54,389,euw
425,Zwingel,"GRANDMASTER I
G",251,12.5,561,70,491,euw
426,Valijn,"GRANDMASTER I
G",251,16.9,302,51,251,euw
427,LeBoisCaBrule,"GRANDMASTER I
G",251,16.5,218,36,182,euw
428,Dalesom,"GRANDMASTER I
G",250,16.8,304,51,253,euw
429,TheFray,"GRANDMASTER I
G",248,16.0,888,142,746,euw
430,BeasTFT,"GRANDMASTER I
G",248,14.6,378,55,323,euw
431,ThisChampIsHard,"GRANDMASTER I
G",247,14.4,326,47,279,euw
432,Enclase,"GRANDMASTER I
G",246,14.4,571,82,489,euw
433,Grassouil,"GRANDMASTER I
G",246,16.8,368,62,306,euw
434,Greed bld,"GRANDMASTER I
G",246,14.4,354,51,303,euw
435,kEizy,"GRANDMASTER I
G",246,17.0,270,46,224,euw
436,SkunkZzy,"GRANDMASTER I
G",245,12.1,1503,182,1321,euw
437,bat les yeuks,"GRANDMASTER I
G",244,21.6,102,22,80,euw
438,BP Kim Jisoo,"GRANDMASTER I
G",244,16.7,108,18,90,euw
439,naphara,"GRANDMASTER I
G",243,14.7,259,38,221,euw
440,Iriiick,"GRANDMASTER I
G",243,16.3,227,37,190,euw
441,OniiiiChan,"GRANDMASTER I
G",242,18.8,511,96,415,euw
442,Kemal1337,"GRANDMASTER I
G",241,10.4,924,96,828,euw
443,Laeta8,"GRANDMASTER I
G",241,15.2,368,56,312,euw
444,The Dedj,"GRANDMASTER I
G",240,12.4,338,42,296,euw
445,Bibia Be Ye Ye,"GRANDMASTER I
G",240,30.4,69,21,48,euw
446,Always top 8 TFT,"GRANDMASTER I
G",239,15.8,507,80,427,euw
447,El Tomdill,"GRANDMASTER I
G",239,14.8,534,79,455,euw
448,Baneworth,"GRANDMASTER I
G",239,16.4,353,58,295,euw
449,LLL Sneaky,"GRANDMASTER I
G",238,16.8,357,60,297,euw
450,Hi im One Piece,"GRANDMASTER I
G",238,15.0,379,57,322,euw
451,Asyfrost,"GRANDMASTER I
G",238,23.4,154,36,118,euw
452,GameTFT,"GRANDMASTER I
G",236,15.8,328,52,276,euw
453,Billie Jimmy,"GRANDMASTER I
G",235,18.0,538,97,441,euw
454,robinnou the god,"GRANDMASTER I
G",235,17.7,475,84,391,euw
455,Seksy,"GRANDMASTER I
G",235,21.1,227,48,179,euw
456,etre infame,"GRANDMASTER I
G",234,11.9,514,61,453,euw
457,fukushimax,"GRANDMASTER I
G",233,16.1,603,97,506,euw
458,Enimos,"GRANDMASTER I
G",233,16.0,524,84,440,euw
459,Bobby666666,"GRANDMASTER I
G",233,14.0,464,65,399,euw
460,LACT,"GRANDMASTER I
G",233,20.9,153,32,121,euw
461,Kÿu v2,"GRANDMASTER I
G",233,20.6,126,26,100,euw
462,Diderot Le Croco,"GRANDMASTER I
G",232,15.3,248,38,210,euw
463,Lariano813,"GRANDMASTER I
G",232,14.8,236,35,201,euw
464,Long Ð,"GRANDMASTER I
G",230,13.4,389,52,337,euw
465,Chelito91,"GRANDMASTER I
G",229,14.1,488,69,419,euw
466,ShishiAnnie,"GRANDMASTER I
G",227,18.9,238,45,193,euw
467,Kalflo,"GRANDMASTER I
G",226,12.4,1199,149,1050,euw
468,perfect sinner,"GRANDMASTER I
G",226,16.3,667,109,558,euw
469,DestructorXD,"GRANDMASTER I
G",225,15.0,320,48,272,euw
470,trècool,"GRANDMASTER I
G",224,13.5,801,108,693,euw
471,Turtlelicious,"GRANDMASTER I
G",224,11.3,787,89,698,euw
472,Roboante,"GRANDMASTER I
G",224,18.4,206,38,168,euw
473,crapchiTFT,"GRANDMASTER I
G",223,18.0,294,53,241,euw
474,o OSi o,"GRANDMASTER I
G",222,16.6,512,85,427,euw
475,XilaxamBoy,"GRANDMASTER I
G",220,22.1,167,37,130,euw
476,ShishiAnnie Two,"GRANDMASTER I
G",220,17.7,192,34,158,euw
477,Momor Vig,"GRANDMASTER I
G",219,12.7,764,97,667,euw
478,Red Tuxedo,"GRANDMASTER I
G",218,14.6,534,78,456,euw
479,Jigejiuwo,"GRANDMASTER I
G",218,13.4,396,53,343,euw
480,Havarianlolz,"GRANDMASTER I
G",218,20.0,185,37,148,euw
481,Crvor,"GRANDMASTER I
G",217,14.8,663,98,565,euw
482,C6 Ghost,"GRANDMASTER I
G",217,13.3,646,86,560,euw
483,clearlove6,"GRANDMASTER I
G",217,16.8,416,70,346,euw
484,Feint TFT,"GRANDMASTER I
G",217,25.3,83,21,62,euw
485,Bobobätr,"GRANDMASTER I
G",215,14.2,449,64,385,euw
486,Specter BS,"GRANDMASTER I
G",215,10.5,353,37,316,euw
487,Italian Urg0d,"GRANDMASTER I
G",214,16.6,511,85,426,euw
488,RiiKKz,"GRANDMASTER I
G",213,15.3,907,139,768,euw
489,ThatCrit,"GRANDMASTER I
G",212,14.1,262,37,225,euw
490,Xarly1498,"GRANDMASTER I
G",211,13.5,757,102,655,euw
491,Mn Gaenvan,"GRANDMASTER I
G",211,15.3,222,34,188,euw
492,TOUNEJAI,"GRANDMASTER I
G",209,19.9,317,63,254,euw
493,StinkPuh,"GRANDMASTER I
G",209,16.7,281,47,234,euw
494,VESIPETO,"GRANDMASTER I
G",207,14.3,418,60,358,euw
495,Kìrby,"GRANDMASTER I
G",207,16.7,251,42,209,euw
496,AR4B,"GRANDMASTER I
G",206,13.5,453,61,392,euw
497,xJPB,"GRANDMASTER I
G",206,16.9,348,59,289,euw
498,Udji,"GRANDMASTER I
G",205,15.5,566,88,478,euw
499,Badwòman,"GRANDMASTER I
G",204,16.1,460,74,386,euw
500,523666,"GRANDMASTER I
G",204,8.5,659,56,603,euw
1,Hiraino,CHALLENGER I,714,22.1,439,97,342,jp
2,KKQ,CHALLENGER I,652,21.2,334,71,263,jp
3,HiROKKtft,CHALLENGER I,584,19.6,311,61,250,jp
4,思い出の昼下がり,CHALLENGER I,544,26.3,209,55,154,jp
5,hakutou,CHALLENGER I,522,23.9,665,159,506,jp
6,dayona,CHALLENGER I,494,17.6,1113,196,917,jp
7,Best 佐藤 JP,CHALLENGER I,479,24.2,244,59,185,jp
8,chocotto,CHALLENGER I,471,21.5,465,100,365,jp
9,煩いマン,CHALLENGER I,450,18.0,233,42,191,jp
10,じーく,CHALLENGER I,446,19.0,326,62,264,jp
11,Best太郎JP,CHALLENGER I,433,21.9,329,72,257,jp
12,むむっ,CHALLENGER I,429,22.3,314,70,244,jp
13,Age 21,CHALLENGER I,414,22.7,198,45,153,jp
14,シャドウバース,CHALLENGER I,407,18.9,628,119,509,jp
15,害獣あらいぐま,CHALLENGER I,392,13.2,409,54,355,jp
16,Shroud Fanboy,CHALLENGER I,387,15.8,1084,171,913,jp
17,ひまわり準決勝,CHALLENGER I,372,24.9,193,48,145,jp
18,kes,CHALLENGER I,341,19.3,368,71,297,jp
19,trotv,CHALLENGER I,327,15.7,515,81,434,jp
20,ajun,CHALLENGER I,323,17.8,737,131,606,jp
21,God Fukuoka,CHALLENGER I,312,19.5,364,71,293,jp
22,ap top mom die,CHALLENGER I,270,23.6,229,54,175,jp
23,rionest,CHALLENGER I,267,17.5,992,174,818,jp
24,etsuya0505,CHALLENGER I,263,16.6,559,93,466,jp
25,えっっ,CHALLENGER I,257,17.9,207,37,170,jp
26,Tぽいんと,CHALLENGER I,249,21.6,278,60,218,jp
27,Adrenaline,CHALLENGER I,237,18.8,500,94,406,jp
28,dozepk,CHALLENGER I,227,15.2,440,67,373,jp
29,Piyochan76,CHALLENGER I,222,16.5,260,43,217,jp
30,大門未知子,CHALLENGER I,220,18.8,192,36,156,jp
31,かふす,CHALLENGER I,196,18.4,761,140,621,jp
32,りーり,CHALLENGER I,180,12.9,967,125,842,jp
33,さとるくん,CHALLENGER I,171,11.2,445,50,395,jp
34,sueno09,CHALLENGER I,165,13.8,283,39,244,jp
35,お前のレベル笑,CHALLENGER I,162,21.0,381,80,301,jp
36,ぼんちょび,CHALLENGER I,149,27.6,152,42,110,jp
37,ますにゃ,CHALLENGER I,146,13.6,691,94,597,jp
38,秋水宴,CHALLENGER I,144,16.1,267,43,224,jp
39,喚くマン,CHALLENGER I,143,18.1,421,76,345,jp
40,まくらi,CHALLENGER I,136,22.8,123,28,95,jp
41,Worst Takashi JP,CHALLENGER I,130,13.2,432,57,375,jp
42,loraplayer,CHALLENGER I,123,17.4,809,141,668,jp
43,KR blonde lov,CHALLENGER I,119,21.4,210,45,165,jp
44,nagatoevol,CHALLENGER I,117,17.2,378,65,313,jp
45,xtc,CHALLENGER I,115,18.1,430,78,352,jp
46,Hechima777,CHALLENGER I,114,14.7,672,99,573,jp
47,pureheart player,CHALLENGER I,108,16.7,336,56,280,jp
48,山田周人,CHALLENGER I,106,16.4,464,76,388,jp
49,Count Mak,CHALLENGER I,105,20.0,435,87,348,jp
50,Bad Takahashi,CHALLENGER I,0,19.0,195,37,158,jp
51,賃砲丸出侍,"GRANDMASTER I
G",157,23.6,212,50,162,jp
52,kotogane411,"GRANDMASTER I
G",103,18.1,199,36,163,jp
53,FoT DazzingDog,"GRANDMASTER I
G",102,21.3,272,58,214,jp
54,Jackn,"GRANDMASTER I
G",99,21.1,208,44,164,jp
55,しかめまどか2,"GRANDMASTER I
G",92,23.7,215,51,164,jp
56,mikan0x0,"GRANDMASTER I
G",87,12.4,716,89,627,jp
57,Yaruo,"GRANDMASTER I
G",82,16.8,280,47,233,jp
58,しかめまどか,"GRANDMASTER I
G",80,14.7,1198,176,1022,jp
59,Sukizofureni,"GRANDMASTER I
G",80,13.4,543,73,470,jp
60,モルディ貝,"GRANDMASTER I
G",80,15.9,314,50,264,jp
61,elfiny,"GRANDMASTER I
G",78,18.1,166,30,136,jp
62,URUUUU,"GRANDMASTER I
G",72,20.0,444,89,355,jp
63,Waterfox,"GRANDMASTER I
G",69,13.1,297,39,258,jp
64,karakuti,"GRANDMASTER I
G",56,20.2,208,42,166,jp
65,ekollon,"GRANDMASTER I
G",53,18.0,422,76,346,jp
66,Ponty,"GRANDMASTER I
G",44,15.6,777,121,656,jp
67,ぽんぽん桂,"GRANDMASTER I
G",38,16.2,563,91,472,jp
68,Twisted Fate Bot,"GRANDMASTER I
G",37,16.5,339,56,283,jp
69,hohe,"GRANDMASTER I
G",36,16.4,617,101,516,jp
70,ロルから逃げるな,"GRANDMASTER I
G",36,19.6,163,32,131,jp
71,にじむら,"GRANDMASTER I
G",33,12.7,686,87,599,jp
72,pveman,"GRANDMASTER I
G",30,17.9,302,54,248,jp
73,nijimuraact2,"GRANDMASTER I
G",28,15.4,428,66,362,jp
74,bappy,"GRANDMASTER I
G",26,18.1,781,141,640,jp
75,ポッチャマ,"GRANDMASTER I
G",26,11.9,318,38,280,jp
76,Raias,"GRANDMASTER I
G",25,16.3,522,85,437,jp
77,おしっこちゃん,"GRANDMASTER I
G",23,11.9,622,74,548,jp
78,名取ざや,"GRANDMASTER I
G",23,23.6,229,54,175,jp
79,マグロマート,"GRANDMASTER I
G",23,19.4,144,28,116,jp
80,Satolis,"GRANDMASTER I
G",22,10.1,424,43,381,jp
81,沼の大破神,"GRANDMASTER I
G",21,19.3,259,50,209,jp
82,millepiedi,"GRANDMASTER I
G",21,14.0,272,38,234,jp
83,ZmLFs2z,"GRANDMASTER I
G",21,21.8,156,34,122,jp
84,pccc,"GRANDMASTER I
G",21,31.1,90,28,62,jp
85,たなってぃ,"GRANDMASTER I
G",17,16.8,434,73,361,jp
86,いけなる,"GRANDMASTER I
G",16,17.6,723,127,596,jp
87,曖昧心,"GRANDMASTER I
G",16,14.7,238,35,203,jp
88,夜空丶,"GRANDMASTER I
G",15,19.6,189,37,152,jp
89,丸の内LOLレイナ,"GRANDMASTER I
G",13,16.1,429,69,360,jp
90,MELODY FLAG,"GRANDMASTER I
G",13,20.2,193,39,154,jp
91,contrail,"GRANDMASTER I
G",13,18.4,147,27,120,jp
92,Why So Serious,"GRANDMASTER I
G",11,14.8,311,46,265,jp
93,えんどほーぷ,"GRANDMASTER I
G",10,8.7,583,51,532,jp
94,夏目純夏,"GRANDMASTER I
G",7,25.1,167,42,125,jp
95,dozeqk,"GRANDMASTER I
G",6,18.5,200,37,163,jp
96,macro11,"GRANDMASTER I
G",5,16.3,282,46,236,jp
97,にぶさき,"GRANDMASTER I
G",3,15.3,965,148,817,jp
98,ぬこ丸,"GRANDMASTER I
G",1,18.7,476,89,387,jp
99,Ugokeru Debu Bot,"GRANDMASTER I
G",1,16.2,222,36,186,jp
100,7zigeN,"GRANDMASTER I
G",0,17.7,1001,177,824,jp
101,bonchobi,"GRANDMASTER I
G",0,14.6,458,67,391,jp
102,GoodMannerU5,"GRANDMASTER I
G",0,14.1,439,62,377,jp
103,だよな,"GRANDMASTER I
G",0,20.5,161,33,128,jp
104,クックパッド歩美,"GRANDMASTER I
G",0,21.1,147,31,116,jp
105,ゲッティスパ美,"GRANDMASTER I
G",0,18.4,163,30,133,jp
106,dngr,MASTER I,24,16.3,264,43,221,jp
107,じょん炊いたー,MASTER I,20,21.6,306,66,240,jp
108,ぜろななにーいち,MASTER I,1,22.1,167,37,130,jp
109,CosplayGirl,MASTER I,0,23.7,224,53,171,jp
110,日高愛,DIAMOND I,96,15.5,420,65,355,jp
111,Eidechse,DIAMOND I,91,16.4,220,36,184,jp
112,foxbaby123b,DIAMOND I,87,13.5,503,68,435,jp
113,shuraha3,DIAMOND I,87,16.3,380,62,318,jp
114,副頭取,DIAMOND I,86,13.7,212,29,183,jp
115,るきにゃん,DIAMOND I,85,17.2,459,79,380,jp
116,ゆっちー,DIAMOND I,76,11.9,362,43,319,jp
117,askrp,DIAMOND I,75,17.0,569,97,472,jp
118,lalabybyby,DIAMOND I,75,15.6,461,72,389,jp
119,XionNoi,DIAMOND I,75,18.5,384,71,313,jp
120,misomega,DIAMOND I,75,15.9,402,64,338,jp
121,MichaelChan,DIAMOND I,75,17.7,317,56,261,jp
122,てっくてっく,DIAMOND I,75,19.0,273,52,221,jp
123,ききちま,DIAMOND I,75,18.2,285,52,233,jp
124,福山はさまるJP,DIAMOND I,75,16.3,307,50,257,jp
125,ABEKANZOU,DIAMOND I,75,19.5,210,41,169,jp
126,ButaDaJoe,DIAMOND I,75,19.5,190,37,153,jp
127,ヨンジン,DIAMOND I,75,9.4,373,35,338,jp
128,スルギすき,DIAMOND I,75,16.7,204,34,170,jp
129,オーシャン増永,DIAMOND I,75,18.8,176,33,143,jp
130,tola,DIAMOND I,75,14.3,230,33,197,jp
131,濃厚鶏白湯拉麺,DIAMOND I,75,17.3,156,27,129,jp
132,IKUTOMIE,DIAMOND I,75,11.4,228,26,202,jp
133,AikaS,DIAMOND I,74,16.3,728,119,609,jp
134,いまのん,DIAMOND I,71,17.9,352,63,289,jp
135,くりちゃん大好き,DIAMOND I,69,21.4,159,34,125,jp
136,HitujiDaJoe,DIAMOND I,63,16.4,195,32,163,jp
137,Hermes0,DIAMOND I,60,16.5,722,119,603,jp
138,1515225,DIAMOND I,59,14.9,376,56,320,jp
139,汝何着品如衣,DIAMOND I,57,16.1,230,37,193,jp
140,low roller,DIAMOND I,52,18.3,175,32,143,jp
141,tomonar1,DIAMOND I,51,14.2,379,54,325,jp
142,vvvvvvvvvipp,DIAMOND I,44,17.8,527,94,433,jp
143,ぽこくま,DIAMOND I,42,18.8,138,26,112,jp
144,koogie,DIAMOND I,39,14.3,343,49,294,jp
145,Premium Malt,DIAMOND I,38,13.4,672,90,582,jp
146,Sungoi,DIAMOND I,37,15.8,221,35,186,jp
147,εOnOз,DIAMOND I,37,18.8,138,26,112,jp
148,shinano,DIAMOND I,36,16.0,156,25,131,jp
149,エミュー,DIAMOND I,35,14.5,448,65,383,jp
150,ぴにゃぴっぴ,DIAMOND I,32,15.4,350,54,296,jp
151,Kuririman,DIAMOND I,31,14.7,265,39,226,jp
152,Jethro Cyrus,DIAMOND I,29,14.0,586,82,504,jp
153,shuraha4,DIAMOND I,27,13.5,303,41,262,jp
154,halkeye,DIAMOND I,25,14.2,600,85,515,jp
155,orange7premium,DIAMOND I,25,17.1,461,79,382,jp
156,スタフィー,DIAMOND I,25,23.8,172,41,131,jp
157,世界詞のキア,DIAMOND I,24,16.7,126,21,105,jp
158,srinm,DIAMOND I,21,16.7,442,74,368,jp
159,うるるる,DIAMOND I,21,21.2,137,29,108,jp
160,NewmetaTrollking,DIAMOND I,19,12.6,374,47,327,jp
161,IlllIlllIlllI,DIAMOND I,18,20.3,177,36,141,jp
162,ばーじん,DIAMOND I,17,15.2,816,124,692,jp
163,キャンディ  猫,DIAMOND I,17,19.8,172,34,138,jp
164,Remixi,DIAMOND I,17,11.8,195,23,172,jp
165,neetneo,DIAMOND I,16,20.9,210,44,166,jp
166,ダンボ君,DIAMOND I,11,17.4,161,28,133,jp
167,snatcher,DIAMOND I,6,14.9,529,79,450,jp
168,VTAKU77,DIAMOND I,6,12.5,120,15,105,jp
169,InventusGaming,DIAMOND I,5,10.6,350,37,313,jp
170,福山はさまるNA,DIAMOND I,5,19.7,147,29,118,jp
171,watchhhhhh,DIAMOND I,3,18.7,150,28,122,jp
172,Rhino Cider,DIAMOND I,3,12.5,192,24,168,jp
173,ジャジャラ,DIAMOND I,2,16.8,184,31,153,jp
174,Sakurakouji Luna,DIAMOND I,2,20.6,126,26,100,jp
175,Asdgum,DIAMOND I,1,15.0,360,54,306,jp
176,ShiitakeForest,DIAMOND I,1,14.0,236,33,203,jp
177,はんえつか,DIAMOND I,1,16.8,185,31,154,jp
178,Gafu,DIAMOND I,0,13.6,802,109,693,jp
179,gacchapin20,DIAMOND I,0,13.4,649,87,562,jp
180,Kyoutle,DIAMOND I,0,12.7,659,84,575,jp
181,NAGATSUNE,DIAMOND I,0,14.6,556,81,475,jp
182,pano,DIAMOND I,0,17.0,448,76,372,jp
183,Shield Samba,DIAMOND I,0,13.3,481,64,417,jp
184,アイルー卿,DIAMOND I,0,15.1,364,55,309,jp
185,Endcyclone,DIAMOND I,0,27.8,144,40,104,jp
186,laser501,DIAMOND I,0,16.4,237,39,198,jp
187,siva fes,DIAMOND I,0,12.5,279,35,244,jp
188,yatsuhashi567,DIAMOND I,0,13.5,251,34,217,jp
189,下了88,DIAMOND I,0,27.6,116,32,84,jp
190,toudoriDX2,DIAMOND I,0,9.9,302,30,272,jp
191,nasyoter,DIAMOND I,0,15.1,139,21,118,jp
192,チャイコフスキー,DIAMOND II,96,14.1,1028,145,883,jp
193,newie,DIAMOND II,94,15.5,328,51,277,jp
194,Caplico,DIAMOND II,94,17.6,244,43,201,jp
195,AHIKJDK,DIAMOND II,92,27.2,103,28,75,jp
196,Nochita,DIAMOND II,89,12.2,262,32,230,jp
197,UnpokoKenshi,DIAMOND II,83,17.8,230,41,189,jp
198,キイロイトリ3,DIAMOND II,80,13.3,255,34,221,jp
199,醤ØuØ油,DIAMOND II,79,14.0,822,115,707,jp
200,うーきち TFT,DIAMOND II,75,18.6,585,109,476,jp
201,korekoreTFT,DIAMOND II,75,14.0,712,100,612,jp
202,えんぢょ,DIAMOND II,75,18.2,422,77,345,jp
203,Y0m02,DIAMOND II,75,14.1,509,72,437,jp
204,所念皆星河,DIAMOND II,75,18.7,315,59,256,jp
205,やんやんこ,DIAMOND II,75,13.1,435,57,378,jp
206,young4u,DIAMOND II,75,16.6,314,52,262,jp
207,マヨヒガ,DIAMOND II,75,11.1,458,51,407,jp
208,kamiEli,DIAMOND II,75,14.8,337,50,287,jp
209,7Silky7,DIAMOND II,75,13.2,356,47,309,jp
210,HUSSEY8810,DIAMOND II,75,13.1,314,41,273,jp
211,くりちゃんTFT,DIAMOND II,75,19.5,200,39,161,jp
212,檸檬堂,DIAMOND II,75,16.0,244,39,205,jp
213,ヨダルラーハ,DIAMOND II,75,20.0,170,34,136,jp
214,ウーノ,DIAMOND II,75,14.8,229,34,195,jp
215,Kaboom,DIAMOND II,75,22.4,85,19,66,jp
216,涼風あおば,DIAMOND II,75,19.8,96,19,77,jp
217,びっとこ女子,DIAMOND II,72,13.7,526,72,454,jp
218,admin testuser01,DIAMOND II,69,14.6,817,119,698,jp
219,おやすみの翁,DIAMOND II,69,17.0,135,23,112,jp
220,Religious丶,DIAMOND II,68,17.9,308,55,253,jp
221,超天才,DIAMOND II,67,16.9,308,52,256,jp
222,きゅんきゅん,DIAMOND II,64,14.8,420,62,358,jp
223,HaRpooN,DIAMOND II,61,15.1,523,79,444,jp
224,tinko irelia,DIAMOND II,60,16.4,238,39,199,jp
225,ciple753,DIAMOND II,60,12.7,300,38,262,jp
226,center8128,DIAMOND II,60,14.6,171,25,146,jp
227,うぃぐ,DIAMOND II,56,11.0,236,26,210,jp
228,山下美月,DIAMOND II,54,26.7,105,28,77,jp
229,hrs,DIAMOND II,53,19.1,303,58,245,jp
230,huairenzhushou,DIAMOND II,50,17.2,481,83,398,jp
231,Enter Hallownest,DIAMOND II,50,16.0,231,37,194,jp
232,Makorli,DIAMOND II,45,10.6,226,24,202,jp
233,梧 桐,DIAMOND II,44,14.4,923,133,790,jp
234,彼氏の顔ぽっぴー,DIAMOND II,44,13.5,155,21,134,jp
235,yayo84,DIAMOND II,43,21.9,128,28,100,jp
236,嘘柱 誇張しのぶ,DIAMOND II,42,16.2,191,31,160,jp
237,ZEITAKU man,DIAMOND II,42,22.5,111,25,86,jp
238,Cyzo,DIAMOND II,41,12.4,564,70,494,jp
239,I DO RAMMUS JUNG,DIAMOND II,40,16.2,321,52,269,jp
240,Pattol,DIAMOND II,40,18.7,246,46,200,jp
241,Hirobumi,DIAMOND II,38,20.1,189,38,151,jp
242,enamel,DIAMOND II,37,9.5,337,32,305,jp
243,おふめたであそぼ,DIAMOND II,36,12.5,144,18,126,jp
244,ミュート,DIAMOND II,35,13.8,297,41,256,jp
245,doxxo,DIAMOND II,34,11.5,253,29,224,jp
246,Stea 2,DIAMOND II,33,11.3,124,14,110,jp
247,axela,DIAMOND II,32,12.4,177,22,155,jp
248,みすどでぶ,DIAMOND II,28,13.0,192,25,167,jp
249,犬走椛,DIAMOND II,27,20.4,93,19,74,jp
250,初心者kyo,DIAMOND II,26,11.0,264,29,235,jp
251,西新井,DIAMOND II,26,15.6,167,26,141,jp
252,ゲレクシス,DIAMOND II,26,18.5,130,24,106,jp
253,黑島沙和i,DIAMOND II,25,29.0,324,94,230,jp
254,akitosoya,DIAMOND II,25,14.0,493,69,424,jp
255,mcscrubjr,DIAMOND II,25,16.2,277,45,232,jp
256,にんふ,DIAMOND II,25,16.3,252,41,211,jp
257,detteiusyousa,DIAMOND II,25,11.7,205,24,181,jp
258,菲桑家大魔王,DIAMOND II,23,21.4,281,60,221,jp
259,仕事がきらいです,DIAMOND II,23,14.2,239,34,205,jp
260,TenderBalls,DIAMOND II,22,16.5,218,36,182,jp
261,靴職人,DIAMOND II,21,13.6,513,70,443,jp
262,biubiu,DIAMOND II,19,18.0,372,67,305,jp
263,墨 眉,DIAMOND II,19,14.6,288,42,246,jp
264,NT plz,DIAMOND II,18,13.6,339,46,293,jp
265,ふうニキ,DIAMOND II,17,11.4,518,59,459,jp
266,ランダムそうち,DIAMOND II,16,12.7,669,85,584,jp
267,xKurosx,DIAMOND II,16,16.5,412,68,344,jp
268,yurarara11,DIAMOND II,15,20.6,489,101,388,jp
269,戦ナ占学竜忍詩機,DIAMOND II,15,7.7,718,55,663,jp
270,Giáo Án Top8 TFT,DIAMOND II,13,20.4,275,56,219,jp
271,Syutya,DIAMOND II,12,14.8,650,96,554,jp
272,thewrongman123,DIAMOND II,10,15.8,322,51,271,jp
273,Rin09,DIAMOND II,10,14.5,186,27,159,jp
274,ーAkiraー,DIAMOND II,9,13.7,364,50,314,jp
275,askrq,DIAMOND II,9,23.4,154,36,118,jp
276,メンタルがよわい,DIAMOND II,7,22.1,104,23,81,jp
277,プレデター村上,DIAMOND II,1,12.0,416,50,366,jp
278,とっき,DIAMOND II,0,16.7,797,133,664,jp
279,ZEINIKU man,DIAMOND II,0,15.9,627,100,527,jp
280,acaria,DIAMOND II,0,23.5,298,70,228,jp
281,エトペペ,DIAMOND II,0,21.9,310,68,242,jp
282,ぽこた,DIAMOND II,0,18.6,349,65,284,jp
283,ぐくぐくぐく,DIAMOND II,0,13.1,495,65,430,jp
284,理解のある彼くん,DIAMOND II,0,15.6,405,63,342,jp
285,蟹さん,DIAMOND II,0,11.7,437,51,386,jp
286,onamasu,DIAMOND II,0,12.3,348,43,305,jp
287,花園めい,DIAMOND II,0,14.2,296,42,254,jp
288,Eclairr,DIAMOND II,0,16.9,236,40,196,jp
289,whiteliot99,DIAMOND II,0,13.7,293,40,253,jp
290,ni ma su ra,DIAMOND II,0,16.0,243,39,204,jp
291,whiteposs,DIAMOND II,0,10.1,377,38,339,jp
292,imymind,DIAMOND II,0,15.3,229,35,194,jp
293,Drosophila,DIAMOND II,0,16.2,210,34,176,jp
294,Hide on the bush,DIAMOND II,0,12.1,281,34,247,jp
295,このばかちんがぁ,DIAMOND II,0,14.7,224,33,191,jp
296,新ふうちゃん,DIAMOND II,0,14.1,234,33,201,jp
297,SanteSante,DIAMOND II,0,12.1,257,31,226,jp
298,えりぽよ,DIAMOND II,0,11.4,264,30,234,jp
299,Angel di maria,DIAMOND II,0,18.8,149,28,121,jp
300,ARAM専,DIAMOND II,0,16.4,165,27,138,jp
301,お下劣大百科,DIAMOND II,0,17.2,128,22,106,jp
302,ezmk3,DIAMOND II,0,11.1,171,19,152,jp
303,GrystalVirgin,DIAMOND III,98,23.0,100,23,77,jp
304,インターネット,DIAMOND III,93,17.0,147,25,122,jp
305,492601,DIAMOND III,84,18.8,192,36,156,jp
306,しろてぃー,DIAMOND III,82,8.9,699,62,637,jp
307,Stea 0,DIAMOND III,81,12.7,456,58,398,jp
308,RankedBot,DIAMOND III,79,15.0,507,76,431,jp
309,エアは空気,DIAMOND III,77,15.0,412,62,350,jp
310,hpppz,DIAMOND III,75,17.5,663,116,547,jp
311,AquaAura,DIAMOND III,75,19.2,365,70,295,jp
312,KICKbach,DIAMOND III,75,12.8,521,67,454,jp
313,ふるつぼ,DIAMOND III,75,17.8,332,59,273,jp
314,海口江流儿,DIAMOND III,75,22.4,245,55,190,jp
315,此方より彼方まで,DIAMOND III,75,16.2,277,45,232,jp
316,Shinj,DIAMOND III,75,13.0,316,41,275,jp
317,nentou,DIAMOND III,75,16.1,242,39,203,jp
318,nO1v1On,DIAMOND III,75,16.2,234,38,196,jp
319,Yelin2,DIAMOND III,75,22.3,139,31,108,jp
320,斬帝少女アカメ,DIAMOND III,75,14.3,217,31,186,jp
321,ironman2,DIAMOND III,75,14.3,217,31,186,jp
322,止まらないオルガ,DIAMOND III,75,44.3,61,27,34,jp
323,zaiga,DIAMOND III,75,23.2,99,23,76,jp
324,きんたマン,DIAMOND III,75,12.4,185,23,162,jp
325,約束された終末,DIAMOND III,75,26.9,78,21,57,jp
326,たし蟹ｗ,DIAMOND III,75,16.8,119,20,99,jp
327,yukiguniflower,DIAMOND III,70,16.2,148,24,124,jp
328,aind712,DIAMOND III,69,18.2,181,33,148,jp
329,iZukama,DIAMOND III,67,12.0,610,73,537,jp
330,tomosuna,DIAMOND III,65,12.2,205,25,180,jp
331,satohige,DIAMOND III,64,16.5,466,77,389,jp
332,giver,DIAMOND III,63,16.2,247,40,207,jp
333,SUPERSALT,DIAMOND III,59,15.8,476,75,401,jp
334,GUNKATANAMAN,DIAMOND III,57,14.9,228,34,194,jp
335,彩月のあ,DIAMOND III,56,15.2,627,95,532,jp
336,MABARIKO,DIAMOND III,56,16.6,501,83,418,jp
337,yayo841,DIAMOND III,56,12.1,273,33,240,jp
338,ymkd,DIAMOND III,56,16.0,200,32,168,jp
339,バロンドール中村,DIAMOND III,55,10.1,750,76,674,jp
340,りいの,DIAMOND III,55,16.6,385,64,321,jp
341,Raitora,DIAMOND III,52,14.8,271,40,231,jp
342,forever18,DIAMOND III,51,16.1,348,56,292,jp
343,じゃこちゃん,DIAMOND III,51,14.2,261,37,224,jp
344,Pon2,DIAMOND III,47,15.2,453,69,384,jp
345,Monster Box 20段,DIAMOND III,47,18.5,275,51,224,jp
346,新参者X,DIAMOND III,45,21.5,246,53,193,jp
347,roku123,DIAMOND III,44,16.7,402,67,335,jp
348,Best 三毛猫 jp,DIAMOND III,44,11.4,262,30,232,jp
349,Lyth,DIAMOND III,43,17.5,143,25,118,jp
350,百年後,DIAMOND III,42,12.1,365,44,321,jp
351,度し難い,DIAMOND III,40,14.3,621,89,532,jp
352,keropu,DIAMOND III,40,11.7,428,50,378,jp
353,ravennnnnnnnnnnn,DIAMOND III,39,11.9,513,61,452,jp
354,ぐれい,DIAMOND III,38,12.9,652,84,568,jp
355,電磁抜刀 禍,DIAMOND III,38,13.8,188,26,162,jp
356,otomo,DIAMOND III,38,17.7,124,22,102,jp
357,ええんやで,DIAMOND III,36,12.1,265,32,233,jp
358,cøcø,DIAMOND III,34,13.6,631,86,545,jp
359,Beige,DIAMOND III,33,12.5,337,42,295,jp
360,sack dance,DIAMOND III,32,10.5,968,102,866,jp
361,kumeseniii,DIAMOND III,32,15.3,378,58,320,jp
362,Wuju Senshi,DIAMOND III,31,13.8,434,60,374,jp
363,HibeInBush,DIAMOND III,31,16.0,338,54,284,jp
364,かろかん,DIAMOND III,31,22.6,62,14,48,jp
365,Lotus Q,DIAMOND III,30,12.3,316,39,277,jp
366,Calimero,DIAMOND III,30,15.4,208,32,176,jp
367,期間限定公開18禁,DIAMOND III,30,18.8,154,29,125,jp
368,priyome,DIAMOND III,29,13.7,205,28,177,jp
369,アイス,DIAMOND III,29,28.8,80,23,57,jp
370,れおすぴ,DIAMOND III,28,16.5,406,67,339,jp
371,titekubo,DIAMOND III,28,13.8,400,55,345,jp
372,kimi1211,DIAMOND III,28,12.2,435,53,382,jp
373,北条加蓮,DIAMOND III,28,10.9,239,26,213,jp
374,ohayou vn,DIAMOND III,27,13.6,626,85,541,jp
375,ahegaomj,DIAMOND III,27,16.4,183,30,153,jp
376,Best 井上 JP,DIAMOND III,27,12.2,188,23,165,jp
377,Sknow,DIAMOND III,26,13.0,437,57,380,jp
378,五十音ことは,DIAMOND III,26,15.4,240,37,203,jp
379,mari,DIAMOND III,25,24.7,235,58,177,jp
380,summertimer,DIAMOND III,25,15.8,309,49,260,jp
381,空は高く風は歌え,DIAMOND III,25,23.1,173,40,133,jp
382,理科一類,DIAMOND III,25,21.6,185,40,145,jp
383,kuma81,DIAMOND III,25,11.1,314,35,279,jp
384,Rudel,DIAMOND III,25,23.3,146,34,112,jp
385,Mixiffy,DIAMOND III,25,19.2,99,19,80,jp
386,ウーフ,DIAMOND III,25,23.9,67,16,51,jp
387,Piwxn9,DIAMOND III,25,12.8,125,16,109,jp
388,鳥取で一番強い男,DIAMOND III,24,12.9,365,47,318,jp
389,Rolling,DIAMOND III,24,16.9,183,31,152,jp
390,SteelyRaww,DIAMOND III,23,15.7,464,73,391,jp
391,遥シオン,DIAMOND III,23,21.4,289,62,227,jp
392,tikpen,DIAMOND III,22,16.0,412,66,346,jp
393,unenyon,DIAMOND III,22,13.6,324,44,280,jp
394,ばねちゃんねる,DIAMOND III,22,20.1,214,43,171,jp
395,Veyr Soryr,DIAMOND III,21,16.2,142,23,119,jp
396,ていちん,DIAMOND III,20,15.9,516,82,434,jp
397,hahachay,DIAMOND III,20,13.0,585,76,509,jp
398,setuna,DIAMOND III,18,12.8,374,48,326,jp
399,がいこくじんです,DIAMOND III,18,12.6,350,44,306,jp
400,oni5roshi,DIAMOND III,18,16.6,217,36,181,jp
401,Furry White,DIAMOND III,18,18.8,96,18,78,jp
402,M700LTR,DIAMOND III,17,14.3,237,34,203,jp
403,へぶお,DIAMOND III,17,20.5,117,24,93,jp
404,ひもさまだぞ,DIAMOND III,17,28.6,77,22,55,jp
405,だいごちゃん,DIAMOND III,16,14.8,330,49,281,jp
406,Habibi Top,DIAMOND III,15,17.2,238,41,197,jp
407,SoNor,DIAMOND III,15,10.2,382,39,343,jp
408,TFTgirl,DIAMOND III,15,15.7,223,35,188,jp
409,PogoMix,DIAMOND III,15,13.8,188,26,162,jp
410,Orgap,DIAMOND III,14,9.6,293,28,265,jp
411,kasuteraman,DIAMOND III,12,10.7,961,103,858,jp
412,くうしか,DIAMOND III,11,13.4,701,94,607,jp
413,Hiromu3,DIAMOND III,11,11.6,475,55,420,jp
414,OHA,DIAMOND III,11,16.1,161,26,135,jp
415,あでみん,DIAMOND III,9,12.0,301,36,265,jp
416,Leaaaaaaaaaaaaaa,DIAMOND III,8,15.8,310,49,261,jp
417,dai1,DIAMOND III,5,15.6,700,109,591,jp
418,LegalH1gh,DIAMOND III,5,14.8,432,64,368,jp
419,germger,DIAMOND III,5,18.7,262,49,213,jp
420,shabtyu,DIAMOND III,5,16.5,249,41,208,jp
421,yuuchao815,DIAMOND III,5,10.9,238,26,212,jp
422,紅葉Maple,DIAMOND III,5,15.0,140,21,119,jp
423,やりサーのボッチ,DIAMOND III,4,13.7,524,72,452,jp
424,三好と松永,DIAMOND III,4,25.5,102,26,76,jp
425,Shiromine,DIAMOND III,4,19.2,130,25,105,jp
426,森七菜,DIAMOND III,3,18.6,602,112,490,jp
427,氷球弾,DIAMOND III,2,22.3,206,46,160,jp
428,もりぴー,DIAMOND III,2,15.6,294,46,248,jp
429,MapleStory2,DIAMOND III,2,12.4,266,33,233,jp
430,もめちん,DIAMOND III,1,10.9,484,53,431,jp
431,robeen,DIAMOND III,0,14.3,544,78,466,jp
432,鈴木汚拓,DIAMOND III,0,12.2,600,73,527,jp
433,真島ヒロ,DIAMOND III,0,13.0,501,65,436,jp
434,AD VietNamese,DIAMOND III,0,13.8,465,64,401,jp
435,ゼファー,DIAMOND III,0,15.8,367,58,309,jp
436,nossou,DIAMOND III,0,15.6,358,56,302,jp
437,下ネタは嫌いです,DIAMOND III,0,19.1,277,53,224,jp
438,Kimura,DIAMOND III,0,11.9,444,53,391,jp
439,でーもんまみ,DIAMOND III,0,17.7,288,51,237,jp
440,CV斎藤千和,DIAMOND III,0,12.9,386,50,336,jp
441,イキ杉愛苦朗,DIAMOND III,0,16.3,276,45,231,jp
442,ジーコ,DIAMOND III,0,15.5,278,43,235,jp
443,コグマウ,DIAMOND III,0,15.7,267,42,225,jp
444,yanemint,DIAMOND III,0,12.5,295,37,258,jp
445,独 尊,DIAMOND III,0,14.2,219,31,188,jp
446,プンプン打つな,DIAMOND III,0,18.5,162,30,132,jp
447,kaede614,DIAMOND III,0,11.8,220,26,194,jp
448,わたなべ,DIAMOND III,0,12.4,186,23,163,jp
449,ももりんちょ,DIAMOND III,0,18.3,115,21,94,jp
450,Kak4rotto,DIAMOND III,0,18.4,98,18,80,jp
451,moitapchoi1,DIAMOND III,0,8.0,212,17,195,jp
452,cnmWDNMD,DIAMOND IV,98,21.1,312,66,246,jp
453,要糖嘛,DIAMOND IV,96,15.2,223,34,189,jp
454,OffBeat,DIAMOND IV,95,14.7,326,48,278,jp
455,がねたろ,DIAMOND IV,94,12.3,326,40,286,jp
456,bbegg1nnerr,DIAMOND IV,93,16.6,541,90,451,jp
457,oilyoshi,DIAMOND IV,91,18.6,441,82,359,jp
458,bonkuraman,DIAMOND IV,88,12.8,359,46,313,jp
459,Mintchan,DIAMOND IV,88,16.8,131,22,109,jp
460,Ashrin,DIAMOND IV,88,13.5,163,22,141,jp
461,supelaw,DIAMOND IV,87,10.6,643,68,575,jp
462,もしもボックス,DIAMOND IV,87,15.1,239,36,203,jp
463,Gifted,DIAMOND IV,87,14.5,235,34,201,jp
464,Barotte1,DIAMOND IV,87,15.2,210,32,178,jp
465,お酒は二十歳になってから,DIAMOND IV,87,32.9,70,23,47,jp
466,REGRETSHE,DIAMOND IV,84,17.3,515,89,426,jp
467,七秒の記憶,DIAMOND IV,82,12.0,234,28,206,jp
468,lll LanPa lll,DIAMOND IV,80,12.6,382,48,334,jp
469,天下り常習者,DIAMOND IV,80,16.2,142,23,119,jp
470,TAKO888,DIAMOND IV,78,10.5,478,50,428,jp
471,じぇいわい,DIAMOND IV,77,16.5,297,49,248,jp
472,ふうせんネコ,DIAMOND IV,77,15.5,219,34,185,jp
473,On Your Left,DIAMOND IV,75,14.6,584,85,499,jp
474,yorolium,DIAMOND IV,75,16.0,488,78,410,jp
475,我我我能c,DIAMOND IV,75,19.1,329,63,266,jp
476,Ryona,DIAMOND IV,75,11.7,520,61,459,jp
477,林檎盛り,DIAMOND IV,75,11.4,533,61,472,jp
478,RaineSound,DIAMOND IV,75,19.4,283,55,228,jp
479,AZYC,DIAMOND IV,75,21.8,225,49,176,jp
480,銀色赤底の実,DIAMOND IV,75,14.0,350,49,301,jp
481,tyataro,DIAMOND IV,75,10.7,438,47,391,jp
482,theend100,DIAMOND IV,75,11.3,388,44,344,jp
483,やなせ TKS,DIAMOND IV,75,16.3,263,43,220,jp
484,ハジラミ,DIAMOND IV,75,14.6,288,42,246,jp
485,Father Christmas,DIAMOND IV,75,16.9,243,41,202,jp
486,チンChinn充電,DIAMOND IV,75,15.9,232,37,195,jp
487,wsb,DIAMOND IV,75,14.1,262,37,225,jp
488,四月は君のウソだ,DIAMOND IV,75,15.1,239,36,203,jp
489,lllIIllIIlllII,DIAMOND IV,75,14.6,246,36,210,jp
490,小太り中年大貫,DIAMOND IV,75,20.6,165,34,131,jp
491,hachi64,DIAMOND IV,75,12.4,274,34,240,jp
492,Inagibukit,DIAMOND IV,75,11.4,299,34,265,jp
493,かどまめかし,DIAMOND IV,75,17.9,168,30,138,jp
494,アングリーチキン,DIAMOND IV,75,17.8,169,30,139,jp
495,hinekura,DIAMOND IV,75,14.8,189,28,161,jp
496,Fraternity,DIAMOND IV,75,14.3,195,28,167,jp
497,horoTFT,DIAMOND IV,75,10.0,269,27,242,jp
498,たまごのこまた,DIAMOND IV,75,14.5,179,26,153,jp
499,6456tft,DIAMOND IV,75,35.7,70,25,45,jp
500,E Z P Zzz,DIAMOND IV,75,19.7,127,25,102,jp
1,AFTV 꼴픽이,CHALLENGER I,1685,19.2,1014,195,819,kr
2,곰과제리2,CHALLENGER I,1627,20.2,312,63,249,kr
3,김린Or남친,CHALLENGER I,1503,18.0,890,160,730,kr
4,정동글2,CHALLENGER I,1452,18.6,327,61,266,kr
5,정동글,CHALLENGER I,1408,17.8,594,106,488,kr
6,노마딕,CHALLENGER I,1341,17.6,636,112,524,kr
7,홀애비2,CHALLENGER I,1326,18.8,1002,188,814,kr
8,스트롱뽀송뽀송,CHALLENGER I,1297,15.0,947,142,805,kr
9,퐈피는잘못없어,CHALLENGER I,1265,17.5,1180,207,973,kr
10,럭키체스777,CHALLENGER I,1225,13.6,676,92,584,kr
11,AFTV 웃바,CHALLENGER I,1205,18.1,573,104,469,kr
12,펠새로이,CHALLENGER I,1201,18.1,733,133,600,kr
13,galaxy monster,CHALLENGER I,1183,12.8,507,65,442,kr
14,난몰라,CHALLENGER I,1173,17.4,424,74,350,kr
15,체주미,CHALLENGER I,1168,17.7,305,54,251,kr
16,곰과제리,CHALLENGER I,1167,18.0,820,148,672,kr
17,청정민,CHALLENGER I,1153,14.3,1296,185,1111,kr
18,shungjinsoo2,CHALLENGER I,1141,16.8,457,77,380,kr
19,아기용1,CHALLENGER I,1135,19.9,1615,321,1294,kr
20,포식자원툴,CHALLENGER I,1135,15.5,933,145,788,kr
21,shungjinsoo,CHALLENGER I,1134,17.8,881,157,724,kr
22,SanChess,CHALLENGER I,1130,17.2,564,97,467,kr
23,알레 델리,CHALLENGER I,1125,22.9,279,64,215,kr
24,알맹승지,CHALLENGER I,1120,11.8,593,70,523,kr
25,BAAMM,CHALLENGER I,1103,18.9,1262,238,1024,kr
26,두니주니,CHALLENGER I,1080,18.4,1302,239,1063,kr
27,Cherryon,CHALLENGER I,1063,15.3,894,137,757,kr
28,TZ 제리,CHALLENGER I,1050,14.7,605,89,516,kr
29,바삭한빵,CHALLENGER I,1047,18.3,447,82,365,kr
30,피노키훈,CHALLENGER I,1045,18.4,815,150,665,kr
31,기도메타777,CHALLENGER I,1042,13.6,331,45,286,kr
32,화살 세례,CHALLENGER I,1034,16.9,691,117,574,kr
33,깽 만,CHALLENGER I,1033,13.2,823,109,714,kr
34,Park Eunbin,CHALLENGER I,1032,17.2,464,80,384,kr
35,왜 나만 운없냐,CHALLENGER I,1032,18.0,344,62,282,kr
36,Alle Deli,CHALLENGER I,1020,14.5,484,70,414,kr
37,곰과제리3,CHALLENGER I,1018,16.1,391,63,328,kr
38,마스터 3,CHALLENGER I,1013,10.5,847,89,758,kr
39,My Paradise,CHALLENGER I,1007,23.4,745,174,571,kr
40,머리한입꼬리한입,CHALLENGER I,1004,16.4,1015,167,848,kr
41,종자잇,CHALLENGER I,967,16.1,404,65,339,kr
42,축 꾸,CHALLENGER I,943,18.2,825,150,675,kr
43,랑조췻,CHALLENGER I,927,11.7,1441,168,1273,kr
44,카시장인 삿카시,CHALLENGER I,926,14.8,425,63,362,kr
45,Fiora TOP,CHALLENGER I,922,12.4,628,78,550,kr
46,IIIlllIIIlllII,CHALLENGER I,921,11.3,1321,150,1171,kr
47,정동기리,CHALLENGER I,920,17.7,299,53,246,kr
48,끓인사발면,CHALLENGER I,911,19.7,375,74,301,kr
49,패트롤원툴,CHALLENGER I,895,17.2,640,110,530,kr
50,prexis,CHALLENGER I,892,11.0,1062,117,945,kr
51,현이야아아,CHALLENGER I,888,13.1,817,107,710,kr
52,궁뎅크니,CHALLENGER I,887,14.8,694,103,591,kr
53,패트롤원툴2,CHALLENGER I,872,15.0,687,103,584,kr
54,Gritor,CHALLENGER I,870,16.2,1265,205,1060,kr
55,사랑해꿀아,CHALLENGER I,861,15.2,574,87,487,kr
56,김유Or,CHALLENGER I,853,16.6,464,77,387,kr
57,안산시청,CHALLENGER I,845,17.2,534,92,442,kr
58,hiimg4nmi,CHALLENGER I,844,15.0,802,120,682,kr
59,안 졍,CHALLENGER I,844,16.9,356,60,296,kr
60,꽃피그,CHALLENGER I,842,18.4,282,52,230,kr
61,안지영,CHALLENGER I,841,18.3,339,62,277,kr
62,롤체고오수,CHALLENGER I,833,17.1,234,40,194,kr
63,푸딩턱털낼름낼름,CHALLENGER I,832,19.6,322,63,259,kr
64,펠 다,CHALLENGER I,830,23.6,399,94,305,kr
65,로자이어,CHALLENGER I,824,12.7,683,87,596,kr
66,꼴픽이 Youtube,CHALLENGER I,817,21.8,179,39,140,kr
67,킨드레드블루그린,CHALLENGER I,812,17.2,785,135,650,kr
68,천득 Youtube,CHALLENGER I,812,16.3,404,66,338,kr
69,보이지않는기물,CHALLENGER I,810,18.6,472,88,384,kr
70,15조현지,CHALLENGER I,807,22.1,303,67,236,kr
71,끓인사발면2,CHALLENGER I,807,24.2,211,51,160,kr
72,woiwoer12,CHALLENGER I,806,16.1,953,153,800,kr
73,TFT 너밤,CHALLENGER I,806,18.6,479,89,390,kr
74,귀여운나르자나,CHALLENGER I,799,22.6,618,140,478,kr
75,최killing,CHALLENGER I,798,12.2,704,86,618,kr
76,지하닝2,CHALLENGER I,794,19.6,607,119,488,kr
77,버그활용법,CHALLENGER I,785,26.1,280,73,207,kr
78,lxry,CHALLENGER I,784,14.1,220,31,189,kr
79,TFT Xion,CHALLENGER I,783,13.8,1129,156,973,kr
80,찬란하고찬란하게,CHALLENGER I,779,12.4,1107,137,970,kr
81,개 북,CHALLENGER I,777,18.1,415,75,340,kr
82,Eunso,CHALLENGER I,770,14.9,1019,152,867,kr
83,그레이스바라기,CHALLENGER I,766,14.6,302,44,258,kr
84,내가더사기얍,CHALLENGER I,764,15.8,512,81,431,kr
85,바위게줍기장인,CHALLENGER I,763,15.2,874,133,741,kr
86,Younna,CHALLENGER I,759,21.2,184,39,145,kr
87,원도깨비,CHALLENGER I,757,14.7,504,74,430,kr
88,챌린저라닉변함,CHALLENGER I,752,11.6,869,101,768,kr
89,Dosu,CHALLENGER I,752,14.3,279,40,239,kr
90,미어캣군,CHALLENGER I,744,13.4,417,56,361,kr
91,TZ 제리쌤,CHALLENGER I,744,16.0,293,47,246,kr
92,Everton FAN,CHALLENGER I,744,11.4,360,41,319,kr
93,옴팡이,CHALLENGER I,741,19.7,1485,292,1193,kr
94,종범1,CHALLENGER I,740,17.9,246,44,202,kr
95,Keane Tft,CHALLENGER I,740,20.0,185,37,148,kr
96,초보끼리합시다,CHALLENGER I,733,14.2,758,108,650,kr
97,Mongri,CHALLENGER I,732,16.4,1336,219,1117,kr
98,AFTV로얄,CHALLENGER I,731,12.2,1077,131,946,kr
99,빅머니장사장,CHALLENGER I,731,17.9,441,79,362,kr
100,고유나,CHALLENGER I,731,16.4,420,69,351,kr
101,90972114del,CHALLENGER I,729,16.0,1008,161,847,kr
102,귀여운쫑이자나,CHALLENGER I,727,15.9,815,130,685,kr
103,천 득,CHALLENGER I,727,14.1,411,58,353,kr
104,전설의소라고동,CHALLENGER I,724,15.4,746,115,631,kr
105,코스모TV,CHALLENGER I,711,17.2,681,117,564,kr
106,시루시루해,CHALLENGER I,708,15.9,686,109,577,kr
107,Pnaz,CHALLENGER I,695,29.7,222,66,156,kr
108,Why do I live,CHALLENGER I,694,17.0,576,98,478,kr
109,줘 너,CHALLENGER I,692,13.4,1045,140,905,kr
110,체스보이민다빈,CHALLENGER I,690,17.2,1304,224,1080,kr
111,possible,CHALLENGER I,677,15.9,527,84,443,kr
112,사회관,CHALLENGER I,676,12.7,951,121,830,kr
113,알맹승지2,CHALLENGER I,674,10.1,467,47,420,kr
114,포포도쓰,CHALLENGER I,673,14.3,813,116,697,kr
115,잉꾸잉꾸잉꾸,CHALLENGER I,673,15.3,680,104,576,kr
116,TZ 코그멍,CHALLENGER I,671,16.8,423,71,352,kr
117,아갈머리를콰악,CHALLENGER I,671,22.7,203,46,157,kr
118,Blanker,CHALLENGER I,667,17.5,770,135,635,kr
119,WE CAN WlN,CHALLENGER I,666,17.3,537,93,444,kr
120,오면 딴다,CHALLENGER I,663,13.5,786,106,680,kr
121,조치타치,CHALLENGER I,663,10.5,791,83,708,kr
122,k1moddi,CHALLENGER I,659,18.3,213,39,174,kr
123,김음주,CHALLENGER I,657,14.1,767,108,659,kr
124,우디르디르,CHALLENGER I,653,15.1,649,98,551,kr
125,혹시그거아냐,CHALLENGER I,651,14.0,385,54,331,kr
126,앗 추워,CHALLENGER I,647,15.0,731,110,621,kr
127,참새년,CHALLENGER I,645,13.9,546,76,470,kr
128,이Or름,CHALLENGER I,641,11.5,975,112,863,kr
129,Roik,CHALLENGER I,637,28.2,131,37,94,kr
130,곽예림,CHALLENGER I,634,12.3,950,117,833,kr
131,남자는코멧,CHALLENGER I,634,13.1,389,51,338,kr
132,오지마요제발,CHALLENGER I,633,11.5,992,114,878,kr
133,대위 리정혁,CHALLENGER I,632,14.5,605,88,517,kr
134,삐진범,CHALLENGER I,631,14.9,242,36,206,kr
135,AFTV 구루루,CHALLENGER I,630,14.8,1279,190,1089,kr
136,last40ne,CHALLENGER I,630,19.1,141,27,114,kr
137,FateGrand5rder,CHALLENGER I,629,9.2,1128,104,1024,kr
138,엠브로돈까스,CHALLENGER I,628,18.0,1486,267,1219,kr
139,조치타칫쿵칫타,CHALLENGER I,627,9.7,403,39,364,kr
140,AFTV 깔창부린,CHALLENGER I,624,16.2,1756,285,1471,kr
141,유후a,CHALLENGER I,624,17.1,592,101,491,kr
142,탑하겠습니다,CHALLENGER I,624,17.8,359,64,295,kr
143,카리조마,CHALLENGER I,623,17.7,513,91,422,kr
144,게므론,CHALLENGER I,622,9.7,924,90,834,kr
145,YunHyeonSik,CHALLENGER I,618,12.6,364,46,318,kr
146,똥꼬에펜타킬,CHALLENGER I,618,11.4,404,46,358,kr
147,시즌2대한민국1등,CHALLENGER I,616,15.6,527,82,445,kr
148,2000 11 12,CHALLENGER I,616,17.7,282,50,232,kr
149,욕한번채금한번,CHALLENGER I,615,19.4,663,129,534,kr
150,치약소년,CHALLENGER I,613,15.5,251,39,212,kr
151,정밍호짱짱걸,CHALLENGER I,609,13.9,981,136,845,kr
152,EMP 모구,CHALLENGER I,609,15.8,438,69,369,kr
153,Trust me only,CHALLENGER I,608,11.1,470,52,418,kr
154,proooa,CHALLENGER I,607,16.4,513,84,429,kr
155,지니쁘미,CHALLENGER I,607,15.9,271,43,228,kr
156,Art DrucKer,CHALLENGER I,606,14.5,691,100,591,kr
157,불꽃자잇 사생팬,CHALLENGER I,602,14.6,397,58,339,kr
158,멍청아린,CHALLENGER I,601,14.1,580,82,498,kr
159,대깨포식자,CHALLENGER I,601,13.6,447,61,386,kr
160,혹혹훅훅훅,CHALLENGER I,601,13.1,321,42,279,kr
161,베가알쓰리짱,CHALLENGER I,598,13.6,660,90,570,kr
162,illililillili,CHALLENGER I,594,22.3,139,31,108,kr
163,세번째차인달삼,CHALLENGER I,593,17.4,910,158,752,kr
164,초식판다,CHALLENGER I,592,13.1,880,115,765,kr
165,길막장인,CHALLENGER I,592,18.0,412,74,338,kr
166,정 찰 돼,CHALLENGER I,591,12.2,433,53,380,kr
167,깡 백,CHALLENGER I,590,17.3,573,99,474,kr
168,어런이222,CHALLENGER I,590,13.9,653,91,562,kr
169,미소왕,CHALLENGER I,590,13.8,630,87,543,kr
170,땅콩달콤,CHALLENGER I,590,15.3,504,77,427,kr
171,주나식,CHALLENGER I,590,17.3,243,42,201,kr
172,Dpr live A,CHALLENGER I,589,14.8,176,26,150,kr
173,뱅 탁,CHALLENGER I,586,12.3,496,61,435,kr
174,쓰레쉬핵초고수,CHALLENGER I,585,14.7,795,117,678,kr
175,이딴겜해주지마,CHALLENGER I,585,38.6,119,46,73,kr
176,AF HappyVirus,CHALLENGER I,583,18.8,282,53,229,kr
177,진이애완동물,CHALLENGER I,582,15.2,488,74,414,kr
178,노래하는 쭌,CHALLENGER I,580,10.7,788,84,704,kr
179,이집트신화,CHALLENGER I,576,12.9,707,91,616,kr
180,깔딱깔딱,CHALLENGER I,575,18.0,784,141,643,kr
181,팬더랑놀자,CHALLENGER I,573,14.1,569,80,489,kr
182,소브로,CHALLENGER I,573,15.9,371,59,312,kr
183,빠꾸 없이 빠끄,CHALLENGER I,572,9.8,714,70,644,kr
184,르제스키,CHALLENGER I,571,17.3,578,100,478,kr
185,요들시너지 룰루,CHALLENGER I,569,13.9,223,31,192,kr
186,하와와 아담,CHALLENGER I,568,18.4,653,120,533,kr
187,봄날이갓두,CHALLENGER I,568,11.8,672,79,593,kr
188,Viento 9,CHALLENGER I,568,13.9,476,66,410,kr
189,쥬상이,CHALLENGER I,568,14.5,303,44,259,kr
190,AFTV 제로겟,CHALLENGER I,567,9.3,1733,162,1571,kr
191,s3unguk,CHALLENGER I,566,14.7,545,80,465,kr
192,똥줄타노스,CHALLENGER I,565,17.4,270,47,223,kr
193,TFT어캣,CHALLENGER I,565,16.9,278,47,231,kr
194,코리안조커테드창,CHALLENGER I,563,17.6,279,49,230,kr
195,AFTV 오대,CHALLENGER I,560,16.1,1417,228,1189,kr
196,V 6 6 V,CHALLENGER I,560,12.3,665,82,583,kr
197,미래지향사나이,CHALLENGER I,559,15.8,634,100,534,kr
198,호랑이찌찌젖짜기,CHALLENGER I,557,15.5,522,81,441,kr
199,달삼이빡빡라이즈,CHALLENGER I,556,14.2,628,89,539,kr
200,안하기로했자나,CHALLENGER I,556,16.6,314,52,262,kr
201,초콜렛공장,CHALLENGER I,555,12.6,348,44,304,kr
202,물 배,CHALLENGER I,553,13.1,604,79,525,kr
203,최 석,CHALLENGER I,553,22.3,193,43,150,kr
204,비비고김치,CHALLENGER I,553,8.9,460,41,419,kr
205,The 진감,CHALLENGER I,552,13.1,1258,165,1093,kr
206,오우거 돌주먹,CHALLENGER I,550,15.8,562,89,473,kr
207,yunhyunsik,CHALLENGER I,550,17.9,347,62,285,kr
208,눈부신 날,CHALLENGER I,550,16.1,341,55,286,kr
209,터틀 킴,CHALLENGER I,547,12.7,550,70,480,kr
210,I Go Challenger,CHALLENGER I,547,14.7,368,54,314,kr
211,멀보노자슥아,CHALLENGER I,545,13.2,736,97,639,kr
212,롤토체스 강의,CHALLENGER I,545,17.4,258,45,213,kr
213,사뢍해2,CHALLENGER I,543,14.9,483,72,411,kr
214,꽝 백,CHALLENGER I,542,15.6,505,79,426,kr
215,오에리,CHALLENGER I,542,13.5,370,50,320,kr
216,검은비,CHALLENGER I,541,17.1,344,59,285,kr
217,지하닝여자친구,CHALLENGER I,540,18.0,294,53,241,kr
218,놀릴준비 끝,CHALLENGER I,538,17.3,243,42,201,kr
219,뚱인라구여,CHALLENGER I,536,14.8,701,104,597,kr
220,개할거없네,CHALLENGER I,530,15.0,608,91,517,kr
221,콘쓰탄쯔,CHALLENGER I,530,13.8,420,58,362,kr
222,LlMITED,CHALLENGER I,530,12.4,169,21,148,kr
223,신낫상우,CHALLENGER I,529,16.6,477,79,398,kr
224,고고브라덜,CHALLENGER I,528,15.1,636,96,540,kr
225,귀여운피즈자나,CHALLENGER I,528,13.3,700,93,607,kr
226,백석대학교,CHALLENGER I,525,16.7,335,56,279,kr
227,칼바람 할아버지,CHALLENGER I,525,18.6,252,47,205,kr
228,항상던지지마라,CHALLENGER I,523,15.8,328,52,276,kr
229,바닐라공장,CHALLENGER I,523,13.4,239,32,207,kr
230,TFT Sloth,CHALLENGER I,521,15.4,855,132,723,kr
231,나혼산,CHALLENGER I,521,15.3,307,47,260,kr
232,Daeju imp,CHALLENGER I,519,9.9,436,43,393,kr
233,아 갓 씨,CHALLENGER I,515,14.2,492,70,422,kr
234,sunken,CHALLENGER I,514,16.6,728,121,607,kr
235,육류만,CHALLENGER I,514,16.3,590,96,494,kr
236,Schakal,CHALLENGER I,514,13.3,707,94,613,kr
237,왕 자,CHALLENGER I,514,12.7,584,74,510,kr
238,부스커,CHALLENGER I,513,11.4,734,84,650,kr
239,23세 홍삼길,CHALLENGER I,512,13.6,689,94,595,kr
240,장주현,CHALLENGER I,511,19.3,233,45,188,kr
241,로또야놀자,CHALLENGER I,510,13.9,965,134,831,kr
242,더 비상한다,CHALLENGER I,510,12.9,364,47,317,kr
243,배틀그라운드좋아,CHALLENGER I,509,12.5,1216,152,1064,kr
244,스펨선비,CHALLENGER I,509,12.3,562,69,493,kr
245,콩콩이는,CHALLENGER I,509,19.0,274,52,222,kr
246,발신짱,CHALLENGER I,508,11.8,696,82,614,kr
247,hyuk1,CHALLENGER I,508,16.4,341,56,285,kr
248,내가 미안훼,CHALLENGER I,508,16.9,189,32,157,kr
249,익 명 아 재,CHALLENGER I,507,19.4,614,119,495,kr
250,스킬 효과,CHALLENGER I,506,18.3,989,181,808,kr
251,나카모리 아키나,CHALLENGER I,506,12.6,549,69,480,kr
252,개인랭버스기사,CHALLENGER I,505,14.7,586,86,500,kr
253,설레는마음,CHALLENGER I,505,16.6,386,64,322,kr
254,TFT뚝배기수집가,CHALLENGER I,503,13.1,643,84,559,kr
255,팹시만 콜라,CHALLENGER I,503,15.7,313,49,264,kr
256,02Mania,CHALLENGER I,502,16.9,332,56,276,kr
257,노블마인드,CHALLENGER I,502,12.4,450,56,394,kr
258,체스장인 렝가,CHALLENGER I,502,15.2,316,48,268,kr
259,illilililli1,CHALLENGER I,502,15.7,242,38,204,kr
260,선대군,CHALLENGER I,501,12.9,472,61,411,kr
261,재 온,CHALLENGER I,501,16.1,279,45,234,kr
262,Dosu0,CHALLENGER I,501,18.2,203,37,166,kr
263,AFTV 신부형,CHALLENGER I,500,10.3,1108,114,994,kr
264,System2,CHALLENGER I,500,22.8,359,82,277,kr
265,당 언,CHALLENGER I,499,14.8,1094,162,932,kr
266,홍시띠,CHALLENGER I,498,17.9,414,74,340,kr
267,neverf0rgOt,CHALLENGER I,497,12.3,659,81,578,kr
268,그랜드킴,CHALLENGER I,494,15.2,762,116,646,kr
269,고추니 Tv,CHALLENGER I,494,12.9,897,116,781,kr
270,지하닝youtube,CHALLENGER I,494,15.0,433,65,368,kr
271,모델한당,CHALLENGER I,494,25.0,188,47,141,kr
272,총잡이그립다,CHALLENGER I,494,19.3,212,41,171,kr
273,원딜 좀 키워주자,CHALLENGER I,490,19.9,261,52,209,kr
274,TFT Let it Rain,CHALLENGER I,490,13.7,270,37,233,kr
275,갱뱅후,CHALLENGER I,488,14.6,520,76,444,kr
276,LAD 1,CHALLENGER I,488,13.1,527,69,458,kr
277,그냥시로,CHALLENGER I,486,17.5,599,105,494,kr
278,정말사랑해요,CHALLENGER I,485,9.3,568,53,515,kr
279,TR Zombi,CHALLENGER I,484,24.5,163,40,123,kr
280,FT아일랜드,CHALLENGER I,483,15.3,641,98,543,kr
281,Ignited,CHALLENGER I,483,12.4,508,63,445,kr
282,나랑랑이,CHALLENGER I,483,13.6,405,55,350,kr
283,heals,CHALLENGER I,482,16.7,454,76,378,kr
284,Arsenal92,CHALLENGER I,482,11.6,620,72,548,kr
285,AFTV 백기사,CHALLENGER I,482,21.9,269,59,210,kr
286,TZ 근영,CHALLENGER I,481,18.9,312,59,253,kr
287,정말싫어해요,CHALLENGER I,481,9.3,365,34,331,kr
288,금빵갓,CHALLENGER I,480,12.7,495,63,432,kr
289,A Prosecutor,CHALLENGER I,480,19.0,289,55,234,kr
290,장난감병정z,CHALLENGER I,479,15.9,832,132,700,kr
291,TFT HAGWAN,CHALLENGER I,478,12.0,474,57,417,kr
292,지하닝팬,CHALLENGER I,478,16.7,311,52,259,kr
293,설화산 티모,CHALLENGER I,478,12.7,339,43,296,kr
294,TFT홍스타,CHALLENGER I,469,25.2,151,38,113,kr
295,Danny 선생님,CHALLENGER I,464,13.2,643,85,558,kr
296,Teufelhaft,CHALLENGER I,464,13.7,306,42,264,kr
297,DouYu1958671,CHALLENGER I,452,15.0,367,55,312,kr
298,제황산,CHALLENGER I,423,15.0,888,133,755,kr
299,춘드레드,CHALLENGER I,420,35.1,154,54,100,kr
300,크 우,CHALLENGER I,334,16.2,389,63,326,kr
301,지하닝,"GRANDMASTER I
G",516,33.8,136,46,90,kr
302,bin physical,"GRANDMASTER I
G",512,13.1,697,91,606,kr
303,롤접으면여친생김,"GRANDMASTER I
G",504,17.7,317,56,261,kr
304,너말이야너1,"GRANDMASTER I
G",487,13.1,526,69,457,kr
305,현이야아,"GRANDMASTER I
G",474,15.0,213,32,181,kr
306,지르반4살,"GRANDMASTER I
G",470,17.1,549,94,455,kr
307,콩대congdae,"GRANDMASTER I
G",470,17.3,335,58,277,kr
308,설로재,"GRANDMASTER I
G",470,17.7,141,25,116,kr
309,히릿싸이마세,"GRANDMASTER I
G",464,15.1,285,43,242,kr
310,백시니,"GRANDMASTER I
G",463,13.4,464,62,402,kr
311,without some,"GRANDMASTER I
G",461,15.2,211,32,179,kr
312,dexxa,"GRANDMASTER I
G",453,11.2,1225,137,1088,kr
313,칸체스TV,"GRANDMASTER I
G",451,13.3,413,55,358,kr
314,초급자우대,"GRANDMASTER I
G",450,14.1,184,26,158,kr
315,준디네,"GRANDMASTER I
G",447,11.2,1179,132,1047,kr
316,ComeBack,"GRANDMASTER I
G",447,13.8,333,46,287,kr
317,Lalisa Manobal,"GRANDMASTER I
G",446,20.5,224,46,178,kr
318,오늘도좋고,"GRANDMASTER I
G",444,11.8,517,61,456,kr
319,쿨한토니,"GRANDMASTER I
G",442,15.6,320,50,270,kr
320,홀애비따까리,"GRANDMASTER I
G",442,21.4,173,37,136,kr
321,싱글벙글얍,"GRANDMASTER I
G",438,13.3,934,124,810,kr
322,WAF부케,"GRANDMASTER I
G",438,22.8,145,33,112,kr
323,가면 따냐,"GRANDMASTER I
G",430,15.2,343,52,291,kr
324,샐러리라면,"GRANDMASTER I
G",428,15.3,498,76,422,kr
325,마법공학소라고동,"GRANDMASTER I
G",427,19.6,580,114,466,kr
326,미리리미리3,"GRANDMASTER I
G",427,18.7,182,34,148,kr
327,멧돼지,"GRANDMASTER I
G",426,13.9,886,123,763,kr
328,hyuk2,"GRANDMASTER I
G",425,12.8,560,72,488,kr
329,하낫 둘 숨었다,"GRANDMASTER I
G",422,20.6,160,33,127,kr
330,DelisJin,"GRANDMASTER I
G",417,17.1,269,46,223,kr
331,범 원,"GRANDMASTER I
G",415,20.7,140,29,111,kr
332,임육뎍,"GRANDMASTER I
G",413,14.8,548,81,467,kr
333,천득 fan,"GRANDMASTER I
G",412,12.1,1064,129,935,kr
334,SsGoi,"GRANDMASTER I
G",411,16.6,187,31,156,kr
335,데굴데굴,"GRANDMASTER I
G",410,21.1,242,51,191,kr
336,기생벌레,"GRANDMASTER I
G",410,17.9,245,44,201,kr
337,OHCLADDAB,"GRANDMASTER I
G",410,15.2,224,34,190,kr
338,TFT ELLE,"GRANDMASTER I
G",408,16.2,365,59,306,kr
339,불타는당근,"GRANDMASTER I
G",408,12.9,433,56,377,kr
340,도리찡,"GRANDMASTER I
G",407,16.0,526,84,442,kr
341,bin wieder DA,"GRANDMASTER I
G",402,7.9,353,28,325,kr
342,X Videos 방금봄,"GRANDMASTER I
G",400,14.3,998,143,855,kr
343,90980619del,"GRANDMASTER I
G",400,16.8,653,110,543,kr
344,이렇게 좋은 날,"GRANDMASTER I
G",399,14.1,575,81,494,kr
345,인생을사는조진재,"GRANDMASTER I
G",398,14.5,317,46,271,kr
346,울집냥이양아치,"GRANDMASTER I
G",397,14.3,489,70,419,kr
347,참새년2,"GRANDMASTER I
G",395,21.1,171,36,135,kr
348,제토체스,"GRANDMASTER I
G",390,19.9,266,53,213,kr
349,TFT 시리,"GRANDMASTER I
G",388,14.4,837,121,716,kr
350,두가지,"GRANDMASTER I
G",387,11.4,694,79,615,kr
351,TOP하겠습니다,"GRANDMASTER I
G",385,17.0,529,90,439,kr
352,Teukhan,"GRANDMASTER I
G",382,13.9,1082,151,931,kr
353,AFTV 전기시너지,"GRANDMASTER I
G",382,15.4,552,85,467,kr
354,꿀항아리,"GRANDMASTER I
G",381,14.5,373,54,319,kr
355,모지리궁상,"GRANDMASTER I
G",379,15.0,412,62,350,kr
356,빠 꿈,"GRANDMASTER I
G",377,16.2,321,52,269,kr
357,KIMSEONIL,"GRANDMASTER I
G",377,15.9,264,42,222,kr
358,뀽탱이,"GRANDMASTER I
G",375,16.1,709,114,595,kr
359,볼베3성주셈,"GRANDMASTER I
G",374,14.9,853,127,726,kr
360,갱구찡,"GRANDMASTER I
G",372,14.4,673,97,576,kr
361,TFT 1436,"GRANDMASTER I
G",372,15.5,271,42,229,kr
362,TZ 홀리,"GRANDMASTER I
G",371,19.5,323,63,260,kr
363,경진이,"GRANDMASTER I
G",369,16.1,415,67,348,kr
364,KGE,"GRANDMASTER I
G",368,17.9,452,81,371,kr
365,Khanchess,"GRANDMASTER I
G",366,18.3,306,56,250,kr
366,성록썬더,"GRANDMASTER I
G",364,16.3,337,55,282,kr
367,협 착,"GRANDMASTER I
G",361,17.1,240,41,199,kr
368,한겜하고말사이에,"GRANDMASTER I
G",360,14.0,777,109,668,kr
369,20세기배추,"GRANDMASTER I
G",357,14.9,572,85,487,kr
370,두마리의 토끼,"GRANDMASTER I
G",357,14.5,400,58,342,kr
371,전 짝 시,"GRANDMASTER I
G",357,12.7,433,55,378,kr
372,용욱아 물좀,"GRANDMASTER I
G",357,21.3,122,26,96,kr
373,진스턴,"GRANDMASTER I
G",356,12.2,806,98,708,kr
374,밀턴프리드먼,"GRANDMASTER I
G",356,13.3,571,76,495,kr
375,꼐 속,"GRANDMASTER I
G",355,14.3,678,97,581,kr
376,토토로11,"GRANDMASTER I
G",355,11.7,744,87,657,kr
377,허른이,"GRANDMASTER I
G",355,12.7,503,64,439,kr
378,트위치 yuuubin,"GRANDMASTER I
G",353,13.6,295,40,255,kr
379,Jun Club,"GRANDMASTER I
G",351,25.0,164,41,123,kr
380,롤토체스asdf,"GRANDMASTER I
G",350,23.7,118,28,90,kr
381,불빠따쩝쩝이,"GRANDMASTER I
G",349,15.9,465,74,391,kr
382,검눈이,"GRANDMASTER I
G",344,20.0,150,30,120,kr
383,RICOH,"GRANDMASTER I
G",343,21.7,212,46,166,kr
384,프리맥,"GRANDMASTER I
G",342,14.1,1028,145,883,kr
385,고양이무한리필,"GRANDMASTER I
G",342,15.3,267,41,226,kr
386,이류환,"GRANDMASTER I
G",342,13.4,232,31,201,kr
387,AFTV 빠따,"GRANDMASTER I
G",340,16.8,411,69,342,kr
388,그저피할뿐,"GRANDMASTER I
G",336,18.6,285,53,232,kr
389,모리가와,"GRANDMASTER I
G",334,11.7,514,60,454,kr
390,카포포카,"GRANDMASTER I
G",333,14.2,400,57,343,kr
391,돼지꼬리원숭이,"GRANDMASTER I
G",333,20.6,228,47,181,kr
392,헤카림버스,"GRANDMASTER I
G",331,13.1,297,39,258,kr
393,빛보다빠른빤스런,"GRANDMASTER I
G",331,14.7,238,35,203,kr
394,롤체실력겜,"GRANDMASTER I
G",330,15.2,459,70,389,kr
395,2라2성,"GRANDMASTER I
G",329,16.2,400,65,335,kr
396,미리리미리2,"GRANDMASTER I
G",329,13.5,274,37,237,kr
397,AP Innovaticn,"GRANDMASTER I
G",325,15.4,299,46,253,kr
398,JJ오렌지ll,"GRANDMASTER I
G",324,14.9,760,113,647,kr
399,자니자니lol,"GRANDMASTER I
G",324,15.1,536,81,455,kr
400,Mid Hernia,"GRANDMASTER I
G",322,15.2,343,52,291,kr
401,WAF,"GRANDMASTER I
G",322,25.8,190,49,141,kr
402,4px,"GRANDMASTER I
G",322,23.1,208,48,160,kr
403,이라로랑,"GRANDMASTER I
G",320,11.4,984,112,872,kr
404,AFTV 진혼곡2,"GRANDMASTER I
G",319,17.0,300,51,249,kr
405,버버니,"GRANDMASTER I
G",317,23.8,143,34,109,kr
406,hide on bupyeong,"GRANDMASTER I
G",316,16.0,438,70,368,kr
407,4픽얼굴벨코즈,"GRANDMASTER I
G",314,15.8,495,78,417,kr
408,Oena,"GRANDMASTER I
G",314,13.8,507,70,437,kr
409,족발당수,"GRANDMASTER I
G",313,18.9,159,30,129,kr
410,홈런볼리베어,"GRANDMASTER I
G",312,18.9,323,61,262,kr
411,정수옥빠,"GRANDMASTER I
G",312,15.8,342,54,288,kr
412,김준용1,"GRANDMASTER I
G",309,16.2,389,63,326,kr
413,언더파치고싶엉,"GRANDMASTER I
G",308,16.6,290,48,242,kr
414,쪼해피롱,"GRANDMASTER I
G",307,19.6,920,180,740,kr
415,리스망,"GRANDMASTER I
G",307,12.1,734,89,645,kr
416,롤체하러왓어요,"GRANDMASTER I
G",307,15.2,519,79,440,kr
417,용국이꼬츄,"GRANDMASTER I
G",307,10.8,581,63,518,kr
418,롱지호,"GRANDMASTER I
G",306,16.0,556,89,467,kr
419,갱따위 귀찮아,"GRANDMASTER I
G",306,15.1,589,89,500,kr
420,saw and see,"GRANDMASTER I
G",306,14.0,543,76,467,kr
421,Arky,"GRANDMASTER I
G",305,13.3,1112,148,964,kr
422,이순방,"GRANDMASTER I
G",305,11.5,888,102,786,kr
423,Bongo Bong,"GRANDMASTER I
G",305,14.5,289,42,247,kr
424,질판감정소모안함,"GRANDMASTER I
G",304,18.5,869,161,708,kr
425,DearMemory,"GRANDMASTER I
G",304,15.1,576,87,489,kr
426,miguk,"GRANDMASTER I
G",304,19.3,202,39,163,kr
427,공주만의깃털기사,"GRANDMASTER I
G",302,12.9,418,54,364,kr
428,고릴라머리,"GRANDMASTER I
G",301,13.8,543,75,468,kr
429,why do i live2,"GRANDMASTER I
G",300,17.5,171,30,141,kr
430,빵상신,"GRANDMASTER I
G",299,17.0,453,77,376,kr
431,AFTV이클립스,"GRANDMASTER I
G",297,19.3,487,94,393,kr
432,Ayaka,"GRANDMASTER I
G",297,15.5,478,74,404,kr
433,940218,"GRANDMASTER I
G",295,20.9,334,70,264,kr
434,무질량,"GRANDMASTER I
G",295,15.0,406,61,345,kr
435,수원 나무늘보,"GRANDMASTER I
G",294,17.3,278,48,230,kr
436,입벌려갱들어간다,"GRANDMASTER I
G",293,13.7,615,84,531,kr
437,탈맹은지능순이져,"GRANDMASTER I
G",293,12.7,276,35,241,kr
438,한가윤,"GRANDMASTER I
G",293,18.4,152,28,124,kr
439,CHESS BOY,"GRANDMASTER I
G",291,22.8,114,26,88,kr
440,소크라테스v,"GRANDMASTER I
G",290,17.9,323,58,265,kr
441,부산대 신의주,"GRANDMASTER I
G",290,12.6,428,54,374,kr
442,궁디파,"GRANDMASTER I
G",289,15.5,238,37,201,kr
443,프로젝트마스타이,"GRANDMASTER I
G",286,11.7,590,69,521,kr
444,야쿨르트,"GRANDMASTER I
G",285,13.7,452,62,390,kr
445,검은눈썹,"GRANDMASTER I
G",285,12.5,384,48,336,kr
446,흑to the형,"GRANDMASTER I
G",285,14.1,312,44,268,kr
447,나만강아지없어힝,"GRANDMASTER I
G",284,14.2,400,57,343,kr
448,TZ제리2,"GRANDMASTER I
G",282,16.8,161,27,134,kr
449,우리크,"GRANDMASTER I
G",281,15.4,713,110,603,kr
450,AFTV 빠바박,"GRANDMASTER I
G",280,13.6,1568,214,1354,kr
451,빛을 본 그림자,"GRANDMASTER I
G",279,13.8,629,87,542,kr
452,AffogaT0,"GRANDMASTER I
G",279,16.3,460,75,385,kr
453,하룽룽이,"GRANDMASTER I
G",277,14.4,693,100,593,kr
454,벤치110키로,"GRANDMASTER I
G",277,19.6,281,55,226,kr
455,말파 3성,"GRANDMASTER I
G",275,13.0,552,72,480,kr
456,Seonghun96,"GRANDMASTER I
G",275,12.6,509,64,445,kr
457,조 립,"GRANDMASTER I
G",275,15.4,272,42,230,kr
458,정신이있니없니,"GRANDMASTER I
G",275,14.6,158,23,135,kr
459,진 형,"GRANDMASTER I
G",273,14.5,234,34,200,kr
460,tV motolora,"GRANDMASTER I
G",270,7.8,1303,101,1202,kr
461,제이삽,"GRANDMASTER I
G",268,11.2,847,95,752,kr
462,흐엉눈물나,"GRANDMASTER I
G",268,15.7,325,51,274,kr
463,또옹쟁이,"GRANDMASTER I
G",268,12.9,278,36,242,kr
464,퓨시아,"GRANDMASTER I
G",267,13.2,136,18,118,kr
465,싸ECo,"GRANDMASTER I
G",266,14.3,530,76,454,kr
466,secondMVP,"GRANDMASTER I
G",261,18.0,489,88,401,kr
467,Autochesser,"GRANDMASTER I
G",260,13.8,442,61,381,kr
468,서우깡,"GRANDMASTER I
G",259,17.4,362,63,299,kr
469,밥똥롤체,"GRANDMASTER I
G",258,17.5,692,121,571,kr
470,LADLAB,"GRANDMASTER I
G",257,12.8,580,74,506,kr
471,닭가슴살먹고싶어,"GRANDMASTER I
G",257,17.0,324,55,269,kr
472,입털면찾아서죽임,"GRANDMASTER I
G",257,13.2,227,30,197,kr
473,종 구 팔,"GRANDMASTER I
G",255,17.4,1041,181,860,kr
474,시나몬 국어,"GRANDMASTER I
G",255,13.5,607,82,525,kr
475,귀 찬,"GRANDMASTER I
G",255,15.2,462,70,392,kr
476,호감형스킬샷,"GRANDMASTER I
G",254,21.6,134,29,105,kr
477,AFTV빙이,"GRANDMASTER I
G",253,13.6,611,83,528,kr
478,ChoRok,"GRANDMASTER I
G",253,15.4,259,40,219,kr
479,silicic,"GRANDMASTER I
G",249,11.7,496,58,438,kr
480,호라파동,"GRANDMASTER I
G",249,18.9,201,38,163,kr
481,맛좋은꿀,"GRANDMASTER I
G",247,16.1,678,109,569,kr
482,야 연,"GRANDMASTER I
G",247,12.3,779,96,683,kr
483,eunje0ng,"GRANDMASTER I
G",246,12.2,625,76,549,kr
484,피리 부는 누누,"GRANDMASTER I
G",245,19.1,340,65,275,kr
485,스트롱섹시,"GRANDMASTER I
G",245,21.2,179,38,141,kr
486,귀족찡,"GRANDMASTER I
G",245,22.6,164,37,127,kr
487,Javacity Coffee,"GRANDMASTER I
G",244,17.5,228,40,188,kr
488,루 윈,"GRANDMASTER I
G",243,22.7,176,40,136,kr
489,빠빠빠삐삐,"GRANDMASTER I
G",243,16.7,120,20,100,kr
490,AFTV빙이저격수,"GRANDMASTER I
G",241,12.3,285,35,250,kr
491,Metronome,"GRANDMASTER I
G",238,17.5,862,151,711,kr
492,알수없음1,"GRANDMASTER I
G",238,15.0,532,80,452,kr
493,TFT 빠코,"GRANDMASTER I
G",238,16.6,403,67,336,kr
494,따대남,"GRANDMASTER I
G",237,16.4,572,94,478,kr
495,로리고수,"GRANDMASTER I
G",234,14.5,475,69,406,kr
496,뭉미오,"GRANDMASTER I
G",234,9.7,692,67,625,kr
497,옛 섬,"GRANDMASTER I
G",233,14.0,571,80,491,kr
498,메로나공장,"GRANDMASTER I
G",233,13.9,202,28,174,kr
499,붤 붤,"GRANDMASTER I
G",233,20.8,125,26,99,kr
500,능가전역진까030,"GRANDMASTER I
G",232,12.3,667,82,585,kr
1,Tewesineitor,CHALLENGER I,1498,29.1,306,89,217,lan
2,Rayio,CHALLENGER I,1289,23.1,927,214,713,lan
3,akalyzer,CHALLENGER I,1279,26.7,688,184,504,lan
4,Líon,CHALLENGER I,1144,20.5,552,113,439,lan
5,Crycer,CHALLENGER I,1007,30.3,304,92,212,lan
6,Quantum8,CHALLENGER I,959,23.8,286,68,218,lan
7,SákuraHana,CHALLENGER I,954,32.7,220,72,148,lan
8,CarryMe Akashi,CHALLENGER I,925,20.1,487,98,389,lan
9,Yami Laicus,CHALLENGER I,896,27.7,303,84,219,lan
10,GhoStorm,CHALLENGER I,865,21.0,404,85,319,lan
11,NVS Bowen,CHALLENGER I,859,20.1,329,66,263,lan
12,bite of destiny,CHALLENGER I,769,21.2,533,113,420,lan
13,xBjaker,CHALLENGER I,768,20.8,308,64,244,lan
14,Cerealito,CHALLENGER I,752,18.4,408,75,333,lan
15,NVS Bowi,CHALLENGER I,685,23.1,242,56,186,lan
16,Dal,CHALLENGER I,659,19.3,363,70,293,lan
17,lmlWarCrY,CHALLENGER I,629,21.7,300,65,235,lan
18,Ch1wy,CHALLENGER I,628,14.0,734,103,631,lan
19,KilljoyMex,CHALLENGER I,615,22.8,241,55,186,lan
20,MyzteryAlex,CHALLENGER I,557,12.5,944,118,826,lan
21,Dlanor,CHALLENGER I,550,21.0,442,93,349,lan
22,PipoMaster,CHALLENGER I,546,22.2,306,68,238,lan
23,itken,CHALLENGER I,537,16.6,1006,167,839,lan
24,KiraDessu,CHALLENGER I,535,22.9,401,92,309,lan
25,QuiMi,CHALLENGER I,513,20.4,362,74,288,lan
26,Exus,CHALLENGER I,512,21.8,284,62,222,lan
27,MaRiO bRoS,CHALLENGER I,500,17.7,767,136,631,lan
28,Garto Ward,CHALLENGER I,475,17.6,319,56,263,lan
29,AztecMx,CHALLENGER I,475,13.4,238,32,206,lan
30,RiftHerald,CHALLENGER I,472,17.8,208,37,171,lan
31,2D Jaro,CHALLENGER I,471,23.8,755,180,575,lan
32,ianakin7,CHALLENGER I,457,18.2,779,142,637,lan
33,7DS HyperSpace,CHALLENGER I,448,21.7,1046,227,819,lan
34,Redmoonwolf,CHALLENGER I,448,11.9,354,42,312,lan
35,Mr Mugui,CHALLENGER I,423,17.2,1015,175,840,lan
36,andmont,CHALLENGER I,418,19.7,264,52,212,lan
37,TftAcademy,CHALLENGER I,413,12.9,548,71,477,lan
38,Soul 1,CHALLENGER I,407,23.4,256,60,196,lan
39,Lysıthea,CHALLENGER I,400,23.2,371,86,285,lan
40,Hi im Clark,CHALLENGER I,400,22.4,286,64,222,lan
41,Sealcune Mbappé,CHALLENGER I,396,19.1,560,107,453,lan
42,shiry,CHALLENGER I,394,19.8,273,54,219,lan
43,melizaX,CHALLENGER I,390,17.4,338,59,279,lan
44,Im not villo,CHALLENGER I,389,21.0,366,77,289,lan
45,JOnnyLR,CHALLENGER I,376,17.1,357,61,296,lan
46,KllK EditZ,CHALLENGER I,362,18.1,287,52,235,lan
47,Frondavil,CHALLENGER I,346,15.7,432,68,364,lan
48,Vampiro Playero,CHALLENGER I,346,19.0,310,59,251,lan
49,Quántum,CHALLENGER I,253,22.3,166,37,129,lan
50,elchicolinux,CHALLENGER I,165,16.0,243,39,204,lan
51,Slix,"GRANDMASTER I
G",379,24.4,172,42,130,lan
52,warlocksky,"GRANDMASTER I
G",328,14.6,253,37,216,lan
53,Kurokoba,"GRANDMASTER I
G",323,19.0,179,34,145,lan
54,AntonyGamingTFT,"GRANDMASTER I
G",322,15.5,483,75,408,lan
55,Ardén,"GRANDMASTER I
G",313,12.3,530,65,465,lan
56,oliver10,"GRANDMASTER I
G",305,19.2,271,52,219,lan
57,thewghost,"GRANDMASTER I
G",302,24.4,197,48,149,lan
58,Putint,"GRANDMASTER I
G",293,19.5,266,52,214,lan
59,Siempremuerto,"GRANDMASTER I
G",291,15.3,340,52,288,lan
60,Power,"GRANDMASTER I
G",278,14.4,389,56,333,lan
61,TheBadMF,"GRANDMASTER I
G",268,16.9,344,58,286,lan
62,No soy exoor,"GRANDMASTER I
G",258,25.0,172,43,129,lan
63,Maguita,"GRANDMASTER I
G",248,18.1,332,60,272,lan
64,Gargota,"GRANDMASTER I
G",243,21.8,294,64,230,lan
65,CrisT1an,"GRANDMASTER I
G",238,22.9,166,38,128,lan
66,PoronghaNegra,"GRANDMASTER I
G",234,17.1,397,68,329,lan
67,Revengp,"GRANDMASTER I
G",231,20.7,217,45,172,lan
68,Gio9811,"GRANDMASTER I
G",222,15.3,235,36,199,lan
69,Garchomp,"GRANDMASTER I
G",219,26.7,180,48,132,lan
70,Ucr,"GRANDMASTER I
G",218,14.8,372,55,317,lan
71,Dondenuncias,"GRANDMASTER I
G",218,28.6,161,46,115,lan
72,Too Sweet,"GRANDMASTER I
G",209,25.4,130,33,97,lan
73,Marenn,"GRANDMASTER I
G",207,13.6,287,39,248,lan
74,NAOS911,"GRANDMASTER I
G",206,11.6,614,71,543,lan
75,Cleopatro,"GRANDMASTER I
G",201,34.3,105,36,69,lan
76,Main Q,"GRANDMASTER I
G",196,19.1,277,53,224,lan
77,Need more skins,"GRANDMASTER I
G",195,15.4,376,58,318,lan
78,Cjddd,"GRANDMASTER I
G",191,15.9,220,35,185,lan
79,Psend,"GRANDMASTER I
G",190,19.7,198,39,159,lan
80,ransabia,"GRANDMASTER I
G",186,14.2,625,89,536,lan
81,G2 Josar,"GRANDMASTER I
G",186,19.1,335,64,271,lan
82,Aletsis,"GRANDMASTER I
G",180,22.8,136,31,105,lan
83,javia316,"GRANDMASTER I
G",177,15.1,482,73,409,lan
84,Xkorzo YT,"GRANDMASTER I
G",177,28.4,95,27,68,lan
85,LiL Exoor,"GRANDMASTER I
G",176,23.9,201,48,153,lan
86,Warblo,"GRANDMASTER I
G",174,24.4,405,99,306,lan
87,25356,"GRANDMASTER I
G",172,16.9,307,52,255,lan
88,XiaoPo06,"GRANDMASTER I
G",168,13.4,574,77,497,lan
89,Rambotehamatado,"GRANDMASTER I
G",168,16.3,429,70,359,lan
90,Twistä,"GRANDMASTER I
G",168,10.8,353,38,315,lan
91,Seìyu,"GRANDMASTER I
G",166,15.2,283,43,240,lan
92,Rodo TFT,"GRANDMASTER I
G",164,15.9,239,38,201,lan
93,No Mercy,"GRANDMASTER I
G",160,16.7,582,97,485,lan
94,Khorge,"GRANDMASTER I
G",156,19.7,132,26,106,lan
95,panchoAngüis,"GRANDMASTER I
G",153,23.5,306,72,234,lan
96,TheOnlyTeddy,"GRANDMASTER I
G",150,17.1,251,43,208,lan
97,Khorge PN,"GRANDMASTER I
G",145,19.0,210,40,170,lan
98,Vork,"GRANDMASTER I
G",144,15.1,443,67,376,lan
99,Pompo,"GRANDMASTER I
G",142,18.0,345,62,283,lan
100,zeiik,"GRANDMASTER I
G",138,16.9,267,45,222,lan
101,FordHealer,"GRANDMASTER I
G",135,27.0,74,20,54,lan
102,TFT Lelouch,"GRANDMASTER I
G",133,13.7,256,35,221,lan
103,DragoFenix2,"GRANDMASTER I
G",124,16.3,289,47,242,lan
104,Apödaca,"GRANDMASTER I
G",123,26.2,259,68,191,lan
105,Stupefy,"GRANDMASTER I
G",123,13.2,440,58,382,lan
106,Pauleandro,"GRANDMASTER I
G",121,8.3,575,48,527,lan
107,Dan Nassor,"GRANDMASTER I
G",118,17.9,486,87,399,lan
108,socio2k,"GRANDMASTER I
G",118,18.1,310,56,254,lan
109,Pushesz,"GRANDMASTER I
G",117,18.7,348,65,283,lan
110,lkokito,"GRANDMASTER I
G",116,18.4,418,77,341,lan
111,ExtraWuiller,"GRANDMASTER I
G",116,14.3,245,35,210,lan
112,WJ Rem,"GRANDMASTER I
G",114,15.3,301,46,255,lan
113,Pedro Bae,"GRANDMASTER I
G",113,24.6,349,86,263,lan
114,llArthzll,"GRANDMASTER I
G",109,23.6,330,78,252,lan
115,xHeroskillx,"GRANDMASTER I
G",107,15.8,240,38,202,lan
116,lyonew,"GRANDMASTER I
G",105,13.4,499,67,432,lan
117,Phobosss,"GRANDMASTER I
G",105,14.4,348,50,298,lan
118,donberli,"GRANDMASTER I
G",103,15.8,539,85,454,lan
119,TFT Ares,"GRANDMASTER I
G",102,11.0,547,60,487,lan
120,aeal99,"GRANDMASTER I
G",102,12.6,199,25,174,lan
121,Jir0,"GRANDMASTER I
G",101,15.5,503,78,425,lan
122,lx Rayhad xl,"GRANDMASTER I
G",100,21.4,159,34,125,lan
123,rambo12345678,"GRANDMASTER I
G",99,14.7,523,77,446,lan
124,Chesspants,"GRANDMASTER I
G",97,18.8,197,37,160,lan
125,Dizzy DestroyLAN,"GRANDMASTER I
G",96,20.9,91,19,72,lan
126,Anivio,"GRANDMASTER I
G",95,16.7,288,48,240,lan
127,papusmaximus,"GRANDMASTER I
G",95,6.5,324,21,303,lan
128,McGregorr,"GRANDMASTER I
G",92,18.6,419,78,341,lan
129,bEiMáR,"GRANDMASTER I
G",91,13.6,797,108,689,lan
130,BarbeQ,"GRANDMASTER I
G",90,15.7,562,88,474,lan
131,Skaaarl,"GRANDMASTER I
G",90,16.3,257,42,215,lan
132,TFTJefe,"GRANDMASTER I
G",89,14.8,283,42,241,lan
133,EN1GMA,"GRANDMASTER I
G",87,18.1,782,142,640,lan
134,Desü,"GRANDMASTER I
G",87,14.6,478,70,408,lan
135,soli hdz,"GRANDMASTER I
G",86,17.4,426,74,352,lan
136,Gatito Cósmıco,"GRANDMASTER I
G",85,17.6,239,42,197,lan
137,BarbieQ,"GRANDMASTER I
G",85,27.5,109,30,79,lan
138,Cloud strife,"GRANDMASTER I
G",85,16.8,155,26,129,lan
139,GS Lancelot,"GRANDMASTER I
G",83,17.9,263,47,216,lan
140,Skan011,"GRANDMASTER I
G",81,14.0,235,33,202,lan
141,Don Stban,"GRANDMASTER I
G",80,21.7,129,28,101,lan
142,AbrahamBM,"GRANDMASTER I
G",75,16.3,190,31,159,lan
143,Vey,"GRANDMASTER I
G",73,16.9,219,37,182,lan
144,l Moe l,"GRANDMASTER I
G",68,12.6,310,39,271,lan
145,GøldLyon,"GRANDMASTER I
G",65,16.2,303,49,254,lan
146,Druu TFT,"GRANDMASTER I
G",50,18.6,413,77,336,lan
147,DLT Macloud,"GRANDMASTER I
G",27,17.4,482,84,398,lan
148,D4nyle,"GRANDMASTER I
G",0,14.1,1530,216,1314,lan
149,WilvySmile,"GRANDMASTER I
G",0,15.4,745,115,630,lan
150,Fherpaz,"GRANDMASTER I
G",0,13.1,435,57,378,lan
151,ChinoRobin,MASTER I,122,23.7,232,55,177,lan
152,Nightlover,MASTER I,109,17.3,330,57,273,lan
153,God JdGa,MASTER I,92,23.2,357,83,274,lan
154,ILY Elena Rubí,MASTER I,81,24.3,111,27,84,lan
155,liou,MASTER I,80,17.1,129,22,107,lan
156,Venonmanzer,MASTER I,70,10.6,265,28,237,lan
157,Moncho,MASTER I,69,12.8,156,20,136,lan
158,TrafalgarL4w,MASTER I,67,20.2,411,83,328,lan
159,JoseM29,MASTER I,66,16.0,350,56,294,lan
160,Nebura,MASTER I,65,19.5,205,40,165,lan
161,TheFenixx,MASTER I,64,30.7,205,63,142,lan
162,96Cronus05,MASTER I,63,21.2,203,43,160,lan
163,JulesMont,MASTER I,50,21.2,231,49,182,lan
164,TheGearZ,MASTER I,50,11.7,180,21,159,lan
165,Lą Sultąną,MASTER I,49,28.7,94,27,67,lan
166,Frozte,MASTER I,48,17.9,223,40,183,lan
167,Orange,MASTER I,47,12.0,482,58,424,lan
168,Arcaanine,MASTER I,45,10.7,590,63,527,lan
169,SKY Trafalgar,MASTER I,44,15.7,498,78,420,lan
170,YaphetS Karma,MASTER I,44,23.0,165,38,127,lan
171,Mahito,MASTER I,44,23.7,114,27,87,lan
172,TFT Cadix,MASTER I,43,16.2,413,67,346,lan
173,Wild Octupus,MASTER I,41,23.9,180,43,137,lan
174,Tengen Uzui,MASTER I,39,22.8,197,45,152,lan
175,Espemss,MASTER I,39,14.9,222,33,189,lan
176,Wamuu,MASTER I,38,17.4,379,66,313,lan
177,Danté,MASTER I,38,19.0,331,63,268,lan
178,NKG Madness,MASTER I,38,21.9,196,43,153,lan
179,Lą Mąscotą,MASTER I,38,15.2,151,23,128,lan
180,Fêderico,MASTER I,36,17.1,315,54,261,lan
181,HaganeNoren,MASTER I,34,20.5,215,44,171,lan
182,Roy Mustang XD,MASTER I,33,12.9,334,43,291,lan
183,Enryu The Red,MASTER I,30,18.6,307,57,250,lan
184,RedsKnight,MASTER I,29,18.3,333,61,272,lan
185,Gizu,MASTER I,29,13.2,416,55,361,lan
186,BoscoBramblefoot,MASTER I,29,18.9,233,44,189,lan
187,chërlyn,MASTER I,28,23.4,320,75,245,lan
188,Devilx500,MASTER I,28,13.7,497,68,429,lan
189,Tactics,MASTER I,27,7.2,917,66,851,lan
190,Archi,MASTER I,27,12.7,237,30,207,lan
191,Dirmund,MASTER I,27,9.8,264,26,238,lan
192,Stuff,MASTER I,25,13.9,381,53,328,lan
193,Utephh,MASTER I,25,16.3,258,42,216,lan
194,Camipson,MASTER I,24,15.0,233,35,198,lan
195,ZyppoTFT,MASTER I,21,17.2,395,68,327,lan
196,Šęcręt Aurôrą,MASTER I,21,14.2,288,41,247,lan
197,DiiimiTRY,MASTER I,19,19.1,188,36,152,lan
198,Ęnder,MASTER I,17,16.0,175,28,147,lan
199,SotoOZoto,MASTER I,17,24.3,107,26,81,lan
200,j41746943J,MASTER I,16,15.8,266,42,224,lan
201,persian rugs,MASTER I,15,19.8,182,36,146,lan
202,JustAdc,MASTER I,14,15.8,651,103,548,lan
203,GerrySaiyan15,MASTER I,14,15.6,282,44,238,lan
204,Ezcanør,MASTER I,14,13.4,299,40,259,lan
205,Lechuga Húmeda,MASTER I,13,16.3,251,41,210,lan
206,NTS Dr Edwin,MASTER I,13,14.2,169,24,145,lan
207,Wínter,MASTER I,12,17.6,204,36,168,lan
208,Hittler Sama UwU,MASTER I,11,21.2,377,80,297,lan
209,MXG JonhWonka,MASTER I,11,23.9,117,28,89,lan
210,Akua,MASTER I,9,17.4,201,35,166,lan
211,TaquitoAIPastor,MASTER I,9,18.1,149,27,122,lan
212,JONN93,MASTER I,8,12.8,584,75,509,lan
213,DedosLocos7u7,MASTER I,8,14.4,250,36,214,lan
214,Sëkker,MASTER I,7,20.8,216,45,171,lan
215,Sorrento0,MASTER I,6,16.5,399,66,333,lan
216,AlXDXD,MASTER I,6,17.7,209,37,172,lan
217,LFT Zero,MASTER I,6,16.9,148,25,123,lan
218,ICostDRE,MASTER I,5,16.4,548,90,458,lan
219,Flexus,MASTER I,5,17.5,206,36,170,lan
220,juandotft,MASTER I,5,16.3,178,29,149,lan
221,darksiders9,MASTER I,5,14.1,205,29,176,lan
222,Porygon,MASTER I,5,23.4,111,26,85,lan
223,xXReyXx,MASTER I,4,16.5,260,43,217,lan
224,Scrum1233,MASTER I,3,17.5,309,54,255,lan
225,A K A DeckeR GNR,MASTER I,3,15.5,284,44,240,lan
226,VarelaG4M3R,MASTER I,3,9.2,467,43,424,lan
227,HDKA02,MASTER I,3,17.0,182,31,151,lan
228,Rcadillo,MASTER I,2,15.4,841,130,711,lan
229,III    MÅC   III,MASTER I,2,11.0,593,65,528,lan
230,4manu4,MASTER I,2,15.1,291,44,247,lan
231,thor0077,MASTER I,2,14.1,198,28,170,lan
232,boli é corozo,MASTER I,2,22.2,99,22,77,lan
233,TFT Kalo,MASTER I,1,10.5,725,76,649,lan
234,LaGoorda,MASTER I,1,18.2,154,28,126,lan
235,F Ë N R I R Wølf,MASTER I,1,16.4,152,25,127,lan
236,El HuachicoIero,MASTER I,1,16.7,90,15,75,lan
237,Farek,MASTER I,0,12.8,654,84,570,lan
238,ºªº,MASTER I,0,19.0,369,70,299,lan
239,scarmg,MASTER I,0,19.8,349,69,280,lan
240,Sr Frito,MASTER I,0,15.4,429,66,363,lan
241,FjBlanco,MASTER I,0,17.8,360,64,296,lan
242,JIDEG,MASTER I,0,16.1,391,63,328,lan
243,Kyokenn,MASTER I,0,15.1,398,60,338,lan
244,EvilAgeent,MASTER I,0,17.0,336,57,279,lan
245,PAPILFOELREY,MASTER I,0,14.4,353,51,302,lan
246,HoIIow Knight,MASTER I,0,14.2,351,50,301,lan
247,ahsodan,MASTER I,0,14.8,332,49,283,lan
248,Volk13,MASTER I,0,12.8,350,45,305,lan
249,fciencias,MASTER I,0,16.5,255,42,213,lan
250,marcitox,MASTER I,0,16.0,250,40,210,lan
251,DL DIAMOND DL,MASTER I,0,13.2,281,37,244,lan
252,Farlicious,MASTER I,0,24.8,145,36,109,lan
253,Aguri Onishi,MASTER I,0,18.9,169,32,137,lan
254,V Draeko,MASTER I,0,10.0,300,30,270,lan
255,marduko,MASTER I,0,11.2,260,29,231,lan
256,BlitzDance,MASTER I,0,18.4,147,27,120,lan
257,JottaEle,MASTER I,0,12.9,209,27,182,lan
258,MidGod,MASTER I,0,15.1,152,23,129,lan
259,Souł,DIAMOND I,95,15.1,299,45,254,lan
260,DHA Arslan,DIAMOND I,93,7.6,538,41,497,lan
261,Entei,DIAMOND I,93,21.6,148,32,116,lan
262,DenisLuluch,DIAMOND I,84,16.3,344,56,288,lan
263,MIROLINDO,DIAMOND I,82,19.1,235,45,190,lan
264,itai yamete papa,DIAMOND I,82,17.8,242,43,199,lan
265,Play,DIAMOND I,81,11.8,329,39,290,lan
266,spymomkiller,DIAMOND I,79,15.7,236,37,199,lan
267,Cuervó,DIAMOND I,78,18.9,302,57,245,lan
268,Sigma the black,DIAMOND I,76,10.4,298,31,267,lan
269,Hide øn bušh,DIAMOND I,75,18.3,923,169,754,lan
270,DreigonzxD,DIAMOND I,75,19.8,445,88,357,lan
271,Metapod69 3,DIAMOND I,75,17.8,411,73,338,lan
272,TierDany,DIAMOND I,75,21.3,338,72,266,lan
273,Apolden,DIAMOND I,75,14.0,506,71,435,lan
274,OblivionDrake,DIAMOND I,75,12.8,516,66,450,lan
275,Rafoski,DIAMOND I,75,10.7,561,60,501,lan
276,xXSenshouXx,DIAMOND I,75,21.1,266,56,210,lan
277,Karlosd6,DIAMOND I,75,19.6,265,52,213,lan
278,NVS Mlchael,DIAMOND I,75,23.7,207,49,158,lan
279,Luisillo senpai,DIAMOND I,75,16.1,304,49,255,lan
280,Tamarhindo,DIAMOND I,75,15.8,240,38,202,lan
281,Freakiest show,DIAMOND I,75,21.1,142,30,112,lan
282,TFT ransabia,DIAMOND I,75,27.2,103,28,75,lan
283,alberth321,DIAMOND I,75,9.8,275,27,248,lan
284,V Fénix,DIAMOND I,75,10.7,196,21,175,lan
285,XxsummaruuxX,DIAMOND I,75,12.5,120,15,105,lan
286,Gallher,DIAMOND I,74,18.4,479,88,391,lan
287,EternalWarriorXD,DIAMOND I,74,21.8,206,45,161,lan
288,Homencoming,DIAMOND I,73,7.6,381,29,352,lan
289,Ovejomaru,DIAMOND I,72,18.9,307,58,249,lan
290,Beerwish,DIAMOND I,70,15.0,654,98,556,lan
291,ABjomies,DIAMOND I,69,18.4,569,105,464,lan
292,diandi,DIAMOND I,68,18.8,256,48,208,lan
293,Rey Menelao,DIAMOND I,67,15.3,445,68,377,lan
294,El Rolox,DIAMOND I,67,25.4,114,29,85,lan
295,Compa Kiki,DIAMOND I,66,16.4,140,23,117,lan
296,LlámameBruce Lee,DIAMOND I,64,17.2,494,85,409,lan
297,wolfteamx5,DIAMOND I,63,15.1,642,97,545,lan
298,Marrochet,DIAMOND I,61,11.6,310,36,274,lan
299,Emili4n,DIAMOND I,59,27.9,305,85,220,lan
300,Sleepfer,DIAMOND I,57,13.6,789,107,682,lan
301,Enr1que,DIAMOND I,57,11.7,635,74,561,lan
302,SabritasOriginal,DIAMOND I,57,19.9,287,57,230,lan
303,rakids,DIAMOND I,57,8.3,515,43,472,lan
304,Wukong Radiante,DIAMOND I,57,16.0,262,42,220,lan
305,Sr Escanor,DIAMOND I,54,15.7,325,51,274,lan
306,TOMATOFARMER535,DIAMOND I,53,9.6,604,58,546,lan
307,Llámame Minizyzz,DIAMOND I,53,17.0,194,33,161,lan
308,Rkman,DIAMOND I,52,19.1,194,37,157,lan
309,gujet,DIAMOND I,52,16.7,209,35,174,lan
310,ChrisVinsmoke,DIAMOND I,50,23.8,290,69,221,lan
311,DarkSpoiled,DIAMOND I,50,16.7,390,65,325,lan
312,very cute girl,DIAMOND I,50,20.0,310,62,248,lan
313,ElGuasoNPerú,DIAMOND I,50,14.3,399,57,342,lan
314,FrogZero,DIAMOND I,50,24.1,228,55,173,lan
315,TeversomuchT,DIAMOND I,50,12.8,415,53,362,lan
316,ccrixalis,DIAMOND I,50,17.6,295,52,243,lan
317,Pao Wang 595,DIAMOND I,50,17.4,299,52,247,lan
318,Konohá,DIAMOND I,50,17.7,271,48,223,lan
319,Frank,DIAMOND I,50,20.1,229,46,183,lan
320,Osorongo GG,DIAMOND I,50,19.6,230,45,185,lan
321,VGIA Manute,DIAMOND I,50,14.0,314,44,270,lan
322,Gral Torin,DIAMOND I,50,18.2,231,42,189,lan
323,edwardp00,DIAMOND I,50,17.1,239,41,198,lan
324,Sakuno,DIAMOND I,50,20.4,186,38,148,lan
325,OGT Sergio,DIAMOND I,50,19.7,183,36,147,lan
326,swarosky,DIAMOND I,50,14.3,252,36,216,lan
327,General Rou,DIAMOND I,50,24.6,142,35,107,lan
328,Senna Palmer,DIAMOND I,50,22.1,131,29,102,lan
329,Sopa e Mondongo,DIAMOND I,50,21.3,108,23,85,lan
330,Hi im Zeuus,DIAMOND I,50,15.4,136,21,115,lan
331,JeffBlack0619,DIAMOND I,48,14.7,245,36,209,lan
332,YAYADC,DIAMOND I,48,12.6,175,22,153,lan
333,Bebessiitaaaa,DIAMOND I,47,15.5,386,60,326,lan
334,SsyaelAporro,DIAMOND I,47,16.1,236,38,198,lan
335,Mr chane,DIAMOND I,44,17.1,362,62,300,lan
336,I N G L E,DIAMOND I,44,13.7,146,20,126,lan
337,AriChan,DIAMOND I,43,10.7,270,29,241,lan
338,Spianda,DIAMOND I,42,20.8,279,58,221,lan
339,YokedWar,DIAMOND I,42,17.5,228,40,188,lan
340,Pelososo,DIAMOND I,42,15.7,230,36,194,lan
341,Riflorez,DIAMOND I,41,11.6,912,106,806,lan
342,SayGGpls,DIAMOND I,41,15.0,525,79,446,lan
343,rubiinskey,DIAMOND I,41,20.7,237,49,188,lan
344,eldrit,DIAMOND I,41,16.6,295,49,246,lan
345,nikolaz9393,DIAMOND I,41,16.3,288,47,241,lan
346,Dancho,DIAMOND I,41,16.3,245,40,205,lan
347,0 Torment,DIAMOND I,41,15.9,208,33,175,lan
348,GREIVIN,DIAMOND I,40,9.6,280,27,253,lan
349,XMozart,DIAMOND I,38,13.1,236,31,205,lan
350,Kommless,DIAMOND I,38,17.1,175,30,145,lan
351,Dani Di Twitch,DIAMOND I,38,14.7,204,30,174,lan
352,Firelx,DIAMOND I,38,17.5,160,28,132,lan
353,Betomofcydonia,DIAMOND I,37,12.0,308,37,271,lan
354,Sonagi,DIAMOND I,37,18.1,149,27,122,lan
355,Jei7,DIAMOND I,36,18.3,262,48,214,lan
356,Possesiv,DIAMOND I,36,17.0,212,36,176,lan
357,jimmypagesoler,DIAMOND I,35,13.9,273,38,235,lan
358,WMG Vi,DIAMOND I,34,19.4,360,70,290,lan
359,HuevoCrudo,DIAMOND I,34,14.4,458,66,392,lan
360,merrymaker,DIAMOND I,34,20.6,184,38,146,lan
361,Mitchaellkd,DIAMOND I,34,18.0,183,33,150,lan
362,Odinbel,DIAMOND I,33,8.8,557,49,508,lan
363,Awela Requiem,DIAMOND I,32,23.2,224,52,172,lan
364,javordavor,DIAMOND I,32,18.8,186,35,151,lan
365,SugarSon69,DIAMOND I,31,17.9,363,65,298,lan
366,Happy brownnie,DIAMOND I,31,13.9,288,40,248,lan
367,God avenged,DIAMOND I,31,18.6,167,31,136,lan
368,Chowy,DIAMOND I,30,17.4,321,56,265,lan
369,ATG LEINHEART,DIAMOND I,30,15.2,316,48,268,lan
370,ShonWick,DIAMOND I,30,16.7,227,38,189,lan
371,Genesis IV,DIAMOND I,29,15.8,158,25,133,lan
372,PupusaDeQueso7u7,DIAMOND I,28,16.6,453,75,378,lan
373,xMiguelOx,DIAMOND I,28,13.3,517,69,448,lan
374,Pan the bono,DIAMOND I,28,16.1,366,59,307,lan
375,Tyranarius,DIAMOND I,28,20.1,144,29,115,lan
376,Crs Pursuit,DIAMOND I,27,15.1,299,45,254,lan
377,Zaxxkk,DIAMOND I,27,21.0,138,29,109,lan
378,Dark Room,DIAMOND I,26,13.8,448,62,386,lan
379,Dark Ceniza,DIAMOND I,26,15.0,266,40,226,lan
380,Drefaz,DIAMOND I,25,16.3,424,69,355,lan
381,KO iRushx,DIAMOND I,25,16.6,283,47,236,lan
382,Nettlesome,DIAMOND I,25,11.1,333,37,296,lan
383,Danith,DIAMOND I,25,20.0,165,33,132,lan
384,Tucus,DIAMOND I,25,10.5,267,28,239,lan
385,TFT Legend,DIAMOND I,25,36.8,68,25,43,lan
386,Ron Whiskey,DIAMOND I,25,16.7,120,20,100,lan
387,looljavier,DIAMOND I,24,14.8,209,31,178,lan
388,xPuxi Nike,DIAMOND I,24,12.0,258,31,227,lan
389,F por Hiroshima,DIAMOND I,23,21.4,275,59,216,lan
390,Invyktus,DIAMOND I,23,12.9,224,29,195,lan
391,ALXNIGHT,DIAMOND I,20,15.8,361,57,304,lan
392,McNov4ec,DIAMOND I,20,19.4,139,27,112,lan
393,DelvinBeltre,DIAMOND I,19,14.6,301,44,257,lan
394,XmagodiosX,DIAMOND I,19,16.4,201,33,168,lan
395,Mr 139610051704,DIAMOND I,19,15.2,145,22,123,lan
396,The Fhack23,DIAMOND I,18,15.9,848,135,713,lan
397,JotaJota507,DIAMOND I,18,10.7,915,98,817,lan
398,Canbun,DIAMOND I,18,19.2,318,61,257,lan
399,Melec,DIAMOND I,18,21.4,229,49,180,lan
400,captainfifi,DIAMOND I,18,20.2,94,19,75,lan
401,DhannielUchiha,DIAMOND I,17,17.2,233,40,193,lan
402,Brazen,DIAMOND I,17,15.2,210,32,178,lan
403,Planeta,DIAMOND I,16,15.8,1426,225,1201,lan
404,La Fiera Deidad,DIAMOND I,16,19.4,474,92,382,lan
405,CLK1,DIAMOND I,16,21.8,124,27,97,lan
406,Rak Hollow,DIAMOND I,16,13.5,178,24,154,lan
407,jjvanegask77,DIAMOND I,15,17.6,165,29,136,lan
408,El Cholo Ivan 25,DIAMOND I,14,17.9,313,56,257,lan
409,moonify,DIAMOND I,13,14.9,482,72,410,lan
410,Tømmy Wiseau,DIAMOND I,13,14.7,463,68,395,lan
411,Tocino,DIAMOND I,13,23.1,173,40,133,lan
412,Crackie,DIAMOND I,12,12.1,586,71,515,lan
413,INF Rohclem,DIAMOND I,12,12.8,188,24,164,lan
414,zBoanerGes,DIAMOND I,11,15.5,187,29,158,lan
415,OTP Rumble,DIAMOND I,11,15.8,158,25,133,lan
416,FV oglam,DIAMOND I,10,17.9,207,37,170,lan
417,PATRlA,DIAMOND I,10,15.4,110,17,93,lan
418,Hugalaoruga,DIAMOND I,8,19.4,227,44,183,lan
419,caifas1995,DIAMOND I,7,18.4,596,110,486,lan
420,Churritoo,DIAMOND I,7,17.2,402,69,333,lan
421,WindUp Boy,DIAMOND I,7,20.1,314,63,251,lan
422,Fireyix,DIAMOND I,7,22.6,177,40,137,lan
423,Hide on Petare,DIAMOND I,7,27.4,117,32,85,lan
424,NedS3,DIAMOND I,6,16.4,378,62,316,lan
425,Kestoc,DIAMOND I,6,16.2,228,37,191,lan
426,Gedo Yoch,DIAMOND I,5,16.9,154,26,128,lan
427,Da Fuking Rengar,DIAMOND I,4,19.6,306,60,246,lan
428,Yagami Squall,DIAMOND I,4,14.9,363,54,309,lan
429,Dont Lose Aru,DIAMOND I,4,13.5,333,45,288,lan
430,Níetzsche,DIAMOND I,4,27.5,120,33,87,lan
431,JULK37,DIAMOND I,4,15.4,149,23,126,lan
432,Loptyr,DIAMOND I,4,15.3,144,22,122,lan
433,Virgen Guadalupe,DIAMOND I,3,16.4,377,62,315,lan
434,Zoh Rain Munda,DIAMOND I,3,15.6,250,39,211,lan
435,S0BerB1a,DIAMOND I,2,13.7,677,93,584,lan
436,Epic Diozgor,DIAMOND I,2,15.9,282,45,237,lan
437,ChupemElPrime,DIAMOND I,1,19.8,273,54,219,lan
438,Best Amumu Korea,DIAMOND I,1,18.5,260,48,212,lan
439,Miguel Aleman,DIAMOND I,1,16.7,192,32,160,lan
440,SAV Nooba,DIAMOND I,1,18.1,149,27,122,lan
441,Topoyiyo100,DIAMOND I,1,15.9,163,26,137,lan
442,CeldriKingleSs,DIAMOND I,0,15.5,1577,244,1333,lan
443,WorstHierbaMala,DIAMOND I,0,21.2,433,92,341,lan
444,Secco,DIAMOND I,0,16.9,533,90,443,lan
445,Bréak,DIAMOND I,0,26.1,306,80,226,lan
446,Funtreng,DIAMOND I,0,14.7,491,72,419,lan
447,TheKinginelNorth,DIAMOND I,0,12.7,567,72,495,lan
448,Cristhianhusk,DIAMOND I,0,17.4,409,71,338,lan
449,Unique Stylish,DIAMOND I,0,20.1,348,70,278,lan
450,Right Cłick,DIAMOND I,0,16.4,428,70,358,lan
451,BLACKCAMON,DIAMOND I,0,19.9,311,62,249,lan
452,Nikyu,DIAMOND I,0,21.8,275,60,215,lan
453,JeremyHax,DIAMOND I,0,16.8,345,58,287,lan
454,Agonys Embrace,DIAMOND I,0,16.5,346,57,289,lan
455,caguilarg96,DIAMOND I,0,20.5,273,56,217,lan
456,Yuuru,DIAMOND I,0,20.4,270,55,215,lan
457,Independent Cat,DIAMOND I,0,15.9,340,54,286,lan
458,VenezueLAN TFT,DIAMOND I,0,10.2,517,53,464,lan
459,Byaku Desu,DIAMOND I,0,21.7,230,50,180,lan
460,0 Horus,DIAMOND I,0,16.3,307,50,257,lan
461,Adele,DIAMOND I,0,21.0,229,48,181,lan
462,Noob Daniel,DIAMOND I,0,17.8,269,48,221,lan
463,7thLegion,DIAMOND I,0,21.6,204,44,160,lan
464,Neär,DIAMOND I,0,13.3,331,44,287,lan
465,MessiG45,DIAMOND I,0,16.9,254,43,211,lan
466,Des Lichts,DIAMOND I,0,16.4,262,43,219,lan
467,Seikap,DIAMOND I,0,11.7,367,43,324,lan
468,Marvelous,DIAMOND I,0,16.4,256,42,214,lan
469,Diego Abraham SP,DIAMOND I,0,21.8,188,41,147,lan
470,l Bipolar l,DIAMOND I,0,20.6,199,41,158,lan
471,RomaTroyano,DIAMOND I,0,20.5,195,40,155,lan
472,Leonidasfed,DIAMOND I,0,14.1,284,40,244,lan
473,maykol06,DIAMOND I,0,17.2,227,39,188,lan
474,El Dque,DIAMOND I,0,22.1,172,38,134,lan
475,JhonWonka,DIAMOND I,0,20.2,183,37,146,lan
476,javierpe,DIAMOND I,0,19.8,187,37,150,lan
477,S 3 K K I,DIAMOND I,0,16.7,222,37,185,lan
478,xDuke ł,DIAMOND I,0,19.9,176,35,141,lan
479,MG Japo,DIAMOND I,0,19.4,180,35,145,lan
480,matazorros,DIAMOND I,0,18.5,189,35,154,lan
481,RNG Ktr0,DIAMOND I,0,28.1,121,34,87,lan
482,Fayrer,DIAMOND I,0,15.4,221,34,187,lan
483,Seexy INFECTION,DIAMOND I,0,23.0,139,32,107,lan
484,lSorol,DIAMOND I,0,19.7,147,29,118,lan
485,Gyró Zeppeli,DIAMOND I,0,18.1,160,29,131,lan
486,danilo00,DIAMOND I,0,13.9,209,29,180,lan
487,Chibs TFT,DIAMOND I,0,15.4,182,28,154,lan
488,All for Øne,DIAMOND I,0,15.4,169,26,143,lan
489,OTP Vladimir,DIAMOND I,0,16.8,143,24,119,lan
490,Frani,DIAMOND I,0,14.9,154,23,131,lan
491,ZOLE,DIAMOND I,0,12.2,188,23,165,lan
492,TSM Hiro,DIAMOND I,0,15.9,138,22,116,lan
493,Deleth,DIAMOND I,0,18.6,113,21,92,lan
494,edhson19,DIAMOND I,0,16.1,124,20,104,lan
495,Xero Mad,DIAMOND I,0,9.1,186,17,169,lan
496,Blach,DIAMOND I,0,17.6,91,16,75,lan
497,Lelauch,DIAMOND II,99,21.9,164,36,128,lan
498,Spooky boogie,DIAMOND II,99,10.1,276,28,248,lan
499,R2FarwolD2,DIAMOND II,96,20.0,130,26,104,lan
500,Zhørieg,DIAMOND II,93,17.6,199,35,164,lan
1,FaryaAndWoIyo,CHALLENGER I,1768,29.5,349,103,246,las
2,Shireen4,CHALLENGER I,1684,27.3,502,137,365,las
3,Kłaytøn,CHALLENGER I,1600,25.0,404,101,303,las
4,Tolengo73,CHALLENGER I,1225,27.2,519,141,378,las
5,S de Sencillo,CHALLENGER I,1139,18.7,1348,252,1096,las
6,JustDream,CHALLENGER I,1049,17.7,909,161,748,las
7,DarksBit,CHALLENGER I,993,24.0,254,61,193,las
8,UCH TheLiNe,CHALLENGER I,956,30.8,260,80,180,las
9,Highroll,CHALLENGER I,888,20.2,639,129,510,las
10,No Quarter,CHALLENGER I,844,21.5,386,83,303,las
11,Altenahue,CHALLENGER I,833,22.9,488,112,376,las
12,Samenix,CHALLENGER I,811,27.4,285,78,207,las
13,FuryTank,CHALLENGER I,768,21.7,327,71,256,las
14,Priend,CHALLENGER I,760,17.9,621,111,510,las
15,CooLDownJJ,CHALLENGER I,696,25.0,296,74,222,las
16,Fourloko RX,CHALLENGER I,685,21.5,274,59,215,las
17,Fan de la Linea,CHALLENGER I,620,24.9,189,47,142,las
18,LifesBadTFT,CHALLENGER I,599,21.3,253,54,199,las
19,Christus,CHALLENGER I,599,29.9,147,44,103,las
20,Changuito 10,CHALLENGER I,595,22.2,185,41,144,las
21,shuuumpy,CHALLENGER I,568,19.9,413,82,331,las
22,New Stage,CHALLENGER I,523,19.1,324,62,262,las
23,Girlfromnoxuss,CHALLENGER I,522,20.1,623,125,498,las
24,Dukie,CHALLENGER I,510,20.1,184,37,147,las
25,UCH Morfer,CHALLENGER I,498,17.6,290,51,239,las
26,Jesus,CHALLENGER I,489,22.7,141,32,109,las
27,Bugame,CHALLENGER I,480,22.7,220,50,170,las
28,Gara Arg,CHALLENGER I,444,18.8,399,75,324,las
29,Greyd0n,CHALLENGER I,440,13.6,413,56,357,las
30,Åzok,CHALLENGER I,438,15.9,433,69,364,las
31,InvadersMD,CHALLENGER I,435,16.0,718,115,603,las
32,404NameeNotFound,CHALLENGER I,414,16.4,507,83,424,las
33,TFT MMR Perfect,CHALLENGER I,409,17.4,529,92,437,las
34,Karnal,CHALLENGER I,408,15.0,521,78,443,las
35,Wazapper,CHALLENGER I,393,16.2,320,52,268,las
36,Nico Del Baño,CHALLENGER I,377,26.1,153,40,113,las
37,ChakoPopoco,CHALLENGER I,376,15.3,469,72,397,las
38,Cupiditas,CHALLENGER I,373,20.1,304,61,243,las
39,RoSweL TacTicS,CHALLENGER I,368,14.7,890,131,759,las
40,sendohrai,CHALLENGER I,365,18.1,309,56,253,las
41,xiomax,CHALLENGER I,362,16.5,327,54,273,las
42,Lyked,CHALLENGER I,356,25.7,261,67,194,las
43,Rubik,CHALLENGER I,351,17.1,269,46,223,las
44,MorteMTW,CHALLENGER I,346,17.1,602,103,499,las
45,Gei Ye Si,CHALLENGER I,346,19.4,465,90,375,las
46,Fradox22,CHALLENGER I,332,21.3,188,40,148,las
47,100cityfico,CHALLENGER I,330,11.2,472,53,419,las
48,ACÁ MANDO YO,CHALLENGER I,328,20.9,421,88,333,las
49,Tr1ckster,CHALLENGER I,253,29.7,111,33,78,las
50,SouLXisT,CHALLENGER I,232,19.5,226,44,182,las
51,AUGUSTOMARCO,"GRANDMASTER I
G",345,14.7,339,50,289,las
52,MättZ,"GRANDMASTER I
G",335,11.3,503,57,446,las
53,iudex Jevic,"GRANDMASTER I
G",326,17.5,726,127,599,las
54,Emad Joestar,"GRANDMASTER I
G",314,18.1,210,38,172,las
55,Don Galli,"GRANDMASTER I
G",313,19.7,157,31,126,las
56,ElbalmoR,"GRANDMASTER I
G",295,17.3,289,50,239,las
57,ssbita,"GRANDMASTER I
G",285,18.6,306,57,249,las
58,Cvictoria Bryant,"GRANDMASTER I
G",281,16.3,467,76,391,las
59,ANIMEWEEBLORD420,"GRANDMASTER I
G",277,25.0,124,31,93,las
60,iForeverBronze,"GRANDMASTER I
G",239,16.8,793,133,660,las
61,Raruto,"GRANDMASTER I
G",236,14.0,264,37,227,las
62,Broncelotee,"GRANDMASTER I
G",222,15.1,457,69,388,las
63,RetoSuperado,"GRANDMASTER I
G",222,15.5,349,54,295,las
64,Desgr4cia,"GRANDMASTER I
G",218,10.4,1005,105,900,las
65,HeRz BenT,"GRANDMASTER I
G",213,19.6,327,64,263,las
66,ROH inSec t0,"GRANDMASTER I
G",207,14.1,418,59,359,las
67,TwitchTVLifesBad,"GRANDMASTER I
G",203,26.5,151,40,111,las
68,DONBOMBASTIC,"GRANDMASTER I
G",200,17.1,269,46,223,las
69,Elsa Nito,"GRANDMASTER I
G",196,14.4,431,62,369,las
70,JueguenNormal,"GRANDMASTER I
G",187,14.9,469,70,399,las
71,geoffroy123,"GRANDMASTER I
G",186,14.5,145,21,124,las
72,Ryuuk Kyuu,"GRANDMASTER I
G",185,15.5,161,25,136,las
73,CriXaLis,"GRANDMASTER I
G",178,17.7,423,75,348,las
74,RNGPDD,"GRANDMASTER I
G",178,25.2,103,26,77,las
75,StuPot,"GRANDMASTER I
G",174,16.6,290,48,242,las
76,Mr GFS Reaper,"GRANDMASTER I
G",160,21.5,474,102,372,las
77,TWOEASY,"GRANDMASTER I
G",160,13.7,262,36,226,las
78,hartung,"GRANDMASTER I
G",157,15.5,348,54,294,las
79,Rekatria,"GRANDMASTER I
G",157,17.9,218,39,179,las
80,Kozukî Oden,"GRANDMASTER I
G",156,12.2,237,29,208,las
81,animesenpai2,"GRANDMASTER I
G",153,14.8,250,37,213,las
82,QT FD,"GRANDMASTER I
G",152,17.7,576,102,474,las
83,BC Thoryn,"GRANDMASTER I
G",146,21.0,214,45,169,las
84,KenMasters7,"GRANDMASTER I
G",146,23.1,143,33,110,las
85,Ghosty321,"GRANDMASTER I
G",144,14.6,405,59,346,las
86,Óxidos Basicos,"GRANDMASTER I
G",141,16.3,288,47,241,las
87,BolaDeLomo,"GRANDMASTER I
G",141,15.5,296,46,250,las
88,Xork,"GRANDMASTER I
G",136,20.3,439,89,350,las
89,henryqez,"GRANDMASTER I
G",135,16.2,327,53,274,las
90,Zionooooo,"GRANDMASTER I
G",135,16.5,236,39,197,las
91,ravenoneforeva,"GRANDMASTER I
G",133,20.6,310,64,246,las
92,Dogor,"GRANDMASTER I
G",126,16.4,280,46,234,las
93,Danielove,"GRANDMASTER I
G",125,14.2,360,51,309,las
94,ACD Doomleg,"GRANDMASTER I
G",122,15.0,600,90,510,las
95,CodMeiro,"GRANDMASTER I
G",122,15.1,312,47,265,las
96,LuckyDuit,"GRANDMASTER I
G",119,16.4,281,46,235,las
97,TOXIAS,"GRANDMASTER I
G",118,17.2,186,32,154,las
98,Gaattsu,"GRANDMASTER I
G",116,12.9,535,69,466,las
99,YourGod22,"GRANDMASTER I
G",116,12.5,248,31,217,las
100,xaimmer,"GRANDMASTER I
G",115,16.8,507,85,422,las
101,Daian21,"GRANDMASTER I
G",112,8.5,401,34,367,las
102,NOSABIAQUEPONE,"GRANDMASTER I
G",111,16.8,191,32,159,las
103,VortexN,"GRANDMASTER I
G",108,14.9,396,59,337,las
104,NachoG95,"GRANDMASTER I
G",106,16.9,492,83,409,las
105,Masul,"GRANDMASTER I
G",102,18.2,319,58,261,las
106,zaqlev,"GRANDMASTER I
G",101,18.0,266,48,218,las
107,Dtoke Freestyler,"GRANDMASTER I
G",99,13.9,452,63,389,las
108,WaIter White Jr,"GRANDMASTER I
G",99,13.2,415,55,360,las
109,Peronism,"GRANDMASTER I
G",94,14.8,283,42,241,las
110,EMiguel,"GRANDMASTER I
G",94,20.8,168,35,133,las
111,KeRikoWisKi,"GRANDMASTER I
G",91,14.9,268,40,228,las
112,ElnicoMata,"GRANDMASTER I
G",90,12.2,674,82,592,las
113,LOLEROPERONOPACO,"GRANDMASTER I
G",89,19.0,305,58,247,las
114,CuriousChameIeon,"GRANDMASTER I
G",88,20.5,415,85,330,las
115,xZaMaSx,"GRANDMASTER I
G",88,16.2,363,59,304,las
116,toy chikita,"GRANDMASTER I
G",88,21.2,207,44,163,las
117,Daelon TFT,"GRANDMASTER I
G",85,12.9,409,53,356,las
118,Luchiiitoo,"GRANDMASTER I
G",82,14.0,342,48,294,las
119,Hardcorito Facho,"GRANDMASTER I
G",82,17.6,227,40,187,las
120,Dungeon,"GRANDMASTER I
G",79,16.2,383,62,321,las
121,TU WAIFU ME AMA,"GRANDMASTER I
G",77,17.9,173,31,142,las
122,Shadow Ares,"GRANDMASTER I
G",77,16.0,156,25,131,las
123,Lyrion Tannister,"GRANDMASTER I
G",76,20.0,245,49,196,las
124,iPurge1,"GRANDMASTER I
G",73,13.7,386,53,333,las
125,Cv 366,"GRANDMASTER I
G",72,17.5,206,36,170,las
126,WWWWWWW,"GRANDMASTER I
G",68,14.9,368,55,313,las
127,el ayuwóki,"GRANDMASTER I
G",67,14.8,479,71,408,las
128,SlashFullMuteAll,"GRANDMASTER I
G",67,15.7,337,53,284,las
129,UCH StartNoob,"GRANDMASTER I
G",67,12.4,217,27,190,las
130,TheClasman,"GRANDMASTER I
G",66,14.6,412,60,352,las
131,Sáyron,"GRANDMASTER I
G",65,13.2,433,57,376,las
132,Sirzechsl,"GRANDMASTER I
G",65,13.2,415,55,360,las
133,Crux,"GRANDMASTER I
G",61,15.5,348,54,294,las
134,ElDryzler,"GRANDMASTER I
G",60,11.8,373,44,329,las
135,El Gørdo J,"GRANDMASTER I
G",59,15.9,548,87,461,las
136,Zeikana,"GRANDMASTER I
G",59,17.2,348,60,288,las
137,BTS TFT Player,"GRANDMASTER I
G",58,21.6,306,66,240,las
138,TheDanieTFT,"GRANDMASTER I
G",57,13.2,182,24,158,las
139,Lean Live,"GRANDMASTER I
G",56,14.2,331,47,284,las
140,KravenPa,"GRANDMASTER I
G",55,17.1,427,73,354,las
141,psyque,"GRANDMASTER I
G",55,19.5,195,38,157,las
142,Tactics iBaggy,"GRANDMASTER I
G",54,14.8,230,34,196,las
143,Ola soi Smurf,"GRANDMASTER I
G",53,32.9,82,27,55,las
144,Kellu Afen,"GRANDMASTER I
G",51,16.4,269,44,225,las
145,TiagoAbner,"GRANDMASTER I
G",51,13.3,294,39,255,las
146,Keru,"GRANDMASTER I
G",50,16.0,331,53,278,las
147,Stoned Bulbasaur,"GRANDMASTER I
G",31,13.2,197,26,171,las
148,Arizona Zervas,"GRANDMASTER I
G",26,16.1,347,56,291,las
149,dimeloneri,"GRANDMASTER I
G",15,12.6,325,41,284,las
150,KTP Yoshi,MASTER I,87,13.7,444,61,383,las
151,HuNnnTeR,MASTER I,79,16.4,793,130,663,las
152,64 Bits,MASTER I,73,13.7,233,32,201,las
153,Haise,MASTER I,73,16.3,172,28,144,las
154,Xerwell,MASTER I,59,15.1,404,61,343,las
155,Necroshine77,MASTER I,57,19.4,372,72,300,las
156,Viangrele,MASTER I,55,24.8,303,75,228,las
157,spiirati,MASTER I,54,15.0,407,61,346,las
158,Beldum,MASTER I,54,16.2,290,47,243,las
159,Ledasor,MASTER I,53,21.5,214,46,168,las
160,carkrod,MASTER I,52,14.6,678,99,579,las
161,SOY AGNÓSTICO,MASTER I,52,13.2,304,40,264,las
162,Penzio,MASTER I,50,13.2,273,36,237,las
163,Blasgare,MASTER I,49,9.2,337,31,306,las
164,IICelesteII,MASTER I,46,15.8,602,95,507,las
165,Kamajuchi77,MASTER I,42,16.1,572,92,480,las
166,GGetafe,MASTER I,41,18.9,550,104,446,las
167,El Palo Me Mama,MASTER I,41,19.8,182,36,146,las
168,xFlogger,MASTER I,39,15.8,438,69,369,las
169,LIEUTENANT DAN,MASTER I,36,17.6,273,48,225,las
170,tft main lol,MASTER I,36,21.8,101,22,79,las
171,LioCR7,MASTER I,35,14.6,500,73,427,las
172,Heisnb3rg,MASTER I,30,19.0,205,39,166,las
173,Spaark  TFT,MASTER I,29,15.9,189,30,159,las
174,Brooklyn Baby,MASTER I,26,24.4,156,38,118,las
175,Tortuga Inmortal,MASTER I,24,13.7,481,66,415,las
176,xikhario,MASTER I,23,16.1,322,52,270,las
177,HUAWEI AFeng,MASTER I,23,31.0,71,22,49,las
178,guitardead,MASTER I,22,18.2,209,38,171,las
179,Ingeld,MASTER I,21,14.9,397,59,338,las
180,ikarosdesu,MASTER I,21,16.2,111,18,93,las
181,Chino Rios,MASTER I,20,18.0,439,79,360,las
182,Error 402,MASTER I,20,14.2,204,29,175,las
183,Belfreath,MASTER I,19,12.2,294,36,258,las
184,LL Jhin,MASTER I,19,15.8,183,29,154,las
185,Niño Sad,MASTER I,17,19.1,246,47,199,las
186,UruSativaCarryJr,MASTER I,17,20.5,215,44,171,las
187,Twitch Jaypi9,MASTER I,16,16.1,719,116,603,las
188,UCH Koro,MASTER I,16,17.2,342,59,283,las
189,Farnese,MASTER I,15,15.3,489,75,414,las
190,Sadness Xiu,MASTER I,15,11.9,285,34,251,las
191,Super Carlitos,MASTER I,14,11.9,552,66,486,las
192,Zoa,MASTER I,14,16.3,208,34,174,las
193,Hao,MASTER I,14,9.9,202,20,182,las
194,God DMZ,MASTER I,12,16.3,331,54,277,las
195,Kiroichy,MASTER I,12,21.3,230,49,181,las
196,T2W DOGORwashere,MASTER I,12,19.6,250,49,201,las
197,Seminare,MASTER I,11,16.4,310,51,259,las
198,TFT daddy,MASTER I,11,19.5,195,38,157,las
199,Quantum Cobalt,MASTER I,10,17.1,275,47,228,las
200,LeBlanc Uchiha,MASTER I,9,14.1,1081,152,929,las
201,Wolf Bak,MASTER I,9,15.8,457,72,385,las
202,Casi te gano,MASTER I,9,8.1,848,69,779,las
203,El Dorainiken,MASTER I,9,17.1,280,48,232,las
204,Riften,MASTER I,9,16.5,182,30,152,las
205,Naron Bashor,MASTER I,8,13.0,408,53,355,las
206,MaurooCARP,MASTER I,8,18.0,233,42,191,las
207,1nstant Karma,MASTER I,7,15.5,368,57,311,las
208,Deku611,MASTER I,7,12.6,420,53,367,las
209,Dycoop,MASTER I,7,18.6,188,35,153,las
210,CisTHD,MASTER I,6,15.8,467,74,393,las
211,SubLimE QQ,MASTER I,6,20.6,253,52,201,las
212,Mapachee,MASTER I,5,20.9,378,79,299,las
213,Pochocles,MASTER I,5,18.8,261,49,212,las
214,Pandiwe2K,MASTER I,5,18.8,160,30,130,las
215,Gramitaa,MASTER I,4,15.9,351,56,295,las
216,Trimsk,MASTER I,4,14.7,245,36,209,las
217,Sikolio,MASTER I,3,18.4,396,73,323,las
218,Berzedker,MASTER I,3,17.6,272,48,224,las
219,Best Teemo LAS,MASTER I,2,15.9,478,76,402,las
220,Perekkles,MASTER I,2,17.9,307,55,252,las
221,Serteck,MASTER I,2,17.2,209,36,173,las
222,LeoPalac10,MASTER I,2,19.8,177,35,142,las
223,xXWelintonQuiwXx,MASTER I,2,11.9,210,25,185,las
224,Gasté 13900 IP,MASTER I,1,16.8,368,62,306,las
225,shxpeetheee,MASTER I,1,12.9,356,46,310,las
226,OgilvyRaboLoko,MASTER I,1,15.2,276,42,234,las
227,Alberto Canto,MASTER I,1,23.5,170,40,130,las
228,Preshelec,MASTER I,1,15.7,178,28,150,las
229,Termo Stan Lee,MASTER I,1,23.0,100,23,77,las
230,TonnyD,MASTER I,0,22.9,459,105,354,las
231,n50,MASTER I,0,17.8,546,97,449,las
232,Josecristo,MASTER I,0,15.3,516,79,437,las
233,MamàEstaPresa,MASTER I,0,21.5,302,65,237,las
234,Pastero en Bici,MASTER I,0,16.7,384,64,320,las
235,SIMPH,MASTER I,0,20.4,280,57,223,las
236,xXhermaniguiXx,MASTER I,0,19.9,276,55,221,las
237,El Magias TFT,MASTER I,0,18.4,298,55,243,las
238,FacuBenedetti,MASTER I,0,13.0,400,52,348,las
239,khotax,MASTER I,0,15.0,340,51,289,las
240,AnimalBlanco,MASTER I,0,10.8,433,47,386,las
241,Piash,MASTER I,0,16.3,251,41,210,las
242,Hukka,MASTER I,0,16.9,237,40,197,las
243,Down Powers,MASTER I,0,20.6,189,39,150,las
244,skeeve,MASTER I,0,17.5,211,37,174,las
245,Fuji,MASTER I,0,14.3,238,34,204,las
246,Darkscreem,MASTER I,0,10.8,279,30,249,las
247,iEgoist,MASTER I,0,13.9,209,29,180,las
248,xTato,MASTER I,0,14.6,185,27,158,las
249,GALLig,MASTER I,0,33.3,78,26,52,las
250,Zpeed,MASTER I,0,12.6,206,26,180,las
251,Fugazi,MASTER I,0,22.5,71,16,55,las
252,Te Xuan Ze,MASTER I,0,10.4,154,16,138,las
253,Random Plâyer,DIAMOND I,99,17.2,511,88,423,las
254,Im not Frisco,DIAMOND I,99,14.5,214,31,183,las
255,SoyPis,DIAMOND I,96,15.8,569,90,479,las
256,Asolea Tela No,DIAMOND I,93,20.7,300,62,238,las
257,MateDeCoco,DIAMOND I,90,16.9,207,35,172,las
258,manuaj97,DIAMOND I,88,17.2,192,33,159,las
259,Celtiwi,DIAMOND I,87,17.6,278,49,229,las
260,Lonkiwi,DIAMOND I,84,16.0,430,69,361,las
261,sakuraU,DIAMOND I,84,17.5,166,29,137,las
262,Cueervoo,DIAMOND I,79,14.8,426,63,363,las
263,Ye Feng,DIAMOND I,78,19.8,374,74,300,las
264,saitosan1,DIAMOND I,75,12.8,870,111,759,las
265,Fifiii,DIAMOND I,75,17.3,370,64,306,las
266,CZ Furudo Nate,DIAMOND I,75,16.8,382,64,318,las
267,miami115,DIAMOND I,75,17.4,345,60,285,las
268,ElPantuGG,DIAMOND I,75,20.4,255,52,203,las
269,Little Rookiee,DIAMOND I,75,20.8,245,51,194,las
270,Yruke,DIAMOND I,75,16.0,300,48,252,las
271,xiduoduo,DIAMOND I,75,21.8,170,37,133,las
272,Gressu,DIAMOND I,75,13.5,259,35,224,las
273,Nicops1231,DIAMOND I,75,16.9,189,32,157,las
274,Doni,DIAMOND I,75,17.0,182,31,151,las
275,Óxidos Ácidos,DIAMOND I,75,18.5,162,30,132,las
276,LionLAN,DIAMOND I,75,28.0,75,21,54,las
277,nymph666,DIAMOND I,74,12.6,366,46,320,las
278,OrangeMoon,DIAMOND I,71,18.8,911,171,740,las
279,Areee,DIAMOND I,70,16.5,243,40,203,las
280,Efesum,DIAMOND I,69,17.1,228,39,189,las
281,TuTuRu,DIAMOND I,69,30.4,115,35,80,las
282,skitifornia,DIAMOND I,67,14.2,555,79,476,las
283,ManuelAIcayaga,DIAMOND I,65,15.5,194,30,164,las
284,NOT A MONKEY,DIAMOND I,64,13.5,208,28,180,las
285,SoulStealerr,DIAMOND I,62,15.0,340,51,289,las
286,Ivanovich TFT,DIAMOND I,60,10.8,539,58,481,las
287,Warra,DIAMOND I,60,16.2,290,47,243,las
288,Kraft Tilted,DIAMOND I,59,20.2,287,58,229,las
289,pnc123,DIAMOND I,59,18.1,215,39,176,las
290,SargentoFoley,DIAMOND I,59,23.4,107,25,82,las
291,kraxs,DIAMOND I,57,14.3,476,68,408,las
292,V9 Priax,DIAMOND I,56,23.8,143,34,109,las
293,Carlinhoxs,DIAMOND I,56,14.4,167,24,143,las
294,xPaula,DIAMOND I,55,16.9,362,61,301,las
295,QuiTaEsMalTe,DIAMOND I,54,18.3,317,58,259,las
296,67 iq player,DIAMOND I,54,20.8,120,25,95,las
297,Mid Ghost,DIAMOND I,53,13.8,985,136,849,las
298,Facuu RP,DIAMOND I,53,16.1,454,73,381,las
299,Pinnche,DIAMOND I,52,28.2,223,63,160,las
300,Caver,DIAMOND I,52,15.1,245,37,208,las
301,Echex,DIAMOND I,52,21.9,96,21,75,las
302,Sandsword,DIAMOND I,51,18.3,311,57,254,las
303,Kinimaru,DIAMOND I,51,13.9,238,33,205,las
304,Zeon06,DIAMOND I,50,14.3,608,87,521,las
305,pancitodemoldee,DIAMOND I,50,13.6,440,60,380,las
306,Elba Ginaso,DIAMOND I,50,20.4,289,59,230,las
307,El Chipa,DIAMOND I,50,24.0,221,53,168,las
308,Xavhi,DIAMOND I,50,20.6,257,53,204,las
309,Veni a jugar,DIAMOND I,50,17.3,301,52,249,las
310,TuKoX,DIAMOND I,50,14.7,354,52,302,las
311,ShiroBanee,DIAMOND I,50,11.6,431,50,381,las
312,spartanoperez,DIAMOND I,50,15.1,317,48,269,las
313,pickleegar,DIAMOND I,50,20.5,219,45,174,las
314,Orco13,DIAMOND I,50,17.1,263,45,218,las
315,EdsondoSaantos,DIAMOND I,50,16.6,265,44,221,las
316,BelZeButh,DIAMOND I,50,17.8,241,43,198,las
317,Jordan R Belfort,DIAMOND I,50,23.2,181,42,139,las
318,Yogursito,DIAMOND I,50,15.3,275,42,233,las
319,ßunkow,DIAMOND I,50,21.8,170,37,133,las
320,StarPlzTFT,DIAMOND I,50,17.7,209,37,172,las
321,Gatito Grrrrr,DIAMOND I,50,17.2,215,37,178,las
322,QUIEROmitft,DIAMOND I,50,14.8,243,36,207,las
323,LoLiLoV3r,DIAMOND I,50,22.4,147,33,114,las
324,tomm1g,DIAMOND I,50,15.7,210,33,177,las
325,Jhisus14,DIAMOND I,50,11.4,288,33,255,las
326,Dim4s,DIAMOND I,50,21.6,139,30,109,las
327,Ba5 Menethor,DIAMOND I,50,26.9,104,28,76,las
328,DacerOne,DIAMOND I,50,16.5,170,28,142,las
329,Alapar,DIAMOND I,50,17.9,140,25,115,las
330,Flaco Friky,DIAMOND I,50,14.7,163,24,139,las
331,Bersérker 1,DIAMOND I,48,17.2,308,53,255,las
332,143,DIAMOND I,48,15.8,165,26,139,las
333,Barrioneta,DIAMOND I,46,17.8,309,55,254,las
334,PulpoTiernizado,DIAMOND I,46,11.1,413,46,367,las
335,RestlesSSouL,DIAMOND I,46,11.4,306,35,271,las
336,ProyectD,DIAMOND I,45,14.7,312,46,266,las
337,Tdfdiegoo,DIAMOND I,44,15.9,327,52,275,las
338,miguelDarkGhot,DIAMOND I,43,11.8,348,41,307,las
339,elchicolinux,DIAMOND I,42,16.8,328,55,273,las
340,Chedragon,DIAMOND I,42,12.0,358,43,315,las
341,gabitzz,DIAMOND I,41,11.7,537,63,474,las
342,DTW,DIAMOND I,41,14.0,371,52,319,las
343,Braay,DIAMOND I,41,22.1,208,46,162,las
344,alehhhh,DIAMOND I,40,17.6,631,111,520,las
345,Shinji Ikarii,DIAMOND I,40,9.9,523,52,471,las
346,DTW 2,DIAMOND I,38,16.7,227,38,189,las
347,Pilinvert,DIAMOND I,38,18.5,162,30,132,las
348,nicoffir,DIAMOND I,37,17.5,143,25,118,las
349,xllBorquezzz,DIAMOND I,36,19.2,177,34,143,las
350,dimebag14king,DIAMOND I,35,11.5,453,52,401,las
351,Vorg Zangief,DIAMOND I,35,14.6,343,50,293,las
352,Asteriox,DIAMOND I,35,11.9,227,27,200,las
353,Le Suc,DIAMOND I,35,26.1,92,24,68,las
354,Mr Storm,DIAMOND I,34,19.1,622,119,503,las
355,UCH Dario,DIAMOND I,34,12.1,398,48,350,las
356,Kenshi0,DIAMOND I,33,15.6,250,39,211,las
357,Bladeking107,DIAMOND I,32,14.5,400,58,342,las
358,Leyton0,DIAMOND I,32,20.7,261,54,207,las
359,Glitz,DIAMOND I,32,17.4,115,20,95,las
360,Sparks,DIAMOND I,32,16.8,119,20,99,las
361,SilverChains,DIAMOND I,31,25.2,135,34,101,las
362,lManno,DIAMOND I,30,21.7,286,62,224,las
363,Im Tulancelot,DIAMOND I,30,21.3,202,43,159,las
364,Mitsuri Kanroji,DIAMOND I,29,14.9,562,84,478,las
365,relax bro,DIAMOND I,29,13.9,344,48,296,las
366,Sebamegaa,DIAMOND I,28,18.1,558,101,457,las
367,juanferquinterop,DIAMOND I,28,14.9,234,35,199,las
368,Cronoz,DIAMOND I,27,21.9,233,51,182,las
369,Gearth,DIAMOND I,27,16.7,156,26,130,las
370,Cheche tft,DIAMOND I,26,17.5,383,67,316,las
371,LionFlashVoice,DIAMOND I,26,13.1,236,31,205,las
372,thereisnourflvl,DIAMOND I,25,26.8,250,67,183,las
373,elgodi,DIAMOND I,25,22.0,264,58,206,las
374,YinSaori,DIAMOND I,25,21.3,253,54,199,las
375,Øbi,DIAMOND I,25,23.2,211,49,162,las
376,DogeSenpai,DIAMOND I,25,12.0,408,49,359,las
377,The Unƒørgiven,DIAMOND I,25,15.9,283,45,238,las
378,thepappo,DIAMOND I,25,17.5,234,41,193,las
379,Nerhuk,DIAMOND I,25,13.9,274,38,236,las
380,Jupeson,DIAMOND I,24,14.0,551,77,474,las
381,Evasor07,DIAMOND I,23,19.9,201,40,161,las
382,LK Kuty,DIAMOND I,22,15.3,241,37,204,las
383,Shako,DIAMOND I,22,14.3,217,31,186,las
384,Rodd26,DIAMOND I,22,14.0,186,26,160,las
385,xl Zero lx,DIAMOND I,21,12.3,707,87,620,las
386,TFT Skills,DIAMOND I,21,10.5,532,56,476,las
387,The Katarina,DIAMOND I,21,14.3,238,34,204,las
388,Krayziql,DIAMOND I,21,16.6,163,27,136,las
389,Mitsukurina,DIAMOND I,20,18.4,217,40,177,las
390,generaldark,DIAMOND I,20,22.9,153,35,118,las
391,moisesinho1,DIAMOND I,20,22.0,141,31,110,las
392,Alecis,DIAMOND I,19,16.9,602,102,500,las
393,LenzU,DIAMOND I,19,20.8,168,35,133,las
394,xLuxray729,DIAMOND I,18,22.5,284,64,220,las
395,Kog Mawrley,DIAMOND I,18,19.1,178,34,144,las
396,elPepi,DIAMOND I,18,13.1,183,24,159,las
397,Bandalians,DIAMOND I,17,14.8,1004,149,855,las
398,AlcaTeD,DIAMOND I,17,12.9,394,51,343,las
399,thunderboy4000,DIAMOND I,17,11.4,297,34,263,las
400,Agustin4521,DIAMOND I,16,18.9,359,68,291,las
401,Batmen104,DIAMOND I,15,17.2,552,95,457,las
402,Dorre912,DIAMOND I,15,14.2,431,61,370,las
403,Pinsto,DIAMOND I,15,19.5,210,41,169,las
404,Krovsavetik,DIAMOND I,15,13.1,274,36,238,las
405,RevëntXz,DIAMOND I,15,19.8,177,35,142,las
406,DAM Cacu,DIAMOND I,14,16.7,209,35,174,las
407,Batthory,DIAMOND I,14,20.9,91,19,72,las
408,Evil Puppy,DIAMOND I,12,20.9,703,147,556,las
409,YvesMad,DIAMOND I,12,22.0,141,31,110,las
410,NoobPlayerOfTFT,DIAMOND I,11,10.8,646,70,576,las
411,Ac Comprar Am,DIAMOND I,11,15.0,187,28,159,las
412,REPORT PIÑERA BG,DIAMOND I,11,14.6,192,28,164,las
413,EL Empijjado,DIAMOND I,10,13.0,1217,158,1059,las
414,deBlois,DIAMOND I,10,16.7,324,54,270,las
415,QQPanda,DIAMOND I,10,24.5,159,39,120,las
416,PapáDeNelson,DIAMOND I,9,12.0,382,46,336,las
417,Aizer,DIAMOND I,9,15.4,169,26,143,las
418,JacKp0t,DIAMOND I,9,12.5,176,22,154,las
419,SKT Toddy,DIAMOND I,8,12.1,282,34,248,las
420,Howling Abyss,DIAMOND I,8,9.0,200,18,182,las
421,Raceka,DIAMOND I,7,19.0,337,64,273,las
422,YUATI,DIAMOND I,7,17.5,297,52,245,las
423,AlonsOcean,DIAMOND I,7,11.8,348,41,307,las
424,elJebush,DIAMOND I,7,16.9,189,32,157,las
425,The SkyDrill,DIAMOND I,7,21.1,104,22,82,las
426,ShakeITx,DIAMOND I,6,22.2,203,45,158,las
427,sirCOS,DIAMOND I,6,11.4,332,38,294,las
428,JoseFill,DIAMOND I,5,16.7,484,81,403,las
429,fenrir1,DIAMOND I,5,23.4,124,29,95,las
430,JHlN TONIC,DIAMOND I,5,11.9,227,27,200,las
431,VEJ,DIAMOND I,3,14.4,410,59,351,las
432,SanteOtero,DIAMOND I,3,15.9,358,57,301,las
433,Sirìus,DIAMOND I,3,14.6,233,34,199,las
434,Raulvasf,DIAMOND I,2,14.2,331,47,284,las
435,Tuche,DIAMOND I,2,10.6,386,41,345,las
436,xllBorquezzzz,DIAMOND I,2,19.8,162,32,130,las
437,Joakonix,DIAMOND I,2,14.3,195,28,167,las
438,Athyna,DIAMOND I,1,14.3,461,66,395,las
439,LaPalomaMasSeca,DIAMOND I,1,12.1,547,66,481,las
440,Teoo01,DIAMOND I,1,18.6,334,62,272,las
441,vergilcat,DIAMOND I,1,16.7,216,36,180,las
442,Treshyy,DIAMOND I,1,21.9,114,25,89,las
443,GoldenKid,DIAMOND I,0,18.3,823,151,672,las
444,Mefistófelez,DIAMOND I,0,16.6,589,98,491,las
445,p Ø L i,DIAMOND I,0,14.2,486,69,417,las
446,Correator,DIAMOND I,0,17.4,384,67,317,las
447,Fùry,DIAMOND I,0,23.7,274,65,209,las
448,Khezitho,DIAMOND I,0,19.8,318,63,255,las
449,MisterYougi,DIAMOND I,0,18.0,345,62,283,las
450,marm4,DIAMOND I,0,15.6,392,61,331,las
451,sku da cranium,DIAMOND I,0,11.8,517,61,456,las
452,flavve,DIAMOND I,0,18.8,313,59,254,las
453,Tob9,DIAMOND I,0,21.4,271,58,213,las
454,Kimarus,DIAMOND I,0,19.9,292,58,234,las
455,ZaKK wyldEee,DIAMOND I,0,20.4,279,57,222,las
456,God of Zed,DIAMOND I,0,12.6,406,51,355,las
457,Asterister,DIAMOND I,0,18.3,268,49,219,las
458,9MPRFCT,DIAMOND I,0,13.8,354,49,305,las
459,IFrenchBaguette,DIAMOND I,0,18.8,256,48,208,las
460,Empanadadeatun,DIAMOND I,0,17.6,272,48,224,las
461,GeLoOx,DIAMOND I,0,16.7,287,48,239,las
462,maxiiq,DIAMOND I,0,18.1,259,47,212,las
463,sebamarosses24,DIAMOND I,0,18.2,252,46,206,las
464,Fiora y Fauna,DIAMOND I,0,15.4,286,44,242,las
465,Dime Kephrii,DIAMOND I,0,10.1,415,42,373,las
466,Romicop,DIAMOND I,0,18.8,213,40,173,las
467,Tazzadar,DIAMOND I,0,16.3,245,40,205,las
468,Racsøø,DIAMOND I,0,14.9,262,39,223,las
469,Pablinucu5,DIAMOND I,0,17.4,212,37,175,las
470,ÞŸËKRÖÖŠ TFT,DIAMOND I,0,12.2,304,37,267,las
471,AKA Mudo,DIAMOND I,0,7.7,483,37,446,las
472,PyschoCabra,DIAMOND I,0,24.6,146,36,110,las
473,Ted,DIAMOND I,0,22.9,157,36,121,las
474,Fearl3ss,DIAMOND I,0,26.4,129,34,95,las
475,leoShiShi,DIAMOND I,0,19.5,174,34,140,las
476,TsubasOSO,DIAMOND I,0,17.5,194,34,160,las
477,uwu,DIAMOND I,0,20.1,164,33,131,las
478,OzoneX,DIAMOND I,0,19.9,166,33,133,las
479,DeathRøw,DIAMOND I,0,16.2,203,33,170,las
480,Alamvre,DIAMOND I,0,16.8,191,32,159,las
481,No es mi dia bro,DIAMOND I,0,15.4,208,32,176,las
482,Luh,DIAMOND I,0,15.9,195,31,164,las
483,Zelk,DIAMOND I,0,15.5,200,31,169,las
484,WolfsenpaiAwA,DIAMOND I,0,10.7,289,31,258,las
485,væRge,DIAMOND I,0,16.9,171,29,142,las
486,LIl Scioli,DIAMOND I,0,13.8,210,29,181,las
487,Im Tatan,DIAMOND I,0,16.9,154,26,128,las
488,Zelowan,DIAMOND I,0,13.8,189,26,163,las
489,zash9503,DIAMOND I,0,21.6,116,25,91,las
490,KosKeD10S,DIAMOND I,0,17.4,144,25,119,las
491,Dont Ban Lee,DIAMOND I,0,14.5,172,25,147,las
492,Te Apoyo,DIAMOND I,0,17.7,130,23,107,las
493,NazGúl OP,DIAMOND I,0,12.0,183,22,161,las
494,Iee sin god,DIAMOND I,0,16.7,126,21,105,las
495,Don Lonchera,DIAMOND I,0,14.4,111,16,95,las
496,GhostrickLantern,DIAMOND II,99,13.7,306,42,264,las
497,Itáchi,DIAMOND II,99,11.7,247,29,218,las
498,Zoeciety,DIAMOND II,98,10.1,416,42,374,las
499,matiashe01,DIAMOND II,96,24.7,186,46,140,las
500,SirBłack,DIAMOND II,95,14.8,325,48,277,las
1,vx s5683169,CHALLENGER I,1081,24.4,406,99,307,oce
2,Angora,CHALLENGER I,995,26.2,351,92,259,oce
3,CombatEZ,CHALLENGER I,881,25.9,162,42,120,oce
4,KirinSupreme,CHALLENGER I,842,19.5,472,92,380,oce
5,I Want You,CHALLENGER I,608,18.9,577,109,468,oce
6,Steve Lau,CHALLENGER I,578,21.7,898,195,703,oce
7,JimJaam,CHALLENGER I,565,19.6,468,92,376,oce
8,ilikeud,CHALLENGER I,492,22.2,243,54,189,oce
9,Rng28002200,CHALLENGER I,473,21.9,169,37,132,oce
10,HatsuneMik,CHALLENGER I,464,25.4,165,42,123,oce
11,Blender Main,CHALLENGER I,463,21.0,181,38,143,oce
12,dz2,CHALLENGER I,459,13.9,452,63,389,oce
13,humperdink,CHALLENGER I,441,17.1,433,74,359,oce
14,m2att,CHALLENGER I,413,14.9,1021,152,869,oce
15,jiaonizuodog,CHALLENGER I,410,18.6,657,122,535,oce
16,Last Wh1sper,CHALLENGER I,389,23.3,163,38,125,oce
17,Kïng Tryndamere,CHALLENGER I,379,18.0,428,77,351,oce
18,ˇPhoenix,CHALLENGER I,378,23.6,317,75,242,oce
19,QWERXF,CHALLENGER I,377,21.1,299,63,236,oce
20,yuzhibo777,CHALLENGER I,373,19.4,355,69,286,oce
21,chinaLZH,CHALLENGER I,370,22.7,247,56,191,oce
22,fengyingzhong,CHALLENGER I,367,24.6,122,30,92,oce
23,qp9,CHALLENGER I,354,15.3,359,55,304,oce
24,Jacky Xie,CHALLENGER I,353,22.5,404,91,313,oce
25,dodododododododo,CHALLENGER I,346,20.5,1263,259,1004,oce
26,thedashuaibi,CHALLENGER I,343,19.5,379,74,305,oce
27,MYdi,CHALLENGER I,342,17.4,350,61,289,oce
28,VNLunar,CHALLENGER I,341,13.9,331,46,285,oce
29,Son Chae Young,CHALLENGER I,340,19.4,227,44,183,oce
30,Jack Griffin,CHALLENGER I,336,14.0,307,43,264,oce
31,WIld Sins Main,CHALLENGER I,329,15.1,325,49,276,oce
32,Chatskiiees,CHALLENGER I,327,17.9,526,94,432,oce
33,NayiGOJi,CHALLENGER I,324,19.5,277,54,223,oce
34,BeaBear,CHALLENGER I,317,17.1,334,57,277,oce
35,Cwute Panda,CHALLENGER I,311,16.9,450,76,374,oce
36,smsqs,CHALLENGER I,306,22.7,317,72,245,oce
37,lloydeee,CHALLENGER I,304,20.4,357,73,284,oce
38,Just Mango,CHALLENGER I,303,21.6,314,68,246,oce
39,xg1998,CHALLENGER I,300,16.8,196,33,163,oce
40,Cyphos,CHALLENGER I,298,18.6,388,72,316,oce
41,3uphonium,CHALLENGER I,295,20.8,288,60,228,oce
42,6324ii,CHALLENGER I,293,27.8,133,37,96,oce
43,Damon989,CHALLENGER I,290,19.1,199,38,161,oce
44,Heart1ess,CHALLENGER I,286,20.1,264,53,211,oce
45,LongYu66,CHALLENGER I,285,17.7,328,58,270,oce
46,samesame,CHALLENGER I,274,13.5,466,63,403,oce
47,ggds4y,CHALLENGER I,270,16.7,366,61,305,oce
48,zyoona,CHALLENGER I,243,15.5,386,60,326,oce
49,txtx233,CHALLENGER I,210,17.0,265,45,220,oce
50,Age of Empires 3,CHALLENGER I,209,14.1,453,64,389,oce
51,zhuodaye,"GRANDMASTER I
G",284,17.0,353,60,293,oce
52,plplplpp,"GRANDMASTER I
G",276,22.5,267,60,207,oce
53,MakinSomeBacon,"GRANDMASTER I
G",268,14.4,381,55,326,oce
54,oubo,"GRANDMASTER I
G",256,19.1,324,62,262,oce
55,Jukelord,"GRANDMASTER I
G",255,14.8,311,46,265,oce
56,Law of the few,"GRANDMASTER I
G",250,13.7,663,91,572,oce
57,Madnsss,"GRANDMASTER I
G",238,18.5,222,41,181,oce
58,Fischball,"GRANDMASTER I
G",236,18.7,182,34,148,oce
59,PPAP,"GRANDMASTER I
G",229,13.3,330,44,286,oce
60,Escha,"GRANDMASTER I
G",226,13.7,597,82,515,oce
61,sorryimlikethis,"GRANDMASTER I
G",222,24.2,268,65,203,oce
62,Reborn Myth,"GRANDMASTER I
G",222,12.5,449,56,393,oce
63,YILINHHH,"GRANDMASTER I
G",218,15.7,351,55,296,oce
64,Slayer Bo,"GRANDMASTER I
G",214,17.5,303,53,250,oce
65,lovestarrysky,"GRANDMASTER I
G",211,17.3,521,90,431,oce
66,zofou,"GRANDMASTER I
G",211,17.1,409,70,339,oce
67,Maxilees,"GRANDMASTER I
G",211,16.2,204,33,171,oce
68,jieshao211,"GRANDMASTER I
G",206,18.1,188,34,154,oce
69,zhangtao666,"GRANDMASTER I
G",204,23.2,151,35,116,oce
70,Dunk xiaolu,"GRANDMASTER I
G",200,17.0,447,76,371,oce
71,Bruceissss,"GRANDMASTER I
G",198,18.1,514,93,421,oce
72,821,"GRANDMASTER I
G",198,15.1,325,49,276,oce
73,Laotie Letsgo,"GRANDMASTER I
G",198,25.2,147,37,110,oce
74,1234mutouren,"GRANDMASTER I
G",198,21.3,94,20,74,oce
75,ihjkljg,"GRANDMASTER I
G",195,16.7,234,39,195,oce
76,TonystarkIRON,"GRANDMASTER I
G",195,25.2,127,32,95,oce
77,CampBishop,"GRANDMASTER I
G",194,21.0,252,53,199,oce
78,Fwuffy Panda,"GRANDMASTER I
G",193,23.7,198,47,151,oce
79,TheExpIosiveTaco,"GRANDMASTER I
G",193,15.6,225,35,190,oce
80,1ydia233,"GRANDMASTER I
G",189,24.3,111,27,84,oce
81,CLMEpapa,"GRANDMASTER I
G",188,17.9,318,57,261,oce
82,Fallangle,"GRANDMASTER I
G",185,19.0,195,37,158,oce
83,aksidhhdid,"GRANDMASTER I
G",170,16.9,502,85,417,oce
84,dxapple,"GRANDMASTER I
G",170,15.6,237,37,200,oce
85,Cuttl3fish,"GRANDMASTER I
G",169,11.7,273,32,241,oce
86,Jinsang,"GRANDMASTER I
G",163,16.9,254,43,211,oce
87,aa1816,"GRANDMASTER I
G",162,16.1,267,43,224,oce
88,faketuoni,"GRANDMASTER I
G",153,15.0,207,31,176,oce
89,Rainbow Baby huh,"GRANDMASTER I
G",146,13.9,237,33,204,oce
90,GiveMeGunS,"GRANDMASTER I
G",140,16.7,192,32,160,oce
91,WU YAN ZZU,"GRANDMASTER I
G",139,14.2,318,45,273,oce
92,bingmoyan,"GRANDMASTER I
G",135,16.5,399,66,333,oce
93,fanfanbaby,"GRANDMASTER I
G",129,30.0,100,30,70,oce
94,Yuki0720,"GRANDMASTER I
G",128,12.2,411,50,361,oce
95,ASJD957,"GRANDMASTER I
G",121,19.4,242,47,195,oce
96,cococake,"GRANDMASTER I
G",120,14.4,353,51,302,oce
97,WO DongDongDong,"GRANDMASTER I
G",120,13.0,392,51,341,oce
98,Lethal Zedstarr,"GRANDMASTER I
G",119,11.5,494,57,437,oce
99,dilisiad,"GRANDMASTER I
G",117,23.3,176,41,135,oce
100,why zyh and pipi,"GRANDMASTER I
G",117,14.3,287,41,246,oce
101,Mo poisoness,"GRANDMASTER I
G",114,18.4,407,75,332,oce
102,Mounty,"GRANDMASTER I
G",112,12.0,574,69,505,oce
103,WayneToDieeeeeee,"GRANDMASTER I
G",110,26.3,152,40,112,oce
104,Mascot,"GRANDMASTER I
G",110,12.5,271,34,237,oce
105,3sansansan,"GRANDMASTER I
G",109,18.4,429,79,350,oce
106,Jum,"GRANDMASTER I
G",109,17.2,209,36,173,oce
107,ImaginaryDragons,"GRANDMASTER I
G",108,11.7,163,19,144,oce
108,king0247,"GRANDMASTER I
G",107,19.5,272,53,219,oce
109,AngelMuzi,"GRANDMASTER I
G",107,21.3,155,33,122,oce
110,DarthRoshan,"GRANDMASTER I
G",105,14.2,353,50,303,oce
111,Whisper9897,"GRANDMASTER I
G",105,16.3,141,23,118,oce
112,the munter,"GRANDMASTER I
G",103,12.0,249,30,219,oce
113,huozhigaoxin,"GRANDMASTER I
G",102,16.8,238,40,198,oce
114,PVC Cai,"GRANDMASTER I
G",95,11.7,420,49,371,oce
115,ANTIQUE HEALBOT,"GRANDMASTER I
G",94,15.6,347,54,293,oce
116,CLUBCANTHANDLEME,"GRANDMASTER I
G",94,16.8,310,52,258,oce
117,kuaileyouxi,"GRANDMASTER I
G",92,23.4,167,39,128,oce
118,vx1123913246,"GRANDMASTER I
G",91,15.7,496,78,418,oce
119,01 04 1999,"GRANDMASTER I
G",88,19.6,189,37,152,oce
120,Yeddie,"GRANDMASTER I
G",86,10.8,1325,143,1182,oce
121,hjhukbt,"GRANDMASTER I
G",86,16.5,327,54,273,oce
122,Side Character,"GRANDMASTER I
G",81,13.0,362,47,315,oce
123,yundingle,"GRANDMASTER I
G",81,22.4,183,41,142,oce
124,weigaosheng,"GRANDMASTER I
G",79,13.6,391,53,338,oce
125,yyg980422,"GRANDMASTER I
G",77,15.6,327,51,276,oce
126,Mikkey,"GRANDMASTER I
G",74,14.5,276,40,236,oce
127,aicmg11111,"GRANDMASTER I
G",74,26.4,91,24,67,oce
128,Simon The Miner,"GRANDMASTER I
G",73,11.2,356,40,316,oce
129,RedHawk101,"GRANDMASTER I
G",72,21.8,354,77,277,oce
130,bankaiteam,"GRANDMASTER I
G",72,17.1,281,48,233,oce
131,Letme11,"GRANDMASTER I
G",72,14.6,315,46,269,oce
132,Whitelight,"GRANDMASTER I
G",72,22.8,101,23,78,oce
133,qkkaannuu,"GRANDMASTER I
G",71,13.7,380,52,328,oce
134,AiryLaMenteuse,"GRANDMASTER I
G",66,15.0,206,31,175,oce
135,WnLyKingKK,"GRANDMASTER I
G",64,16.0,661,106,555,oce
136,Wo Tai Nan Le,"GRANDMASTER I
G",64,14.5,606,88,518,oce
137,dier306,"GRANDMASTER I
G",63,18.5,119,22,97,oce
138,Toby,"GRANDMASTER I
G",62,11.6,251,29,222,oce
139,DegenRolling,"GRANDMASTER I
G",62,34.3,70,24,46,oce
140,dnn,"GRANDMASTER I
G",61,17.1,586,100,486,oce
141,free57,"GRANDMASTER I
G",60,34.1,88,30,58,oce
142,Ni Bie ZouWei le,"GRANDMASTER I
G",59,18.4,653,120,533,oce
143,SilencedbymySins,"GRANDMASTER I
G",58,17.2,145,25,120,oce
144,xiaozhiZP,"GRANDMASTER I
G",55,17.2,406,70,336,oce
145,huya21063703,"GRANDMASTER I
G",43,17.0,159,27,132,oce
146,peppa demon,"GRANDMASTER I
G",41,20.0,150,30,120,oce
147,CterMinh,"GRANDMASTER I
G",20,12.5,424,53,371,oce
148,yolonamelyandy,"GRANDMASTER I
G",3,18.5,249,46,203,oce
149,pokerdd,"GRANDMASTER I
G",0,15.0,280,42,238,oce
150,zhuweiran,MASTER I,134,15.6,384,60,324,oce
151,asange,MASTER I,124,15.4,376,58,318,oce
152,HanDaY,MASTER I,121,20.3,236,48,188,oce
153,jffhjjir,MASTER I,119,23.6,144,34,110,oce
154,1363082396l,MASTER I,102,12.7,512,65,447,oce
155,LLL016432,MASTER I,102,11.3,265,30,235,oce
156,wanmgc,MASTER I,88,11.8,321,38,283,oce
157,amazingccc,MASTER I,82,19.6,148,29,119,oce
158,roflwhatever,MASTER I,77,27.1,107,29,78,oce
159,okhaige,MASTER I,72,13.0,315,41,274,oce
160,ding1978,MASTER I,69,16.1,236,38,198,oce
161,xinya45,MASTER I,62,18.7,443,83,360,oce
162,vhugggg,MASTER I,57,11.0,374,41,333,oce
163,fapaiyuanwm,MASTER I,57,19.0,116,22,94,oce
164,BiscottiSwarls,MASTER I,56,13.6,346,47,299,oce
165,Haober,MASTER I,54,26.1,153,40,113,oce
166,Tactics GOD,MASTER I,52,19.9,216,43,173,oce
167,chenshaqi,MASTER I,50,17.0,165,28,137,oce
168,Jenry,MASTER I,49,13.4,186,25,161,oce
169,Maraudaur,MASTER I,46,15.9,553,88,465,oce
170,k9night,MASTER I,46,17.8,219,39,180,oce
171,weiningyuan,MASTER I,46,20.3,148,30,118,oce
172,sunshinellll,MASTER I,44,20.7,111,23,88,oce
173,BlueRose134,MASTER I,43,14.2,400,57,343,oce
174,haoxintai,MASTER I,42,18.1,177,32,145,oce
175,aozhourenmeimama,MASTER I,42,25.7,101,26,75,oce
176,ROKA1713,MASTER I,41,15.4,557,86,471,oce
177,xianqishenjiangl,MASTER I,41,17.3,365,63,302,oce
178,klowly,MASTER I,41,16.6,373,62,311,oce
179,YUKINO013,MASTER I,41,14.1,327,46,281,oce
180,Nekkiiiii,MASTER I,40,11.5,357,41,316,oce
181,eeadea,MASTER I,40,17.5,183,32,151,oce
182,shinlove311,MASTER I,39,18.1,149,27,122,oce
183,Lógic,MASTER I,38,18.2,253,46,207,oce
184,keljiw,MASTER I,38,19.2,151,29,122,oce
185,IllIIIll,MASTER I,38,16.0,150,24,126,oce
186,RKGG,MASTER I,36,15.5,232,36,196,oce
187,MrTianD,MASTER I,33,14.6,405,59,346,oce
188,uilkk925,MASTER I,33,20.1,174,35,139,oce
189,JMJ12138,MASTER I,33,21.9,155,34,121,oce
190,Dwyan3 Wade,MASTER I,32,14.6,418,61,357,oce
191,phyre49,MASTER I,32,15.7,381,60,321,oce
192,Zhiend,MASTER I,30,24.8,214,53,161,oce
193,zhouyinuo,MASTER I,29,17.6,221,39,182,oce
194,huhehe666,MASTER I,29,17.6,204,36,168,oce
195,ELECENG100SU,MASTER I,29,32.5,86,28,58,oce
196,RPNT,MASTER I,28,18.4,282,52,230,oce
197,WardenBenny,MASTER I,28,20.2,213,43,170,oce
198,Grayswandir,MASTER I,28,21.1,152,32,120,oce
199,DonAlternate,MASTER I,27,20.4,308,63,245,oce
200,babyuer,MASTER I,27,22.9,157,36,121,oce
201,Petra,MASTER I,27,22.9,153,35,118,oce
202,TheRealDirtyDan,MASTER I,26,11.2,446,50,396,oce
203,gaowei111,MASTER I,26,22.2,171,38,133,oce
204,I am Fzzf,MASTER I,25,18.9,302,57,245,oce
205,ssjfirzen,MASTER I,24,11.6,1556,181,1375,oce
206,wggrggt,MASTER I,24,24.0,104,25,79,oce
207,livebored,MASTER I,23,12.8,296,38,258,oce
208,WYYZQQ,MASTER I,22,15.4,299,46,253,oce
209,wudichiji,MASTER I,22,19.2,172,33,139,oce
210,sexoo1,MASTER I,22,19.5,159,31,128,oce
211,guangdongfoshan,MASTER I,22,19.6,153,30,123,oce
212,superzjq6,MASTER I,22,25.0,96,24,72,oce
213,Dankk,MASTER I,21,16.0,237,38,199,oce
214,tanhuanjue,MASTER I,21,33.8,80,27,53,oce
215,Cngoodman,MASTER I,21,19.5,113,22,91,oce
216,bbllff,MASTER I,20,16.4,292,48,244,oce
217,GGstay,MASTER I,20,14.6,295,43,252,oce
218,eatjin,MASTER I,19,12.8,383,49,334,oce
219,morningPonyo,MASTER I,19,18.2,132,24,108,oce
220,jisos,MASTER I,18,20.6,436,90,346,oce
221,tatami,MASTER I,18,16.8,191,32,159,oce
222,FPYNMSL,MASTER I,18,23.7,114,27,87,oce
223,doindog1,MASTER I,16,20.6,287,59,228,oce
224,VainF,MASTER I,16,14.2,317,45,272,oce
225,ciwei920,MASTER I,16,19.2,146,28,118,oce
226,cui086,MASTER I,16,23.7,114,27,87,oce
227,dashufangkaiwo,MASTER I,16,10.1,207,21,186,oce
228,uwggwuwhll,MASTER I,15,16.7,299,50,249,oce
229,zhongguoqd,MASTER I,15,15.9,220,35,185,oce
230,KeyaTFT,MASTER I,15,26.6,128,34,94,oce
231,Member,MASTER I,15,13.8,240,33,207,oce
232,callbobo,MASTER I,15,31.0,71,22,49,oce
233,cgnb,MASTER I,14,20.2,238,48,190,oce
234,yastin,MASTER I,14,17.1,175,30,145,oce
235,ganganniu,MASTER I,12,19.0,237,45,192,oce
236,Esseker,MASTER I,12,29.8,121,36,85,oce
237,SoccerSupaStar,MASTER I,12,19.9,176,35,141,oce
238,xiaosi2020,MASTER I,11,13.7,364,50,314,oce
239,LollyMan,MASTER I,11,17.6,193,34,159,oce
240,wo5172,MASTER I,11,12.0,191,23,168,oce
241,aero x,MASTER I,10,12.5,343,43,300,oce
242,SeaBoss,MASTER I,9,13.3,382,51,331,oce
243,DD2601,MASTER I,9,16.5,206,34,172,oce
244,Zoothefuker,MASTER I,8,25.0,100,25,75,oce
245,agzmybz,MASTER I,8,18.8,117,22,95,oce
246,JesterFred,MASTER I,7,16.3,301,49,252,oce
247,buzhiming1111,MASTER I,7,20.8,144,30,114,oce
248,Legolas,MASTER I,6,17.5,308,54,254,oce
249,Sephyli,MASTER I,6,16.3,270,44,226,oce
250,251kaikai,MASTER I,6,23.7,156,37,119,oce
251,wuzyu123,MASTER I,6,30.0,70,21,49,oce
252,Silon77,MASTER I,5,15.6,339,53,286,oce
253,wanfan1999,MASTER I,5,14.3,343,49,294,oce
254,coolzt,MASTER I,5,16.7,162,27,135,oce
255,Zacccccyou,MASTER I,5,19.1,131,25,106,oce
256,muasxy,MASTER I,5,28.9,83,24,59,oce
257,chanllenger4xuxu,MASTER I,5,15.5,155,24,131,oce
258,sorrybro,MASTER I,5,21.9,105,23,82,oce
259,lmllml,MASTER I,4,20.3,192,39,153,oce
260,xiyuluochen,MASTER I,4,16.4,189,31,158,oce
261,Focus More,MASTER I,4,37.7,69,26,43,oce
262,orymdzz,MASTER I,3,17.9,257,46,211,oce
263,Joothefuker,MASTER I,3,25.9,116,30,86,oce
264,dearxiang,MASTER I,3,17.4,92,16,76,oce
265,Stop bite me,MASTER I,2,14.9,726,108,618,oce
266,Heart Doinb,MASTER I,2,25.4,169,43,126,oce
267,yangduck,MASTER I,1,16.1,461,74,387,oce
268,Jando,MASTER I,1,14.2,337,48,289,oce
269,peace2020,MASTER I,1,20.9,210,44,166,oce
270,betkhoc,MASTER I,1,21.1,171,36,135,oce
271,Seeyaa,MASTER I,1,10.2,215,22,193,oce
272,MirMing,MASTER I,0,16.1,590,95,495,oce
273,tinyninja,MASTER I,0,15.3,555,85,470,oce
274,Yyangyonglin,MASTER I,0,21.5,288,62,226,oce
275,hanlu4522,MASTER I,0,14.1,432,61,371,oce
276,Becomingme,MASTER I,0,12.8,454,58,396,oce
277,MarioShu,MASTER I,0,15.0,381,57,324,oce
278,Natural01,MASTER I,0,22.9,245,56,189,oce
279,ZhuoKing,MASTER I,0,15.0,353,53,300,oce
280,mahui521,MASTER I,0,16.8,304,51,253,oce
281,JackAnt,MASTER I,0,24.6,191,47,144,oce
282,Stanton96,MASTER I,0,18.9,217,41,176,oce
283,dangkeai,MASTER I,0,15.4,259,40,219,oce
284,Notle,MASTER I,0,12.7,315,40,275,oce
285,dyx0105,MASTER I,0,18.1,199,36,163,oce
286,jxxyx007,MASTER I,0,18.8,176,33,143,oce
287,styllll,MASTER I,0,15.5,213,33,180,oce
288,changgyul,MASTER I,0,13.0,246,32,214,oce
289,liontiger,MASTER I,0,24.0,129,31,98,oce
290,1224,MASTER I,0,19.6,153,30,123,oce
291,hahhahahh,MASTER I,0,14.6,206,30,176,oce
292,wljbddmz,MASTER I,0,16.4,171,28,143,oce
293,Moon1,MASTER I,0,17.2,157,27,130,oce
294,524510785,MASTER I,0,17.2,157,27,130,oce
295,d0ttY,MASTER I,0,14.1,192,27,165,oce
296,sRongLun,MASTER I,0,18.1,144,26,118,oce
297,frisco,MASTER I,0,11.2,232,26,206,oce
298,King Røck,MASTER I,0,17.6,136,24,112,oce
299,jaming,MASTER I,0,16.4,140,23,117,oce
300,iiiiiiuuuuuu,MASTER I,0,15.4,149,23,126,oce
301,kaiwen521,MASTER I,0,27.4,73,20,53,oce
302,Camm,DIAMOND I,99,17.0,669,114,555,oce
303,wangmiss,DIAMOND I,98,19.9,216,43,173,oce
304,liuyu333,DIAMOND I,98,20.9,167,35,132,oce
305,knlght999,DIAMOND I,98,19.1,183,35,148,oce
306,hemoumouya,DIAMOND I,94,28.7,136,39,97,oce
307,OwO Ke Ai Duooo,DIAMOND I,89,14.9,248,37,211,oce
308,RONSWANSON,DIAMOND I,88,12.6,151,19,132,oce
309,HeartWept,DIAMOND I,85,20.0,260,52,208,oce
310,Bachh,DIAMOND I,85,18.1,237,43,194,oce
311,YuEBuZu,DIAMOND I,82,17.9,162,29,133,oce
312,YTBig4,DIAMOND I,80,21.4,210,45,165,oce
313,An arurf player,DIAMOND I,80,10.2,372,38,334,oce
314,1943,DIAMOND I,80,23.9,96,23,73,oce
315,2Yunerya,DIAMOND I,78,15.0,401,60,341,oce
316,midtesty,DIAMOND I,78,10.9,412,45,367,oce
317,xiaocaibiiiii,DIAMOND I,77,16.6,259,43,216,oce
318,killeen69,DIAMOND I,77,16.4,220,36,184,oce
319,lubenweinib,DIAMOND I,76,17.6,193,34,159,oce
320,Soucouyant,DIAMOND I,75,19.2,1133,218,915,oce
321,GooGieMonA,DIAMOND I,75,21.1,603,127,476,oce
322,fatbug gg,DIAMOND I,75,16.3,673,110,563,oce
323,xxxPeter200xxx,DIAMOND I,75,15.0,586,88,498,oce
324,lolamar05,DIAMOND I,75,14.9,557,83,474,oce
325,cao ni ma 69,DIAMOND I,75,14.4,459,66,393,oce
326,TacticalKorean,DIAMOND I,75,12.4,531,66,465,oce
327,Ethilamwen,DIAMOND I,75,16.7,390,65,325,oce
328,Dosedtns,DIAMOND I,75,20.4,313,64,249,oce
329,Saint Seiya,DIAMOND I,75,13.8,413,57,356,oce
330,janet11corners,DIAMOND I,75,22.5,249,56,193,oce
331,WKY Zui Mei,DIAMOND I,75,16.1,347,56,291,oce
332,When,DIAMOND I,75,14.9,309,46,263,oce
333,Thoppie,DIAMOND I,75,23.5,187,44,143,oce
334,babadeba,DIAMOND I,75,26.6,154,41,113,oce
335,sivirxin,DIAMOND I,75,17.4,235,41,194,oce
336,Way Too Suave,DIAMOND I,75,17.3,237,41,196,oce
337,Nidedad,DIAMOND I,75,22.2,144,32,112,oce
338,ncpchina,DIAMOND I,75,25.6,117,30,87,oce
339,Kappa Khameleon,DIAMOND I,75,15.1,185,28,157,oce
340,woodsie093,DIAMOND I,75,16.4,159,26,133,oce
341,ztddc1,DIAMOND I,75,23.5,102,24,78,oce
342,DoubleShun,DIAMOND I,75,25.0,92,23,69,oce
343,Forget,DIAMOND I,74,19.3,181,35,146,oce
344,stynb666,DIAMOND I,73,17.7,130,23,107,oce
345,you122,DIAMOND I,71,17.4,403,70,333,oce
346,trunks 4,DIAMOND I,71,12.1,372,45,327,oce
347,yansuixin,DIAMOND I,70,11.4,245,28,217,oce
348,THEbulll,DIAMOND I,69,18.7,214,40,174,oce
349,Tsunemori Akane,DIAMOND I,69,12.7,189,24,165,oce
350,asha7454088,DIAMOND I,68,16.7,144,24,120,oce
351,VVVVincent,DIAMOND I,67,15.1,299,45,254,oce
352,Luckyplanck,DIAMOND I,66,21.1,209,44,165,oce
353,S2mple1,DIAMOND I,66,17.4,235,41,194,oce
354,jmjQAQ,DIAMOND I,66,24.8,101,25,76,oce
355,liranxin,DIAMOND I,65,10.8,279,30,249,oce
356,wah fong pei ah,DIAMOND I,64,19.1,383,73,310,oce
357,lzlssly,DIAMOND I,64,18.5,124,23,101,oce
358,MaeIstrom,DIAMOND I,64,15.9,132,21,111,oce
359,Quwrof,DIAMOND I,63,15.5,386,60,326,oce
360,Featherknights,DIAMOND I,63,17.8,213,38,175,oce
361,boosdad,DIAMOND I,63,19.4,175,34,141,oce
362,IInevitable,DIAMOND I,62,16.5,400,66,334,oce
363,Janná,DIAMOND I,62,17.2,221,38,183,oce
364,TooBreezy,DIAMOND I,62,13.5,185,25,160,oce
365,111iidj,DIAMOND I,61,24.4,90,22,68,oce
366,Renais,DIAMOND I,57,19.4,247,48,199,oce
367,Raichiu,DIAMOND I,56,16.4,183,30,153,oce
368,xiaosuan,DIAMOND I,56,16.2,179,29,150,oce
369,liaoketian,DIAMOND I,55,19.3,150,29,121,oce
370,mxcjs123,DIAMOND I,54,17.1,252,43,209,oce
371,gggyou,DIAMOND I,52,18.6,177,33,144,oce
372,sanxingcaixukun,DIAMOND I,50,13.3,670,89,581,oce
373,henannanyang,DIAMOND I,50,13.7,505,69,436,oce
374,Meme Addiction,DIAMOND I,50,18.6,366,68,298,oce
375,Hér MANGOˇ,DIAMOND I,50,15.4,427,66,361,oce
376,widepeepoGlad,DIAMOND I,50,19.3,327,63,264,oce
377,AZHONG00,DIAMOND I,50,16.1,391,63,328,oce
378,wuhandage,DIAMOND I,50,13.6,404,55,349,oce
379,RNGtlang,DIAMOND I,50,16.1,285,46,239,oce
380,OldYellow3,DIAMOND I,50,14.5,304,44,260,oce
381,xxxxyg,DIAMOND I,50,15.8,259,41,218,oce
382,qq13277,DIAMOND I,50,23.1,173,40,133,oce
383,ShadowMing,DIAMOND I,50,18.9,212,40,172,oce
384,overwater,DIAMOND I,50,19.5,195,38,157,oce
385,herdey,DIAMOND I,50,15.0,240,36,204,oce
386,Whoopss,DIAMOND I,50,13.3,263,35,228,oce
387,aoligeiiiiiii,DIAMOND I,50,17.4,172,30,142,oce
388,knippdghu,DIAMOND I,50,20.3,138,28,110,oce
389,s1y2f3,DIAMOND I,50,14.0,171,24,147,oce
390,Shriic,DIAMOND I,50,10.6,199,21,178,oce
391,Arend,DIAMOND I,50,16.0,106,17,89,oce
392,yuxuhui666,DIAMOND I,50,12.1,141,17,124,oce
393,ggoalpick,DIAMOND I,49,19.6,92,18,74,oce
394,assqbqqq,DIAMOND I,47,14.3,342,49,293,oce
395,zhengdejiaoqi,DIAMOND I,47,16.8,131,22,109,oce
396,P pEacH QoO,DIAMOND I,46,15.1,555,84,471,oce
397,why1221,DIAMOND I,46,23.8,185,44,141,oce
398,fxyammm,DIAMOND I,46,22.6,93,21,72,oce
399,Omnî,DIAMOND I,45,26.5,894,237,657,oce
400,P goon,DIAMOND I,45,16.4,908,149,759,oce
401,lionqq,DIAMOND I,45,15.2,428,65,363,oce
402,Tkk and A1in,DIAMOND I,45,15.7,401,63,338,oce
403,qwsxggo,DIAMOND I,45,17.7,328,58,270,oce
404,jiushishen,DIAMOND I,45,19.6,163,32,131,oce
405,Donaldin0,DIAMOND I,44,13.2,440,58,382,oce
406,sudoowoodo,DIAMOND I,44,18.1,315,57,258,oce
407,Its Cupcake,DIAMOND I,44,14.6,253,37,216,oce
408,ffgy655,DIAMOND I,43,11.7,452,53,399,oce
409,Prowlore,DIAMOND I,43,12.3,236,29,207,oce
410,youngAny,DIAMOND I,43,16.3,147,24,123,oce
411,lovelykog,DIAMOND I,43,16.4,128,21,107,oce
412,3356su,DIAMOND I,43,11.8,144,17,127,oce
413,anhaomoBB,DIAMOND I,41,16.0,269,43,226,oce
414,huanyingjiw,DIAMOND I,41,13.0,246,32,214,oce
415,Lssxxs,DIAMOND I,41,15.6,167,26,141,oce
416,Fxxk YOU,DIAMOND I,41,20.3,123,25,98,oce
417,xiaohanggege,DIAMOND I,39,17.3,231,40,191,oce
418,tw Kevin,DIAMOND I,39,17.5,223,39,184,oce
419,WorstNooB,DIAMOND I,39,16.7,168,28,140,oce
420,baboda,DIAMOND I,38,11.5,522,60,462,oce
421,LiuYifeiswolaopo,DIAMOND I,38,22.4,214,48,166,oce
422,dhl666,DIAMOND I,38,22.7,150,34,116,oce
423,gggggggggggggsl,DIAMOND I,38,14.3,196,28,168,oce
424,Mo Maek xx,DIAMOND I,37,15.3,293,45,248,oce
425,MagicalBlond,DIAMOND I,37,17.4,207,36,171,oce
426,zuan4fangguowo,DIAMOND I,37,17.2,197,34,163,oce
427,TayKim,DIAMOND I,37,15.7,191,30,161,oce
428,xuqwer,DIAMOND I,36,14.5,463,67,396,oce
429,Naix WifeSlayer,DIAMOND I,36,17.4,270,47,223,oce
430,BIGBiG12138,DIAMOND I,36,17.6,256,45,211,oce
431,QiWeiL,DIAMOND I,35,16.9,230,39,191,oce
432,11111dingk,DIAMOND I,35,14.6,240,35,205,oce
433,zzaffffff,DIAMOND I,34,20.4,280,57,223,oce
434,PSimmashoot,DIAMOND I,34,13.5,282,38,244,oce
435,wtl20000701,DIAMOND I,34,29.7,101,30,71,oce
436,woshizhuh,DIAMOND I,34,18.0,167,30,137,oce
437,JinGuGuGu,DIAMOND I,33,19.1,199,38,161,oce
438,sj9527,DIAMOND I,33,13.5,237,32,205,oce
439,tt19931216,DIAMOND I,33,13.4,186,25,161,oce
440,Mr Relaxed,DIAMOND I,32,16.6,404,67,337,oce
441,LeoHE,DIAMOND I,32,15.7,362,57,305,oce
442,Gilgameshann,DIAMOND I,32,22.8,149,34,115,oce
443,Energy,DIAMOND I,32,14.5,207,30,177,oce
444,aguangge,DIAMOND I,32,15.9,157,25,132,oce
445,fyiiiiii,DIAMOND I,31,15.3,452,69,383,oce
446,ItchyPenitis,DIAMOND I,31,13.2,509,67,442,oce
447,Shootout,DIAMOND I,31,9.9,394,39,355,oce
448,Michael Draven,DIAMOND I,31,17.9,207,37,170,oce
449,chengzai,DIAMOND I,31,13.7,241,33,208,oce
450,Cai Xu Kun,DIAMOND I,31,13.8,188,26,162,oce
451,WhatULooking4,DIAMOND I,31,15.0,160,24,136,oce
452,Aburuisi,DIAMOND I,30,22.5,102,23,79,oce
453,cccccp,DIAMOND I,29,19.0,247,47,200,oce
454,yyy599795,DIAMOND I,29,12.1,214,26,188,oce
455,camcamca,DIAMOND I,29,24.7,97,24,73,oce
456,Razza,DIAMOND I,28,14.6,178,26,152,oce
457,IGloose,DIAMOND I,27,17.4,161,28,133,oce
458,EffortIess,DIAMOND I,27,23.8,105,25,80,oce
459,Daechang92,DIAMOND I,26,6.8,614,42,572,oce
460,woshizhong,DIAMOND I,26,16.1,223,36,187,oce
461,VX   wwp997521,DIAMOND I,25,19.3,280,54,226,oce
462,Mads Mikkelsen,DIAMOND I,25,12.7,401,51,350,oce
463,kiyomirl,DIAMOND I,25,14.4,264,38,226,oce
464,ZacharyC,DIAMOND I,25,16.2,185,30,155,oce
465,MakeNoSence,DIAMOND I,25,10.4,278,29,249,oce
466,yanfeng1,DIAMOND I,24,25.2,202,51,151,oce
467,BeegChonker,DIAMOND I,24,17.6,119,21,98,oce
468,heishelifu,DIAMOND I,23,24.2,186,45,141,oce
469,xw2000,DIAMOND I,23,17.0,176,30,146,oce
470,Usefulmoose,DIAMOND I,22,13.6,258,35,223,oce
471,XiYangYang CN,DIAMOND I,21,17.8,208,37,171,oce
472,Bma,DIAMOND I,21,17.4,184,32,152,oce
473,QuInD,DIAMOND I,21,13.4,239,32,207,oce
474,UZIqsjy,DIAMOND I,21,19.1,157,30,127,oce
475,drfsd61,DIAMOND I,20,15.3,268,41,227,oce
476,Mcteamster,DIAMOND I,20,20.7,150,31,119,oce
477,TiananomenSquare,DIAMOND I,20,17.1,164,28,136,oce
478,FapaiyuanDemon,DIAMOND I,20,24.2,91,22,69,oce
479,TFBOYSBb,DIAMOND I,20,20.2,104,21,83,oce
480,ROG NO1 Chairman,DIAMOND I,19,18.0,111,20,91,oce
481,Kazsaix,DIAMOND I,18,17.8,214,38,176,oce
482,wlzcyx,DIAMOND I,17,17.5,378,66,312,oce
483,Kaze Meiji,DIAMOND I,17,15.1,265,40,225,oce
484,zhenyoudianshuai,DIAMOND I,17,21.5,177,38,139,oce
485,11233a,DIAMOND I,17,13.4,247,33,214,oce
486,newcpdown,DIAMOND I,17,16.1,193,31,162,oce
487,guooug,DIAMOND I,17,13.3,211,28,183,oce
488,yuzihasasigei,DIAMOND I,17,21.6,97,21,76,oce
489,Aszhaoli,DIAMOND I,17,16.7,120,20,100,oce
490,Jie1217,DIAMOND I,16,22.2,81,18,63,oce
491,luckyeightyeight,DIAMOND I,15,8.6,789,68,721,oce
492,QQloveddme,DIAMOND I,15,15.8,423,67,356,oce
493,Erić,DIAMOND I,15,12.3,348,43,305,oce
494,IG HuShen,DIAMOND I,15,20.1,204,41,163,oce
495,tenseigannn,DIAMOND I,15,13.1,297,39,258,oce
496,ZHANG BABA 002,DIAMOND I,15,16.8,185,31,154,oce
497,mayiplayxerath,DIAMOND I,14,18.6,215,40,175,oce
498,InfestorTerran,DIAMOND I,13,17.8,258,46,212,oce
499,NamiAndChips,DIAMOND I,13,14.6,302,44,258,oce
500,CNboyinAU,DIAMOND I,12,10.8,638,69,569,oce
1,kinqmusti43,CHALLENGER I,1562,25.4,527,134,393,tr
2,Rubic,CHALLENGER I,1419,26.4,635,168,467,tr
3,MAD JOSEPH,CHALLENGER I,1260,20.1,638,128,510,tr
4,speedruzlol,CHALLENGER I,1141,24.7,442,109,333,tr
5,MAD JOSEPH 2,CHALLENGER I,962,25.0,300,75,225,tr
6,Ayenbe,CHALLENGER I,810,26.9,264,71,193,tr
7,Stay ruthless,CHALLENGER I,780,27.5,781,215,566,tr
8,Benedetto,CHALLENGER I,780,22.7,330,75,255,tr
9,jan uma,CHALLENGER I,645,21.8,252,55,197,tr
10,keLch,CHALLENGER I,627,22.7,348,79,269,tr
11,NİZİPLİİİ,CHALLENGER I,585,21.6,887,192,695,tr
12,Jok3r xx,CHALLENGER I,570,21.7,300,65,235,tr
13,Jenerik,CHALLENGER I,553,22.6,252,57,195,tr
14,Perceid TFT,CHALLENGER I,518,26.0,146,38,108,tr
15,bestâ,CHALLENGER I,511,21.6,366,79,287,tr
16,Darksword02,CHALLENGER I,488,16.4,788,129,659,tr
17,Daldım Kazdım,CHALLENGER I,479,22.8,285,65,220,tr
18,lAdastra,CHALLENGER I,478,20.0,541,108,433,tr
19,Liquidzer,CHALLENGER I,472,18.4,452,83,369,tr
20,Waiden,CHALLENGER I,471,18.3,832,152,680,tr
21,SİVASLI PONÇİK,CHALLENGER I,468,16.0,337,54,283,tr
22,Jthie,CHALLENGER I,467,20.9,258,54,204,tr
23,clssJaGG,CHALLENGER I,466,15.2,724,110,614,tr
24,Jonas Salk,CHALLENGER I,466,11.8,599,71,528,tr
25,MAC MASCARA,CHALLENGER I,458,14.9,592,88,504,tr
26,GreatEagle,CHALLENGER I,456,18.7,390,73,317,tr
27,Meglendiel,CHALLENGER I,451,17.0,710,121,589,tr
28,Morte D Amour,CHALLENGER I,430,16.5,647,107,540,tr
29,FeelingTheBlanks,CHALLENGER I,411,11.9,479,57,422,tr
30,SunChos,CHALLENGER I,410,14.8,985,146,839,tr
31,11 04 2004,CHALLENGER I,400,14.7,497,73,424,tr
32,TFT Colorâblê v2,CHALLENGER I,398,15.2,230,35,195,tr
33,MUHENDİSBEY TFT,CHALLENGER I,388,17.3,405,70,335,tr
34,mettuzwee,CHALLENGER I,386,25.6,180,46,134,tr
35,Slay,CHALLENGER I,377,21.1,246,52,194,tr
36,Nîtratex,CHALLENGER I,366,10.6,407,43,364,tr
37,Shinzu,CHALLENGER I,365,10.2,501,51,450,tr
38,zikerr,CHALLENGER I,361,14.8,526,78,448,tr
39,Rapscallion FK,CHALLENGER I,340,21.0,467,98,369,tr
40,NEXTENAAA,CHALLENGER I,339,18.4,255,47,208,tr
41,Top 8,CHALLENGER I,337,25.6,250,64,186,tr
42,TFT Colorâblê,CHALLENGER I,329,16.1,211,34,177,tr
43,THE BOSS PALA,CHALLENGER I,326,13.6,360,49,311,tr
44,StahpItRito v2,CHALLENGER I,321,21.8,174,38,136,tr
45,StahpItRito,CHALLENGER I,314,25.7,183,47,136,tr
46,BrushLeee,CHALLENGER I,312,15.7,172,27,145,tr
47,Discronatia,CHALLENGER I,311,16.7,323,54,269,tr
48,sefaFluxx,CHALLENGER I,309,19.2,948,182,766,tr
49,ŁuciâN,CHALLENGER I,309,13.9,346,48,298,tr
50,Spanker HS,CHALLENGER I,305,20.3,552,112,440,tr
51,Skinner27,"GRANDMASTER I
G",305,22.1,145,32,113,tr
52,TFT Ołrïc,"GRANDMASTER I
G",288,13.6,213,29,184,tr
53,No Life Ceset,"GRANDMASTER I
G",282,17.8,684,122,562,tr
54,9x37,"GRANDMASTER I
G",260,14.5,606,88,518,tr
55,Luca Toni,"GRANDMASTER I
G",229,17.1,239,41,198,tr
56,Troll Bir Nick,"GRANDMASTER I
G",223,19.0,868,165,703,tr
57,TEOİSTİK,"GRANDMASTER I
G",218,13.4,329,44,285,tr
58,ƒallenGod,"GRANDMASTER I
G",208,20.1,309,62,247,tr
59,Sayonara Baby,"GRANDMASTER I
G",196,11.9,901,107,794,tr
60,Phoebe,"GRANDMASTER I
G",193,19.1,377,72,305,tr
61,Furriya,"GRANDMASTER I
G",193,17.9,251,45,206,tr
62,Kemal KS,"GRANDMASTER I
G",186,15.9,673,107,566,tr
63,Jâsper,"GRANDMASTER I
G",182,18.6,177,33,144,tr
64,ForyuS,"GRANDMASTER I
G",181,10.6,913,97,816,tr
65,ŹéÐáñìêłš,"GRANDMASTER I
G",171,13.3,682,91,591,tr
66,Riven İs Mine,"GRANDMASTER I
G",171,17.8,264,47,217,tr
67,play for a fun,"GRANDMASTER I
G",167,18.3,251,46,205,tr
68,Bir Spartalı,"GRANDMASTER I
G",162,17.4,270,47,223,tr
69,qR Kai Hiwatari,"GRANDMASTER I
G",160,11.1,343,38,305,tr
70,Prenses Irelia,"GRANDMASTER I
G",156,13.9,567,79,488,tr
71,caglar128,"GRANDMASTER I
G",153,13.3,225,30,195,tr
72,canadianturkey,"GRANDMASTER I
G",151,24.4,172,42,130,tr
73,xlProDRoMaLlx,"GRANDMASTER I
G",151,16.0,212,34,178,tr
74,Kral Leonidass,"GRANDMASTER I
G",148,13.6,824,112,712,tr
75,Ruheass,"GRANDMASTER I
G",148,17.9,446,80,366,tr
76,Beramusluu TFT,"GRANDMASTER I
G",140,15.4,466,72,394,tr
77,Groove Street CJ,"GRANDMASTER I
G",140,11.3,539,61,478,tr
78,ATC Bulbasaur,"GRANDMASTER I
G",140,17.2,244,42,202,tr
79,My0neSS,"GRANDMASTER I
G",137,17.5,867,152,715,tr
80,Punaise,"GRANDMASTER I
G",130,12.3,1130,139,991,tr
81,GotchaAssBoy,"GRANDMASTER I
G",129,25.8,120,31,89,tr
82,Motosho,"GRANDMASTER I
G",125,20.1,249,50,199,tr
83,Basden,"GRANDMASTER I
G",124,18.0,450,81,369,tr
84,Dr Manhattan,"GRANDMASTER I
G",124,20.8,240,50,190,tr
85,slowly sari,"GRANDMASTER I
G",124,17.1,286,49,237,tr
86,Xaviertz,"GRANDMASTER I
G",123,18.1,393,71,322,tr
87,TheBigWal,"GRANDMASTER I
G",123,12.1,224,27,197,tr
88,Kara Sevdalım,"GRANDMASTER I
G",117,19.1,681,130,551,tr
89,Sağtık CEBO,"GRANDMASTER I
G",115,10.9,457,50,407,tr
90,elyêl,"GRANDMASTER I
G",113,22.3,493,110,383,tr
91,ÇokTaRinTinTinV2,"GRANDMASTER I
G",110,18.4,401,74,327,tr
92,CacaReyiz1907,"GRANDMASTER I
G",107,13.2,710,94,616,tr
93,Berke İnan,"GRANDMASTER I
G",106,16.6,265,44,221,tr
94,Ragyo,"GRANDMASTER I
G",104,17.2,835,144,691,tr
95,Plug,"GRANDMASTER I
G",104,16.4,384,63,321,tr
96,Sir BÂGÎ,"GRANDMASTER I
G",102,12.1,372,45,327,tr
97,KÜNEFE,"GRANDMASTER I
G",101,15.6,243,38,205,tr
98,valiumx,"GRANDMASTER I
G",100,11.7,924,108,816,tr
99,Hyperr roll babe,"GRANDMASTER I
G",96,19.8,111,22,89,tr
100,T H O S U N,"GRANDMASTER I
G",93,16.8,202,34,168,tr
101,w0lverinee,"GRANDMASTER I
G",92,15.3,1050,161,889,tr
102,xTCxINFLAMES,"GRANDMASTER I
G",91,10.2,462,47,415,tr
103,MrDdad,"GRANDMASTER I
G",86,20.1,377,76,301,tr
104,Boxerli Arap,"GRANDMASTER I
G",86,23.0,269,62,207,tr
105,Pressure Fatih,"GRANDMASTER I
G",84,16.9,189,32,157,tr
106,wraıth slayer,"GRANDMASTER I
G",81,16.1,224,36,188,tr
107,Castiel2897,"GRANDMASTER I
G",79,17.9,273,49,224,tr
108,SUQ MADİK,"GRANDMASTER I
G",78,18.5,232,43,189,tr
109,guido05,"GRANDMASTER I
G",78,14.1,305,43,262,tr
110,ImCurly,"GRANDMASTER I
G",77,16.5,643,106,537,tr
111,Apo sen misin la,"GRANDMASTER I
G",75,17.3,330,57,273,tr
112,ReachijaX,"GRANDMASTER I
G",73,13.3,825,110,715,tr
113,hi im KeNji ea,"GRANDMASTER I
G",72,13.2,762,101,661,tr
114,DT Escanor,"GRANDMASTER I
G",71,15.1,252,38,214,tr
115,itsAƒucknComedy,"GRANDMASTER I
G",71,14.7,252,37,215,tr
116,Maegi,"GRANDMASTER I
G",70,17.3,336,58,278,tr
117,Gollum TFT,"GRANDMASTER I
G",69,16.6,458,76,382,tr
118,Im Ventum,"GRANDMASTER I
G",69,10.1,396,40,356,tr
119,asvpxtitan,"GRANDMASTER I
G",68,13.8,672,93,579,tr
120,cropovez,"GRANDMASTER I
G",68,12.7,221,28,193,tr
121,TRANSFOURGOT,"GRANDMASTER I
G",68,8.3,217,18,199,tr
122,SuBA x,"GRANDMASTER I
G",67,5.7,698,40,658,tr
123,BeeepbeepimaJeep,"GRANDMASTER I
G",61,15.4,214,33,181,tr
124,ISGT PeaceI,"GRANDMASTER I
G",57,15.2,145,22,123,tr
125,WestosTFT,"GRANDMASTER I
G",55,10.5,332,35,297,tr
126,THEPRAT,"GRANDMASTER I
G",53,11.7,403,47,356,tr
127,ÇopurBey,"GRANDMASTER I
G",51,11.6,854,99,755,tr
128,Electus1,"GRANDMASTER I
G",50,20.5,503,103,400,tr
129,Mutsuz,"GRANDMASTER I
G",50,13.8,196,27,169,tr
130,MhmtAkgl,"GRANDMASTER I
G",49,13.3,600,80,520,tr
131,KimbuLeyla,"GRANDMASTER I
G",49,16.8,149,25,124,tr
132,Thanos Pyke,"GRANDMASTER I
G",48,16.0,356,57,299,tr
133,Coria,"GRANDMASTER I
G",48,15.0,373,56,317,tr
134,N0NNstar,"GRANDMASTER I
G",47,16.7,442,74,368,tr
135,Reis Back,"GRANDMASTER I
G",47,12.3,341,42,299,tr
136,mFatality,"GRANDMASTER I
G",46,12.6,538,68,470,tr
137,Rykes,"GRANDMASTER I
G",45,17.0,265,45,220,tr
138,Nö1 TFT,"GRANDMASTER I
G",42,13.6,354,48,306,tr
139,Seyfi Baba QQ,"GRANDMASTER I
G",41,18.1,639,116,523,tr
140,Usta Splinterr,"GRANDMASTER I
G",40,13.6,228,31,197,tr
141,bertugrul,"GRANDMASTER I
G",39,19.9,241,48,193,tr
142,Irrepressible,"GRANDMASTER I
G",38,17.6,261,46,215,tr
143,TFT Orfane,"GRANDMASTER I
G",37,17.5,332,58,274,tr
144,Doğay,"GRANDMASTER I
G",36,18.9,249,47,202,tr
145,ll Mr Yılmâz TFT,"GRANDMASTER I
G",35,15.2,407,62,345,tr
146,ÜSTADIM,"GRANDMASTER I
G",35,12.1,281,34,247,tr
147,MertTFT,"GRANDMASTER I
G",34,12.5,335,42,293,tr
148,AcviLion,"GRANDMASTER I
G",32,16.8,446,75,371,tr
149,LordCampus,"GRANDMASTER I
G",32,18.9,307,58,249,tr
150,mustafa1t,"GRANDMASTER I
G",0,9.7,606,59,547,tr
151,EazyPz,MASTER I,62,21.9,260,57,203,tr
152,veifanN,MASTER I,31,24.6,244,60,184,tr
153,Boşver,MASTER I,30,18.3,459,84,375,tr
154,sads,MASTER I,30,15.7,511,80,431,tr
155,blobfısh,MASTER I,30,14.4,327,47,280,tr
156,TFT CEBO,MASTER I,30,14.6,157,23,134,tr
157,caydas,MASTER I,29,16.5,611,101,510,tr
158,Terryfold,MASTER I,29,24.3,115,28,87,tr
159,ExeSus v1,MASTER I,28,14.2,718,102,616,tr
160,IamSonGoku,MASTER I,27,13.8,486,67,419,tr
161,SKT X,MASTER I,27,12.3,447,55,392,tr
162,Nerva,MASTER I,26,13.6,213,29,184,tr
163,John Scatt,MASTER I,26,17.0,112,19,93,tr
164,SSW,MASTER I,24,13.6,1191,162,1029,tr
165,OgUzhan22,MASTER I,24,14.2,669,95,574,tr
166,AsiTatanqa,MASTER I,23,11.8,365,43,322,tr
167,IV Sentinel,MASTER I,22,17.6,523,92,431,tr
168,Beysal,MASTER I,19,23.1,208,48,160,tr
169,Prince Rhaegar,MASTER I,19,12.2,302,37,265,tr
170,idlemonkk,MASTER I,18,20.6,398,82,316,tr
171,hknelmsua,MASTER I,18,19.9,221,44,177,tr
172,İqos,MASTER I,17,21.5,321,69,252,tr
173,HattoriZarbo,MASTER I,17,15.7,306,48,258,tr
174,UnknownZ7,MASTER I,17,16.7,203,34,169,tr
175,ArcHaic,MASTER I,16,18.6,231,43,188,tr
176,serseratx,MASTER I,16,15.1,251,38,213,tr
177,KaanGultekin,MASTER I,16,20.4,176,36,140,tr
178,artyomdh,MASTER I,16,19.9,136,27,109,tr
179,BABALARIN AHMET,MASTER I,14,13.8,470,65,405,tr
180,No Pasaran1917,MASTER I,13,19.6,179,35,144,tr
181,Ratom,MASTER I,12,19.9,332,66,266,tr
182,Necessarium,MASTER I,11,13.9,237,33,204,tr
183,Xenopa,MASTER I,9,14.3,196,28,168,tr
184,BEN THRESH NABER,MASTER I,9,12.3,220,27,193,tr
185,Srcnym,MASTER I,8,18.2,285,52,233,tr
186,AdnantalhaV,MASTER I,8,20.2,233,47,186,tr
187,Swarles Barkley,MASTER I,7,27.7,101,28,73,tr
188,IIIMeA CuLpAIII,MASTER I,7,15.9,176,28,148,tr
189,Fenrîr,MASTER I,6,14.1,474,67,407,tr
190,AçılnBenDokturm,MASTER I,6,16.5,261,43,218,tr
191,PARA,MASTER I,6,17.4,224,39,185,tr
192,Qyrieq,MASTER I,6,9.1,242,22,220,tr
193,Akaki Akakiyeviç,MASTER I,4,13.1,335,44,291,tr
194,ecivecivokkemj,MASTER I,3,21.2,165,35,130,tr
195,WhackyLuck,MASTER I,2,16.1,477,77,400,tr
196,Rydec,MASTER I,2,15.5,194,30,164,tr
197,CNS Undomiel,MASTER I,1,14.2,452,64,388,tr
198,menaSUVARi,MASTER I,1,15.6,212,33,179,tr
199,JoeHart35,MASTER I,1,18.8,144,27,117,tr
200,AxiBy,MASTER I,0,14.7,578,85,493,tr
201,Bihter ZiyagiI,MASTER I,0,13.4,618,83,535,tr
202,Night Train,MASTER I,0,14.6,540,79,461,tr
203,ÜzeyirBey,MASTER I,0,18.0,423,76,347,tr
204,GrevenLosT,MASTER I,0,12.5,608,76,532,tr
205,MjoInir,MASTER I,0,18.5,346,64,282,tr
206,MhRayleiphosor,MASTER I,0,20.5,297,61,236,tr
207,Sendoh7,MASTER I,0,18.3,317,58,259,tr
208,WymehcKo,MASTER I,0,16.8,333,56,277,tr
209,COKKOTUOLDUBU,MASTER I,0,24.0,204,49,155,tr
210,LeqacyOfKaiN,MASTER I,0,14.6,322,47,275,tr
211,chessplayer752,MASTER I,0,12.8,343,44,299,tr
212,ZaD,MASTER I,0,15.6,250,39,211,tr
213,KELTOŞ İRFAN xD,MASTER I,0,16.6,229,38,191,tr
214,diwine fish,MASTER I,0,21.1,156,33,123,tr
215,Plug v2,MASTER I,0,20.4,157,32,125,tr
216,The Ârt of Zed,MASTER I,0,19.2,161,31,130,tr
217,Durp,MASTER I,0,18.8,160,30,130,tr
218,Oscar Bey,MASTER I,0,10.0,299,30,269,tr
219,bigballsman,MASTER I,0,31.8,85,27,58,tr
220,bunupthedance,MASTER I,0,30.7,88,27,61,tr
221,ADAMLJAJİC,MASTER I,0,30.9,68,21,47,tr
222,HardcCcore XL,MASTER I,0,10.1,139,14,125,tr
223,Sinjeog Jonjae,DIAMOND I,99,21.0,229,48,181,tr
224,Xantherâ,DIAMOND I,99,14.3,336,48,288,tr
225,Rüzgâr TFT,DIAMOND I,95,22.9,153,35,118,tr
226,turkuazv2,DIAMOND I,94,18.8,272,51,221,tr
227,Useless Shaco,DIAMOND I,93,15.4,566,87,479,tr
228,Mahluk,DIAMOND I,91,25.3,340,86,254,tr
229,Alzerrax,DIAMOND I,84,22.6,208,47,161,tr
230,SÊßØ,DIAMOND I,83,17.1,304,52,252,tr
231,0011000100111001,DIAMOND I,81,15.5,161,25,136,tr
232,Hatır Huturoğlu,DIAMOND I,80,14.6,151,22,129,tr
233,mertnag,DIAMOND I,78,18.5,535,99,436,tr
234,Drdilatory,DIAMOND I,76,18.2,417,76,341,tr
235,ExTaCy xL,DIAMOND I,75,16.5,834,138,696,tr
236,MIVAC,DIAMOND I,75,28.3,389,110,279,tr
237,KissKissBangBang,DIAMOND I,75,13.9,695,97,598,tr
238,JesterB,DIAMOND I,75,18.0,532,96,436,tr
239,Justin FoIey,DIAMOND I,75,21.4,317,68,249,tr
240,Blodreina TFT,DIAMOND I,75,16.2,408,66,342,tr
241,jesica xd,DIAMOND I,75,15.9,414,66,348,tr
242,No come turkey,DIAMOND I,75,29.7,219,65,154,tr
243,Zoe the Gypsy,DIAMOND I,75,12.8,484,62,422,tr
244,Lynter,DIAMOND I,75,16.6,331,55,276,tr
245,Taş,DIAMOND I,75,26.1,207,54,153,tr
246,Mythug,DIAMOND I,75,14.1,375,53,322,tr
247,yaegan,DIAMOND I,75,16.5,285,47,238,tr
248,tobiwan cannabis,DIAMOND I,75,21.1,213,45,168,tr
249,YVSKUTSAMACI,DIAMOND I,75,16.0,275,44,231,tr
250,Gelfling,DIAMOND I,75,23.8,164,39,125,tr
251,BarRraK,DIAMOND I,75,16.3,215,35,180,tr
252,Mindutio,DIAMOND I,75,15.8,221,35,186,tr
253,Skadia,DIAMOND I,75,27.0,126,34,92,tr
254,TFT Mastèr,DIAMOND I,75,19.3,176,34,142,tr
255,Aproxima,DIAMOND I,75,16.8,202,34,168,tr
256,lYouMustDiel,DIAMOND I,75,19.5,164,32,132,tr
257,endiska,DIAMOND I,75,26.4,110,29,81,tr
258,selo sama hd,DIAMOND I,75,16.1,149,24,125,tr
259,Hugiin,DIAMOND I,75,13.6,177,24,153,tr
260,FedaMaster,DIAMOND I,75,21.0,100,21,79,tr
261,emre kınacı,DIAMOND I,74,17.4,527,92,435,tr
262,Miller Urey X,DIAMOND I,74,16.8,280,47,233,tr
263,Archelaus,DIAMOND I,74,31.0,100,31,69,tr
264,Phenomenal213,DIAMOND I,74,13.8,166,23,143,tr
265,Tavuklara aşığım,DIAMOND I,73,17.8,309,55,254,tr
266,idlemonkk 2,DIAMOND I,73,26.3,95,25,70,tr
267,Polîce,DIAMOND I,72,13.7,549,75,474,tr
268,Slvers Rayleigh,DIAMOND I,71,16.9,290,49,241,tr
269,AshleyG,DIAMOND I,70,12.3,546,67,479,tr
270,Veichi,DIAMOND I,69,21.7,346,75,271,tr
271,CaptainFBII,DIAMOND I,68,10.3,251,26,225,tr
272,Club America,DIAMOND I,67,25.9,108,28,80,tr
273,LORD OF SAVAŞ,DIAMOND I,66,10.9,631,69,562,tr
274,Sans égal,DIAMOND I,65,19.0,205,39,166,tr
275,SCARFÆCE,DIAMOND I,65,16.2,203,33,170,tr
276,Against Life,DIAMOND I,64,12.3,616,76,540,tr
277,Negabrione,DIAMOND I,63,20.4,216,44,172,tr
278,HaunteD TFT,DIAMOND I,62,14.2,388,55,333,tr
279,Flaixy,DIAMOND I,60,11.9,151,18,133,tr
280,hakes27,DIAMOND I,59,12.2,359,44,315,tr
281,Speraktif v2,DIAMOND I,58,19.6,163,32,131,tr
282,Ildeniz,DIAMOND I,57,17.5,388,68,320,tr
283,YaşaMustafaKemal,DIAMOND I,57,10.4,584,61,523,tr
284,TheRoseKnight,DIAMOND I,56,19.7,208,41,167,tr
285,ResqueL,DIAMOND I,56,19.8,192,38,154,tr
286,FiendStyLe,DIAMOND I,56,26.4,91,24,67,tr
287,675115,DIAMOND I,55,14.3,511,73,438,tr
288,AKHİSAR CİNGENİ,DIAMOND I,54,18.8,202,38,164,tr
289,AsSaSINTURK,DIAMOND I,54,13.0,253,33,220,tr
290,ÃŁÞhÃ,DIAMOND I,52,20.4,201,41,160,tr
291,Pegnex,DIAMOND I,51,12.4,499,62,437,tr
292,Garou26,DIAMOND I,51,15.1,238,36,202,tr
293,Pepee16,DIAMOND I,50,13.7,849,116,733,tr
294,SoundOfSiIence,DIAMOND I,50,18.1,507,92,415,tr
295,lateux,DIAMOND I,50,13.2,606,80,526,tr
296,Rescue 5,DIAMOND I,50,20.2,347,70,277,tr
297,Bunkaya,DIAMOND I,50,12.2,524,64,460,tr
298,Sh1vâ,DIAMOND I,50,17.9,312,56,256,tr
299,GameoweR61,DIAMOND I,50,12.8,406,52,354,tr
300,Smøøthie,DIAMOND I,50,20.2,243,49,194,tr
301,Kokarca Haydar,DIAMOND I,50,14.6,328,48,280,tr
302,Haccii,DIAMOND I,50,12.9,373,48,325,tr
303,PSG CAT,DIAMOND I,50,17.0,276,47,229,tr
304,lSkyBanel,DIAMOND I,50,16.0,294,47,247,tr
305,Bosch Aldım,DIAMOND I,50,13.8,332,46,286,tr
306,Yağız,DIAMOND I,50,26.9,167,45,122,tr
307,Por8,DIAMOND I,50,21.8,188,41,147,tr
308,The Gurthang,DIAMOND I,50,19.3,197,38,159,tr
309,Sumo deadlift,DIAMOND I,50,16.8,220,37,183,tr
310,serdext,DIAMOND I,50,12.2,302,37,265,tr
311,yüksel812,DIAMOND I,50,16.7,215,36,179,tr
312,Simurg TFT,DIAMOND I,50,21.2,160,34,126,tr
313,SeismicWave,DIAMOND I,50,20.4,162,33,129,tr
314,DRAGON124,DIAMOND I,50,13.9,223,31,192,tr
315,nasty rabbit,DIAMOND I,50,29.3,92,27,65,tr
316,babayorgunn35,DIAMOND I,50,21.6,125,27,98,tr
317,Kubilata,DIAMOND I,50,18.0,150,27,123,tr
318,HassickdiR,DIAMOND I,50,14.1,156,22,134,tr
319,PengueNNN2,DIAMOND I,50,13.8,152,21,131,tr
320,Vexillary,DIAMOND I,49,11.6,750,87,663,tr
321,Rota420,DIAMOND I,47,16.5,164,27,137,tr
322,TFT Hasslet,DIAMOND I,46,15.8,278,44,234,tr
323,SauirasSalviaa,DIAMOND I,45,13.5,925,125,800,tr
324,Ralphan,DIAMOND I,45,15.6,755,118,637,tr
325,âllen,DIAMOND I,45,18.6,145,27,118,tr
326,Ormancı Kız,DIAMOND I,44,15.1,783,118,665,tr
327,drogbaa37,DIAMOND I,44,9.8,379,37,342,tr
328,WL Poew,DIAMOND I,44,17.9,195,35,160,tr
329,VEXES,DIAMOND I,43,14.3,651,93,558,tr
330,IBRAHIMOVICYUS,DIAMOND I,43,16.3,306,50,256,tr
331,3sok,DIAMOND I,43,21.5,181,39,142,tr
332,Iyilik YaraKI,DIAMOND I,43,16.3,233,38,195,tr
333,Heisenberg CP,DIAMOND I,42,14.6,349,51,298,tr
334,MertColak,DIAMOND I,41,26.6,233,62,171,tr
335,İyi Kalpli Aley,DIAMOND I,41,14.0,250,35,215,tr
336,llumyos,DIAMOND I,41,15.2,223,34,189,tr
337,Endokarditt,DIAMOND I,40,14.5,393,57,336,tr
338,M Ê R T J O H N,DIAMOND I,40,15.2,230,35,195,tr
339,MurUgi,DIAMOND I,40,12.0,166,20,146,tr
340,ROBERTO FİRMİNO,DIAMOND I,40,12.8,140,18,122,tr
341,Móoncake,DIAMOND I,39,20.7,357,74,283,tr
342,lave242,DIAMOND I,39,12.8,506,65,441,tr
343,TIFITCI,DIAMOND I,39,17.8,146,26,120,tr
344,LordOguzKagan,DIAMOND I,39,29.3,82,24,58,tr
345,MAFEDERİN MAF,DIAMOND I,38,22.3,641,143,498,tr
346,MaSuaé,DIAMOND I,37,13.1,1509,198,1311,tr
347,BBang,DIAMOND I,37,12.3,742,91,651,tr
348,Roswell v1,DIAMOND I,37,16.5,346,57,289,tr
349,ˆ G7 ˆ,DIAMOND I,37,17.5,315,55,260,tr
350,lmPerfect,DIAMOND I,37,23.1,186,43,143,tr
351,Techila,DIAMOND I,37,16.8,256,43,213,tr
352,TeoJii,DIAMOND I,37,15.4,272,42,230,tr
353,Hısımus,DIAMOND I,37,17.6,204,36,168,tr
354,karpuz çilek,DIAMOND I,37,13.4,119,16,103,tr
355,Limon ve Kimyon,DIAMOND I,36,10.5,210,22,188,tr
356,VouLDead,DIAMOND I,35,15.7,338,53,285,tr
357,XecutioneRiven,DIAMOND I,34,12.8,296,38,258,tr
358,Zerone,DIAMOND I,34,15.9,232,37,195,tr
359,Cleveyton,DIAMOND I,34,19.6,168,33,135,tr
360,N3squiKk,DIAMOND I,33,15.7,127,20,107,tr
361,JB Cloudy,DIAMOND I,32,13.8,671,93,578,tr
362,ııııılıı,DIAMOND I,32,16.3,361,59,302,tr
363,Alpha  Yozgyur,DIAMOND I,32,12.4,420,52,368,tr
364,ertgskrcii,DIAMOND I,32,17.4,264,46,218,tr
365,sirchadol,DIAMOND I,32,14.4,215,31,184,tr
366,yanıyomsöndür,DIAMOND I,31,16.7,275,46,229,tr
367,Kıvırcık Pompa,DIAMOND I,31,12.2,221,27,194,tr
368,IIKRGZII,DIAMOND I,30,18.6,413,77,336,tr
369,UMP,DIAMOND I,30,24.1,191,46,145,tr
370,Machope,DIAMOND I,30,15.1,218,33,185,tr
371,iHTiYaR,DIAMOND I,29,8.3,516,43,473,tr
372,Ceminson,DIAMOND I,29,13.5,303,41,262,tr
373,Goku,DIAMOND I,29,11.7,239,28,211,tr
374,gahpe GİRAY,DIAMOND I,27,13.8,463,64,399,tr
375,CLL,DIAMOND I,27,17.1,204,35,169,tr
376,Gj MRX,DIAMOND I,27,9.1,198,18,180,tr
377,Neuveorix,DIAMOND I,26,16.4,766,126,640,tr
378,Lilith Sahl,DIAMOND I,26,10.4,297,31,266,tr
379,Laportee,DIAMOND I,25,16.0,493,79,414,tr
380,Seras Viktoria,DIAMOND I,25,24.2,298,72,226,tr
381,Asetaa,DIAMOND I,25,18.6,312,58,254,tr
382,avienex,DIAMOND I,25,10.8,424,46,378,tr
383,KartoncuSevo,DIAMOND I,25,23.1,173,40,133,tr
384,Eldjötnar,DIAMOND I,25,16.1,242,39,203,tr
385,MinionBlock,DIAMOND I,25,17.8,174,31,143,tr
386,MIVAC2,DIAMOND I,25,26.7,105,28,77,tr
387,unforgiving,DIAMOND I,24,15.4,332,51,281,tr
388,Milli Güç,DIAMOND I,24,23.1,212,49,163,tr
389,KERZO,DIAMOND I,24,20.4,235,48,187,tr
390,SoRuNumVar,DIAMOND I,24,18.5,135,25,110,tr
391,madckins2,DIAMOND I,23,10.6,717,76,641,tr
392,Maybe One Dayˆ,DIAMOND I,23,18.0,322,58,264,tr
393,sabonohiken,DIAMOND I,23,15.7,121,19,102,tr
394,Marijuaña,DIAMOND I,22,11.7,824,96,728,tr
395,AshCrimson,DIAMOND I,22,9.9,324,32,292,tr
396,KÓÐ ÃÐI ŻÉÐ,DIAMOND I,21,16.1,335,54,281,tr
397,GoyGoyyCu,DIAMOND I,21,13.1,382,50,332,tr
398,Dorçe,DIAMOND I,21,20.0,210,42,168,tr
399,Twiqqy,DIAMOND I,21,16.3,252,41,211,tr
400,PatoShiq,DIAMOND I,20,12.9,256,33,223,tr
401,FanFinFon,DIAMOND I,19,15.3,334,51,283,tr
402,U WOT MVIII,DIAMOND I,19,25.4,177,45,132,tr
403,Hazârdous,DIAMOND I,19,20.5,161,33,128,tr
404,bunnycery,DIAMOND I,19,8.0,327,26,301,tr
405,Alper,DIAMOND I,18,16.5,272,45,227,tr
406,twnku,DIAMOND I,18,23.5,179,42,137,tr
407,GM Jaqen,DIAMOND I,17,14.7,991,146,845,tr
408,slm ben aspirin,DIAMOND I,17,18.3,431,79,352,tr
409,Gramer Wr,DIAMOND I,17,13.9,538,75,463,tr
410,HaydiBusteR,DIAMOND I,17,15.0,427,64,363,tr
411,ChefCef,DIAMOND I,17,14.9,363,54,309,tr
412,Phenomenal214,DIAMOND I,17,18.9,111,21,90,tr
413,Ömércan,DIAMOND I,16,21.7,152,33,119,tr
414,Ağlak Kebir,DIAMOND I,16,13.7,175,24,151,tr
415,DuDa TFT,DIAMOND I,16,16.5,139,23,116,tr
416,HolyMan34,DIAMOND I,14,11.1,642,71,571,tr
417,The Memo,DIAMOND I,14,15.2,270,41,229,tr
418,Peredhil,DIAMOND I,13,13.2,295,39,256,tr
419,wtf Vaynee,DIAMOND I,13,8.1,455,37,418,tr
420,CLOUDS GOD,DIAMOND I,13,18.8,165,31,134,tr
421,Tasty,DIAMOND I,13,16.8,155,26,129,tr
422,Kılıç ustası,DIAMOND I,12,11.9,1310,156,1154,tr
423,JackDaNieLs6750,DIAMOND I,12,14.9,328,49,279,tr
424,Swagger94,DIAMOND I,12,19.5,241,47,194,tr
425,programlama123,DIAMOND I,12,18.5,216,40,176,tr
426,HolyTheLost,DIAMOND I,11,16.9,326,55,271,tr
427,kemalesme,DIAMOND I,11,18.9,254,48,206,tr
428,DaricK,DIAMOND I,11,13.3,346,46,300,tr
429,4Absinth,DIAMOND I,10,18.6,237,44,193,tr
430,UnutkanAdam,DIAMOND I,10,29.8,124,37,87,tr
431,Alanyalı Efe,DIAMOND I,10,25.9,139,36,103,tr
432,Yukokano,DIAMOND I,9,20.3,236,48,188,tr
433,Xiphos,DIAMOND I,9,21.9,187,41,146,tr
434,IBlueDreamI,DIAMOND I,8,15.8,461,73,388,tr
435,Janiabin,DIAMOND I,8,20.5,205,42,163,tr
436,Minik Efsanem,DIAMOND I,8,12.5,327,41,286,tr
437,xElessaRx,DIAMOND I,8,7.5,536,40,496,tr
438,frambuazll,DIAMOND I,7,15.3,288,44,244,tr
439,Ben Kahinim,DIAMOND I,6,15.0,586,88,498,tr
440,Berladriojon,DIAMOND I,6,15.7,248,39,209,tr
441,Z1AN,DIAMOND I,6,16.2,228,37,191,tr
442,Teemoş,DIAMOND I,6,11.5,321,37,284,tr
443,Jov is Back,DIAMOND I,6,13.8,188,26,162,tr
444,SebastiaN1,DIAMOND I,5,13.0,347,45,302,tr
445,Croaky,DIAMOND I,5,20.9,167,35,132,tr
446,Double Helix,DIAMOND I,5,13.5,148,20,128,tr
447,lolisking1,DIAMOND I,3,24.1,170,41,129,tr
448,BADFATHER,DIAMOND I,3,12.2,336,41,295,tr
449,ORMAN MESUT V2,DIAMOND I,3,11.6,318,37,281,tr
450,KarpotasiN,DIAMOND I,3,13.3,256,34,222,tr
451,Th3ng3s1z,DIAMOND I,3,17.5,177,31,146,tr
452,Likewindfree,DIAMOND I,2,16.4,905,148,757,tr
453,KİLLA ONUR,DIAMOND I,2,20.9,368,77,291,tr
454,Mustoyevski TFT,DIAMOND I,2,19.8,293,58,235,tr
455,ineffableHK,DIAMOND I,2,21.3,183,39,144,tr
456,Reaper oƒ Souls,DIAMOND I,1,16.1,429,69,360,tr
457,Sıgmund Freud,DIAMOND I,1,19.3,336,65,271,tr
458,TEKLEYEN ÇAR,DIAMOND I,1,18.4,201,37,164,tr
459,Âmethyst,DIAMOND I,1,15.5,142,22,120,tr
460,MBURAKLOL TWiTCH,DIAMOND I,0,16.6,997,166,831,tr
461,OneTruth Aimless,DIAMOND I,0,22.3,476,106,370,tr
462,babekizm,DIAMOND I,0,12.5,842,105,737,tr
463,Wondabitte JR,DIAMOND I,0,17.2,564,97,467,tr
464,QTAĞ,DIAMOND I,0,13.0,691,90,601,tr
465,Itachi Uchiha,DIAMOND I,0,12.1,704,85,619,tr
466,DIZDIZ EKREM,DIAMOND I,0,15.3,522,80,442,tr
467,sikkke,DIAMOND I,0,17.1,420,72,348,tr
468,bibakipcikcam2,DIAMOND I,0,19.3,357,69,288,tr
469,O F L U  R E Î S,DIAMOND I,0,12.1,544,66,478,tr
470,TFT Lynch,DIAMOND I,0,12.1,531,64,467,tr
471,Itachi the God,DIAMOND I,0,20.3,310,63,247,tr
472,CBF Pscho,DIAMOND I,0,9.4,671,63,608,tr
473,TSM DEMİRCELİK,DIAMOND I,0,15.7,396,62,334,tr
474,Gannicius,DIAMOND I,0,19.8,308,61,247,tr
475,Herun,DIAMOND I,0,18.4,332,61,271,tr
476,XXLeonardoX,DIAMOND I,0,14.0,436,61,375,tr
477,TFT SAYGO,DIAMOND I,0,13.2,463,61,402,tr
478,TEKSİN,DIAMOND I,0,15.2,389,59,330,tr
479,Prograsiva,DIAMOND I,0,15.1,392,59,333,tr
480,M xDharma,DIAMOND I,0,11.0,536,59,477,tr
481,enjoy90,DIAMOND I,0,15.7,369,58,311,tr
482,Rachel,DIAMOND I,0,15.3,379,58,321,tr
483,fztenginyildirim,DIAMOND I,0,15.2,362,55,307,tr
484,Dodgerın Eltisi,DIAMOND I,0,16.1,322,52,270,tr
485,Radyum,DIAMOND I,0,14.4,361,52,309,tr
486,WORST SUPPORT,DIAMOND I,0,13.6,383,52,331,tr
487,CHEF CUKKA,DIAMOND I,0,9.6,523,50,473,tr
488,aylakayyaş,DIAMOND I,0,15.5,316,49,267,tr
489,xeâ,DIAMOND I,0,11.5,401,46,355,tr
490,IBaşKaNIRuling,DIAMOND I,0,16.1,274,44,230,tr
491,I WOLFGANG I,DIAMOND I,0,15.5,284,44,240,tr
492,JuJuFiFi,DIAMOND I,0,13.1,335,44,291,tr
493,melikacet,DIAMOND I,0,12.1,365,44,321,tr
494,TaTux,DIAMOND I,0,10.7,410,44,366,tr
495,AbantAlabalık GK,DIAMOND I,0,19.4,222,43,179,tr
496,ShittyName,DIAMOND I,0,18.4,233,43,190,tr
497,Eless3r,DIAMOND I,0,17.1,251,43,208,tr
498,Honey Messalina,DIAMOND I,0,14.8,291,43,248,tr
499,musulsezar,DIAMOND I,0,10.8,398,43,355,tr
500,Zugaşi Bere,DIAMOND I,0,21.0,195,41,154,tr
1,aLeProfane,CHALLENGER I,925,26.6,368,98,270,ru
2,KroniiinepTFT,CHALLENGER I,825,27.6,351,97,254,ru
3,HORNIE MY BABY,CHALLENGER I,772,33.5,260,87,173,ru
4,Dyachello,CHALLENGER I,747,20.6,398,82,316,ru
5,chmochma,CHALLENGER I,742,24.7,299,74,225,ru
6,LMS trojancbkui,CHALLENGER I,575,14.7,592,87,505,ru
7,Nycteus,CHALLENGER I,557,22.5,209,47,162,ru
8,WuHan jiayou,CHALLENGER I,541,27.8,223,62,161,ru
9,МRAZIverniteNICK,CHALLENGER I,440,26.5,355,94,261,ru
10,Yablo4niy,CHALLENGER I,395,24.9,185,46,139,ru
11,L9 Rengy,CHALLENGER I,380,17.7,536,95,441,ru
12,kobeyang,CHALLENGER I,335,28.7,530,152,378,ru
13,Marijuanamama,CHALLENGER I,322,15.7,351,55,296,ru
14,Hardrinnz,CHALLENGER I,308,30.0,150,45,105,ru
15,Тяньци,CHALLENGER I,302,21.2,184,39,145,ru
16,DrKaktys,CHALLENGER I,297,17.4,195,34,161,ru
17,KENGBI,CHALLENGER I,291,20.0,509,102,407,ru
18,kiiller,CHALLENGER I,282,18.4,207,38,169,ru
19,DespicabIe,CHALLENGER I,257,25.4,287,73,214,ru
20,NMЯ NO ИМЯ,CHALLENGER I,257,20.2,311,63,248,ru
21,superworldRU,CHALLENGER I,247,19.6,363,71,292,ru
22,CNGOOD,CHALLENGER I,247,24.5,257,63,194,ru
23,Theblueboy,CHALLENGER I,246,30.1,196,59,137,ru
24,VN iRabity,CHALLENGER I,238,20.0,640,128,512,ru
25,NeverTrustSoloQ,CHALLENGER I,232,24.4,197,48,149,ru
26,Авиатор Платонов,CHALLENGER I,221,24.9,333,83,250,ru
27,Zauberbiest,CHALLENGER I,219,17.9,262,47,215,ru
28,JoSmog,CHALLENGER I,207,16.0,614,98,516,ru
29,Không Có Link,CHALLENGER I,198,17.4,596,104,492,ru
30,Светофорчик,CHALLENGER I,198,26.6,248,66,182,ru
31,FIMA,CHALLENGER I,195,21.9,246,54,192,ru
32,CNGOOD1,CHALLENGER I,195,21.6,232,50,182,ru
33,e 1,CHALLENGER I,170,17.5,348,61,287,ru
34,Sоul Reaver,CHALLENGER I,165,20.8,183,38,145,ru
35,Programmer,CHALLENGER I,161,16.5,212,35,177,ru
36,ENDEAVOUR,CHALLENGER I,156,18.6,307,57,250,ru
37,ìnsane,CHALLENGER I,151,20.3,300,61,239,ru
38,Sacred Nоrris,CHALLENGER I,145,14.1,1352,191,1161,ru
39,Legenda of LOL,CHALLENGER I,145,13.2,340,45,295,ru
40,Iggi 1TrickPferd,CHALLENGER I,136,27.4,168,46,122,ru
41,Torianos,CHALLENGER I,132,11.9,594,71,523,ru
42,Kahzoo is KING,CHALLENGER I,127,32.4,102,33,69,ru
43,Кисюня,CHALLENGER I,125,27.8,108,30,78,ru
44,Long live China,CHALLENGER I,120,18.1,276,50,226,ru
45,fantik999,CHALLENGER I,119,16.2,173,28,145,ru
46,Paprika,CHALLENGER I,118,20.9,172,36,136,ru
47,Rocket MaRin,CHALLENGER I,112,23.7,232,55,177,ru
48,Bingo123456,CHALLENGER I,107,17.7,373,66,307,ru
49,Mark of uroboros,CHALLENGER I,100,21.6,967,209,758,ru
50,BEASTMXDE,CHALLENGER I,99,18.7,375,70,305,ru
51,yurchiv,"GRANDMASTER I
G",109,10.1,713,72,641,ru
52,Arcade bÔÔbs,"GRANDMASTER I
G",76,21.2,508,108,400,ru
53,СерёгаСПб,"GRANDMASTER I
G",75,19.1,430,82,348,ru
54,Kapibaro,"GRANDMASTER I
G",71,23.4,342,80,262,ru
55,PeiPei,"GRANDMASTER I
G",71,13.0,478,62,416,ru
56,CuPofCrAcK,"GRANDMASTER I
G",70,11.1,398,44,354,ru
57,Sebastian7,"GRANDMASTER I
G",68,22.0,236,52,184,ru
58,LegendsNeverDIE0,"GRANDMASTER I
G",58,23.5,277,65,212,ru
59,ПаГа,"GRANDMASTER I
G",53,14.2,424,60,364,ru
60,Rukashi,"GRANDMASTER I
G",50,31.5,108,34,74,ru
61,Arclight Panda,"GRANDMASTER I
G",48,19.4,381,74,307,ru
62,zhangqiling,"GRANDMASTER I
G",45,16.4,262,43,219,ru
63,NikeIII,"GRANDMASTER I
G",43,28.9,180,52,128,ru
64,Silent Sona,"GRANDMASTER I
G",38,19.6,383,75,308,ru
65,BomBibomXD,"GRANDMASTER I
G",37,12.6,506,64,442,ru
66,dontlookatmepls,"GRANDMASTER I
G",36,32.2,90,29,61,ru
67,inspekt0r,"GRANDMASTER I
G",34,18.7,331,62,269,ru
68,lza,"GRANDMASTER I
G",34,21.0,200,42,158,ru
69,Youbanyouto,"GRANDMASTER I
G",34,18.6,194,36,158,ru
70,im famous,"GRANDMASTER I
G",34,15.7,229,36,193,ru
71,Hoang,"GRANDMASTER I
G",33,20.9,201,42,159,ru
72,ZiGZaG08,"GRANDMASTER I
G",32,16.4,262,43,219,ru
73,The Inspired One,"GRANDMASTER I
G",30,20.3,148,30,118,ru
74,Spring North,"GRANDMASTER I
G",29,18.0,233,42,191,ru
75,K R I P S I,"GRANDMASTER I
G",25,23.9,264,63,201,ru
76,Trang4438,"GRANDMASTER I
G",23,19.9,387,77,310,ru
77,Shinkulirion,"GRANDMASTER I
G",21,21.7,378,82,296,ru
78,Ветра Севера,"GRANDMASTER I
G",17,9.0,565,51,514,ru
79,hornie,"GRANDMASTER I
G",15,27.2,136,37,99,ru
80,Sapfer,"GRANDMASTER I
G",14,17.5,491,86,405,ru
81,Ice Ivern,"GRANDMASTER I
G",8,15.4,234,36,198,ru
82,Tâm Luct,"GRANDMASTER I
G",7,16.1,224,36,188,ru
83,Крада,"GRANDMASTER I
G",6,12.8,602,77,525,ru
84,Генерал Docta,"GRANDMASTER I
G",5,29.7,155,46,109,ru
85,AlloC,"GRANDMASTER I
G",3,21.1,199,42,157,ru
86,ropo4ka,"GRANDMASTER I
G",0,17.7,447,79,368,ru
87,TFT tsm,"GRANDMASTER I
G",0,16.2,431,70,361,ru
88,Hand off 3,"GRANDMASTER I
G",0,20.6,334,69,265,ru
89,Hen predator,"GRANDMASTER I
G",0,19.8,338,67,271,ru
90,Kiss my fizz,"GRANDMASTER I
G",0,21.3,301,64,237,ru
91,Джим Рейнор,"GRANDMASTER I
G",0,17.7,311,55,256,ru
92,Morozilkin,"GRANDMASTER I
G",0,21.8,220,48,172,ru
93,ruComix,"GRANDMASTER I
G",0,23.4,201,47,154,ru
94,Remilia Scarlet,"GRANDMASTER I
G",0,21.7,207,45,162,ru
95,Hail of Blades,"GRANDMASTER I
G",0,24.2,161,39,122,ru
96,bingo666fly,"GRANDMASTER I
G",0,21.9,164,36,128,ru
97,Killl Lov3,"GRANDMASTER I
G",0,24.2,120,29,91,ru
98,iQuestions,"GRANDMASTER I
G",0,18.9,132,25,107,ru
99,AeCorah,MASTER I,0,24.9,558,139,419,ru
100,Леди Меламори,DIAMOND I,97,14.1,206,29,177,ru
101,Воруй94,DIAMOND I,86,26.2,141,37,104,ru
102,Th3Gambl3r,DIAMOND I,83,19.3,601,116,485,ru
103,BrotherFrank,DIAMOND I,77,26.2,126,33,93,ru
104,thanh169,DIAMOND I,75,22.8,552,126,426,ru
105,TOMSK7777,DIAMOND I,75,23.1,399,92,307,ru
106,ChinaNirvana,DIAMOND I,75,22.3,399,89,310,ru
107,Крушитель001,DIAMOND I,75,19.2,369,71,298,ru
108,EmperorCHN,DIAMOND I,75,25.4,264,67,197,ru
109,SUSUWE,DIAMOND I,75,17.0,383,65,318,ru
110,Lorraine,DIAMOND I,75,27.0,233,63,170,ru
111,DuongLan,DIAMOND I,75,16.1,367,59,308,ru
112,Eldrax,DIAMOND I,75,13.4,441,59,382,ru
113,lºˆºl,DIAMOND I,75,23.0,248,57,191,ru
114,1348319349,DIAMOND I,75,21.1,270,57,213,ru
115,Saitaf,DIAMOND I,75,23.0,226,52,174,ru
116,qsoso,DIAMOND I,75,17.2,302,52,250,ru
117,sketcheer,DIAMOND I,75,17.0,305,52,253,ru
118,dyboщит,DIAMOND I,75,18.5,276,51,225,ru
119,blvckboy,DIAMOND I,75,15.3,320,49,271,ru
120,Dunngarm,DIAMOND I,75,26.3,171,45,126,ru
121,CR0WNZ,DIAMOND I,75,16.0,269,43,226,ru
122,Make me Purr,DIAMOND I,75,20.0,200,40,160,ru
123,RaNdoOoMuK,DIAMOND I,75,20.5,190,39,151,ru
124,Just Cancer,DIAMOND I,75,18.4,207,38,169,ru
125,vulcaner,DIAMOND I,66,21.1,185,39,146,ru
126,Anurion89,DIAMOND I,56,20.3,306,62,244,ru
127,Ksorn,DIAMOND I,56,12.6,198,25,173,ru
128,Малолетка,DIAMOND I,54,33.3,75,25,50,ru
129,lanyuheissl55555,DIAMOND I,53,20.1,273,55,218,ru
130,Callsign Kindred,DIAMOND I,52,33.0,88,29,59,ru
131,Russiabang,DIAMOND I,51,11.7,197,23,174,ru
132,AKJSDs,DIAMOND I,49,24.9,201,50,151,ru
133,Дрeeейвен,DIAMOND I,48,11.0,662,73,589,ru
134,УРОД,DIAMOND I,48,40.1,177,71,106,ru
135,лесk urself jgl,DIAMOND I,46,20.4,201,41,160,ru
136,NorMe,DIAMOND I,46,18.4,152,28,124,ru
137,KissTheStar,DIAMOND I,44,9.2,413,38,375,ru
138,TG Rot Stillness,DIAMOND I,42,11.9,393,47,346,ru
139,junestone,DIAMOND I,41,30.4,214,65,149,ru
140,royál beggar,DIAMOND I,38,23.6,186,44,142,ru
141,Жабка Лиска,DIAMOND I,37,23.8,286,68,218,ru
142,ReMiXoN007,DIAMOND I,33,22.7,141,32,109,ru
143,8xm12a,DIAMOND I,32,11.6,276,32,244,ru
144,Tot,DIAMOND I,31,19.2,130,25,105,ru
145,Kalabaka,DIAMOND I,26,27.2,859,234,625,ru
146,PistolMaravich,DIAMOND I,25,36.1,263,95,168,ru
147,SUPRAAAA,DIAMOND I,25,26.3,99,26,73,ru
148,Kimchi wang,DIAMOND I,17,34.6,127,44,83,ru
149,LHYloveLWJ,DIAMOND I,16,14.5,434,63,371,ru
150,StaverOk,DIAMOND I,14,21.2,231,49,182,ru
151,beznika2,DIAMOND I,14,14.6,213,31,182,ru
152,kecodon9x,DIAMOND I,12,18.0,205,37,168,ru
153,Ji Yong,DIAMOND I,11,13.3,279,37,242,ru
154,ПоНосик в Одеяле,DIAMOND I,10,28.3,191,54,137,ru
155,SorrNyak,DIAMOND I,9,18.3,197,36,161,ru
156,Takanashi Hikka,DIAMOND I,9,18.6,167,31,136,ru
157,Cоming Down,DIAMOND I,4,17.1,216,37,179,ru
158,Evildeaad,DIAMOND I,4,27.8,90,25,65,ru
159,ktotamnukogonet,DIAMOND I,3,25.8,128,33,95,ru
160,royál beggar,DIAMOND I,3,20.7,150,31,119,ru
161,angelys,DIAMOND I,3,10.4,288,30,258,ru
162,oi SEREGA io,DIAMOND I,0,12.2,985,120,865,ru
163,CN liang,DIAMOND I,0,16.4,422,69,353,ru
164,Janelicher,DIAMOND I,0,28.8,208,60,148,ru
165,Лёшкина игра,DIAMOND I,0,24.2,231,56,175,ru
166,Вика Клубника,DIAMOND I,0,21.3,249,53,196,ru
167,GGJIANG,DIAMOND I,0,18.9,281,53,228,ru
168,Лапки Юми,DIAMOND I,0,16.2,326,53,273,ru
169,LooKDKc,DIAMOND I,0,19.5,267,52,215,ru
170,LPL dynasty,DIAMOND I,0,21.7,212,46,166,ru
171,Фабио,DIAMOND I,0,21.1,199,42,157,ru
172,Мёртвый принц,DIAMOND I,0,18.1,221,40,181,ru
173,taibox,DIAMOND I,0,12.0,316,38,278,ru
174,EleemY,DIAMOND I,0,33.0,112,37,75,ru
175,clown syndrome,DIAMOND I,0,22.1,154,34,120,ru
176,sasha1OOO,DIAMOND I,0,18.6,177,33,144,ru
177,AkitoHunter,DIAMOND I,0,11.1,296,33,263,ru
178,PINCER,DIAMOND I,0,25.6,125,32,93,ru
179,JusticeNari,DIAMOND I,0,15.2,210,32,178,ru
180,Юрa,DIAMOND I,0,15.2,204,31,173,ru
181,Дым из трубы,DIAMOND I,0,27.2,103,28,75,ru
182,LРL,DIAMOND II,92,14.6,1012,148,864,ru
183,Napyyyy,DIAMOND II,89,14.4,271,39,232,ru
184,mTxFaT,DIAMOND II,85,18.3,881,161,720,ru
185,Wuaneon,DIAMOND II,85,19.1,152,29,123,ru
186,Ayumiclq313,DIAMOND II,84,23.6,123,29,94,ru
187,Emma Hix,DIAMOND II,82,27.4,117,32,85,ru
188,Arclight JinBey,DIAMOND II,81,18.2,318,58,260,ru
189,Desperateing,DIAMOND II,76,30.8,78,24,54,ru
190,laojiazuishuai,DIAMOND II,75,18.6,334,62,272,ru
191,WO S LAOMAOZI,DIAMOND II,75,21.6,268,58,210,ru
192,Bushuwotoudehong,DIAMOND II,75,19.9,276,55,221,ru
193,Lord Ochinchin,DIAMOND II,75,54.1,98,53,45,ru
194,RngUziJianZihao,DIAMOND II,75,18.4,266,49,217,ru
195,sitius1986,DIAMOND II,75,17.6,279,49,230,ru
196,N0SkillZz,DIAMOND II,75,36.5,126,46,80,ru
197,Мерцание,DIAMOND II,75,9.7,462,45,417,ru
198,CK Guard,DIAMOND II,75,24.7,178,44,134,ru
199,xcvwdst,DIAMOND II,75,41.2,102,42,60,ru
200,Mofu mofu,DIAMOND II,75,55.4,65,36,29,ru
201,Zhenya29,DIAMOND II,75,13.3,270,36,234,ru
202,БистФромЗеИст,DIAMOND II,75,18.6,183,34,149,ru
203,Futaba Sakura,DIAMOND II,75,24.8,129,32,97,ru
204,Sizif,DIAMOND II,75,11.7,179,21,158,ru
205,AileenWuornos,DIAMOND II,75,7.2,250,18,232,ru
206,KURISU ТИНА,DIAMOND II,72,19.3,965,186,779,ru
207,PewDiePew,DIAMOND II,70,22.6,221,50,171,ru
208,VN Error RoLL,DIAMOND II,69,13.6,617,84,533,ru
209,Jidaykin,DIAMOND II,68,16.2,283,46,237,ru
210,ASREN,DIAMOND II,66,18.8,138,26,112,ru
211,РОЗБИЙНЫК,DIAMOND II,65,14.1,510,72,438,ru
212,DEDASHAVAL,DIAMOND II,65,16.1,130,21,109,ru
213,DianaEatme,DIAMOND II,62,14.7,136,20,116,ru
214,DeadKedbl,DIAMOND II,61,29.8,188,56,132,ru
215,bone,DIAMOND II,56,13.7,278,38,240,ru
216,TheRedDevils,DIAMOND II,55,17.4,507,88,419,ru
217,STRMASTER,DIAMOND II,55,23.8,210,50,160,ru
218,LlosDi,DIAMOND II,54,21.1,525,111,414,ru
219,LurDOOM,DIAMOND II,53,18.1,481,87,394,ru
220,GEOtiger,DIAMOND II,50,16.1,286,46,240,ru
221,nn21,DIAMOND II,48,45.0,60,27,33,ru
222,MuTuZ,DIAMOND II,46,15.1,212,32,180,ru
223,Бионикл,DIAMOND II,42,12.5,368,46,322,ru
224,ljx001,DIAMOND II,42,20.4,201,41,160,ru
225,Coca Cola,DIAMOND II,40,15.8,374,59,315,ru
226,Donelly,DIAMOND II,40,14.3,175,25,150,ru
227,Vladimir Syusin,DIAMOND II,37,10.8,241,26,215,ru
228,bpbogdan,DIAMOND II,34,14.5,738,107,631,ru
229,mallaby,DIAMOND II,33,22.7,278,63,215,ru
230,Таксидермист1980,DIAMOND II,32,11.2,509,57,452,ru
231,Black Swift,DIAMOND II,31,19.7,228,45,183,ru
232,Darkwake,DIAMOND II,31,17.9,251,45,206,ru
233,СЛЕСАРЬ СБОРЩИК,DIAMOND II,31,11.9,202,24,178,ru
234,CHNFan,DIAMOND II,28,20.9,206,43,163,ru
235,ЛУЧШИЙ ИГРОК РУ,DIAMOND II,28,17.9,229,41,188,ru
236,E11iks,DIAMOND II,28,15.0,206,31,175,ru
237,cepl4,DIAMOND II,25,17.7,355,63,292,ru
238,Manode,DIAMOND II,25,18.4,261,48,213,ru
239,Леон Надо,DIAMOND II,25,30.3,122,37,85,ru
240,Dragon Chess,DIAMOND II,25,18.9,196,37,159,ru
241,wushengsimeng,DIAMOND II,25,26.8,127,34,93,ru
242,MyPABEu13,DIAMOND II,25,14.2,240,34,206,ru
243,Сижу чешу колоду,DIAMOND II,25,17.2,186,32,154,ru
244,Concubine,DIAMOND II,25,11.8,153,18,135,ru
245,RikQu,DIAMOND II,24,15.1,641,97,544,ru
246,ˆЛëësïnˆVNˆ,DIAMOND II,22,16.2,389,63,326,ru
247,Disnaix Kh,DIAMOND II,21,19.7,314,62,252,ru
248,Одинсан,DIAMOND II,21,16.0,307,49,258,ru
249,StrongestMalice,DIAMOND II,21,24.6,138,34,104,ru
250,daozige,DIAMOND II,21,16.1,193,31,162,ru
251,Cho Em Mãnh Thú,DIAMOND II,20,16.5,266,44,222,ru
252,SadSlipperS,DIAMOND II,18,11.7,528,62,466,ru
253,NickDeko,DIAMOND II,17,18.1,403,73,330,ru
254,Ruff85,DIAMOND II,17,24.1,249,60,189,ru
255,BONDJik,DIAMOND II,17,10.2,441,45,396,ru
256,Snowman322,DIAMOND II,16,14.2,466,66,400,ru
257,HMTuanRu,DIAMOND II,15,19.0,332,63,269,ru
258,EbokvakXXL,DIAMOND II,15,15.3,373,57,316,ru
259,LASTURN,DIAMOND II,15,20.5,259,53,206,ru
260,PieMaker,DIAMOND II,13,14.3,342,49,293,ru
261,bloodgammy,DIAMOND II,12,8.2,425,35,390,ru
262,Ignotas,DIAMOND II,10,22.1,86,19,67,ru
263,MashironIII,DIAMOND II,9,8.1,406,33,373,ru
264,новый год ios,DIAMOND II,7,16.5,194,32,162,ru
265,SERHIOVIP,DIAMOND II,7,13.3,211,28,183,ru
266,CapsuleZZZ,DIAMOND II,4,17.1,204,35,169,ru
267,BlackBURN,DIAMOND II,2,14.1,504,71,433,ru
268,великая река,DIAMOND II,2,17.1,170,29,141,ru
269,China Mortal,DIAMOND II,1,24.4,156,38,118,ru
270,GMLovelyBoy,DIAMOND II,1,27.8,108,30,78,ru
271,Matt,DIAMOND II,1,30.0,90,27,63,ru
272,ЗабулдыгаНовичёк,DIAMOND II,0,10.5,1279,134,1145,ru
273,LoveTrucks,DIAMOND II,0,16.6,604,100,504,ru
274,MIT811,DIAMOND II,0,16.1,589,95,494,ru
275,NikolayDjan,DIAMOND II,0,18.0,444,80,364,ru
276,FlorDaX,DIAMOND II,0,16.5,479,79,400,ru
277,Garru poterr bl9,DIAMOND II,0,11.7,622,73,549,ru
278,iamaha,DIAMOND II,0,19.3,363,70,293,ru
279,basist0s,DIAMOND II,0,14.1,489,69,420,ru
280,JVevermind,DIAMOND II,0,14.9,408,61,347,ru
281,VN Troll,DIAMOND II,0,8.9,674,60,614,ru
282,Reyzy Ligh,DIAMOND II,0,14.6,403,59,344,ru
283,justmax95,DIAMOND II,0,23.1,251,58,193,ru
284,DuKeH,DIAMOND II,0,17.5,291,51,240,ru
285,Kissler99,DIAMOND II,0,17.7,283,50,233,ru
286,Лирен,DIAMOND II,0,18.1,270,49,221,ru
287,4evernightmare,DIAMOND II,0,24.7,190,47,143,ru
288,кýсь,DIAMOND II,0,11.0,382,42,340,ru
289,GODLuck,DIAMOND II,0,18.6,221,41,180,ru
290,Dong XIao yu,DIAMOND II,0,20.1,189,38,151,ru
291,Фезам,DIAMOND II,0,14.2,268,38,230,ru
292,Vla Until You,DIAMOND II,0,20.7,179,37,142,ru
293,Weev,DIAMOND II,0,19.9,176,35,141,ru
294,zonapot,DIAMOND II,0,9.2,369,34,335,ru
295,ТРУСИКИ АНДРЕАСА,DIAMOND II,0,17.6,182,32,150,ru
296,Shanoa,DIAMOND II,0,11.4,228,26,202,ru
297,DMH1996,DIAMOND II,0,15.3,163,25,138,ru
298,minhplekhanovne,DIAMOND II,0,16.7,120,20,100,ru
299,Popcorn,DIAMOND II,0,17.5,97,17,80,ru
300,Alvarado,DIAMOND III,98,18.1,276,50,226,ru
301,SУKA,DIAMOND III,93,16.6,547,91,456,ru
302,Gelindjer,DIAMOND III,93,17.3,191,33,158,ru
303,lolstars,DIAMOND III,93,7.0,286,20,266,ru
304,Britney Shears,DIAMOND III,92,12.5,311,39,272,ru
305,Мистер Кусь,DIAMOND III,90,18.3,273,50,223,ru
306,Гриндамир,DIAMOND III,84,21.7,286,62,224,ru
307,PuddleOfChange,DIAMOND III,80,13.2,227,30,197,ru
308,leidianfawang,DIAMOND III,79,18.8,133,25,108,ru
309,Tima444,DIAMOND III,78,21.8,174,38,136,ru
310,olanva,DIAMOND III,75,19.9,403,80,323,ru
311,ID RANGO,DIAMOND III,75,15.9,397,63,334,ru
312,ShroudOfMystery,DIAMOND III,75,18.3,289,53,236,ru
313,kalan44,DIAMOND III,75,10.0,512,51,461,ru
314,GunnerMSK,DIAMOND III,75,19.7,254,50,204,ru
315,прекрасное свет,DIAMOND III,75,18.2,269,49,220,ru
316,JustSx,DIAMOND III,75,22.1,208,46,162,ru
317,Loyoish,DIAMOND III,75,23.3,189,44,145,ru
318,MJ Su Da Qiang,DIAMOND III,75,17.2,238,41,197,ru
319,rozeva,DIAMOND III,75,20.5,185,38,147,ru
320,Админ Кaзахстана,DIAMOND III,75,11.0,336,37,299,ru
321,ZelibobaUnited,DIAMOND III,75,27.7,119,33,86,ru
322,bloodlook,DIAMOND III,75,13.2,234,31,203,ru
323,10843701,DIAMOND III,75,34.9,86,30,56,ru
324,Crazyyeyeye,DIAMOND III,75,20.9,134,28,106,ru
325,Toveldo,DIAMOND III,75,20.9,134,28,106,ru
326,qqqe,DIAMOND III,75,13.8,160,22,138,ru
327,twitch tv guffee,DIAMOND III,75,41.2,51,21,30,ru
328,Akerasin,DIAMOND III,75,23.9,88,21,67,ru
329,PoisonPotion,DIAMOND III,75,11.1,135,15,120,ru
330,notnakeD,DIAMOND III,74,13.7,313,43,270,ru
331,UmroN,DIAMOND III,73,18.9,243,46,197,ru
332,Afei,DIAMOND III,72,20.7,386,80,306,ru
333,diegoMorales,DIAMOND III,72,14.3,203,29,174,ru
334,XPEHOPE33KA,DIAMOND III,71,21.9,164,36,128,ru
335,Havir,DIAMOND III,71,14.8,244,36,208,ru
336,LikeU,DIAMOND III,70,13.7,393,54,339,ru
337,westerin,DIAMOND III,69,9.7,391,38,353,ru
338,Shankly,DIAMOND III,68,16.9,278,47,231,ru
339,mAv,DIAMOND III,68,30.9,149,46,103,ru
340,одичалый мастер,DIAMOND III,68,11.7,299,35,264,ru
341,squeDzilla,DIAMOND III,66,16.2,333,54,279,ru
342,Прохиндей,DIAMOND III,66,18.2,198,36,162,ru
343,fckingay,DIAMOND III,66,21.8,101,22,79,ru
344,Lovelykira,DIAMOND III,65,16.7,276,46,230,ru
345,VNM Curly,DIAMOND III,64,17.5,251,44,207,ru
346,strikeGL,DIAMOND III,64,20.0,175,35,140,ru
347,gupobiluo,DIAMOND III,63,17.6,437,77,360,ru
348,REFLY,DIAMOND III,63,19.0,357,68,289,ru
349,SARUMAN,DIAMOND III,63,10.3,515,53,462,ru
350,kRAKEN,DIAMOND III,63,9.5,304,29,275,ru
351,Beeeeeeee,DIAMOND III,60,19.3,456,88,368,ru
352,менталэхо,DIAMOND III,59,24.2,165,40,125,ru
353,burunduk13,DIAMOND III,59,12.6,246,31,215,ru
354,DOROFEEVA NASTYA,DIAMOND III,58,13.6,169,23,146,ru
355,Trollpik666,DIAMOND III,57,4.5,373,17,356,ru
356,John  McClane 1,DIAMOND III,55,5.0,396,20,376,ru
357,Wind of Change,DIAMOND III,55,16.2,117,19,98,ru
358,kOpets,DIAMOND III,54,16.5,637,105,532,ru
359,EnergyDashClarko,DIAMOND III,54,14.2,268,38,230,ru
360,ChinhChinh,DIAMOND III,53,17.9,201,36,165,ru
361,Monitor97,DIAMOND III,53,15.1,185,28,157,ru
362,titanin,DIAMOND III,52,11.8,821,97,724,ru
363,Darak,DIAMOND III,52,17.3,179,31,148,ru
364,Kosma,DIAMOND III,51,22.0,268,59,209,ru
365,Вялый Перчик,DIAMOND III,51,13.3,429,57,372,ru
366,Хаоса,DIAMOND III,51,15.5,200,31,169,ru
367,Ksan Leon,DIAMOND III,49,19.4,268,52,216,ru
368,Глубже Некуда,DIAMOND III,49,6.9,522,36,486,ru
369,Bùm Bùm,DIAMOND III,48,20.5,551,113,438,ru
370,NZИ,DIAMOND III,47,15.1,238,36,202,ru
371,SM2LR,DIAMOND III,47,18.2,192,35,157,ru
372,Collide,DIAMOND III,47,18.4,179,33,146,ru
373,NinjaTips,DIAMOND III,47,21.8,101,22,79,ru
374,Amethyst,DIAMOND III,46,23.4,124,29,95,ru
375,The Shark Dog,DIAMOND III,45,16.1,378,61,317,ru
376,SEXOFFENDER TREE,DIAMOND III,45,16.3,135,22,113,ru
377,Ungraved,DIAMOND III,44,16.4,342,56,286,ru
378,Binkan Ichiro,DIAMOND III,44,15.7,331,52,279,ru
379,10 12 1997,DIAMOND III,43,16.1,485,78,407,ru
380,Justnеss,DIAMOND III,43,16.5,242,40,202,ru
381,nlinhsv21,DIAMOND III,43,20.7,150,31,119,ru
382,LeBron James 23,DIAMOND III,41,15.5,316,49,267,ru
383,TDK TheDikiY,DIAMOND III,41,28.4,116,33,83,ru
384,BaJlyxa,DIAMOND III,41,21.4,140,30,110,ru
385,IsaakFrost,DIAMOND III,40,11.1,434,48,386,ru
386,rip lil feel,DIAMOND III,40,21.9,105,23,82,ru
387,Черника,DIAMOND III,39,19.4,293,57,236,ru
388,OsKvErNiTeLь,DIAMOND III,37,14.6,417,61,356,ru
389,ªºЯ Ç 4 ДуракÅºª,DIAMOND III,37,16.7,329,55,274,ru
390,0SemeChka0,DIAMOND III,37,22.5,173,39,134,ru
391,Alyonkaa,DIAMOND III,36,12.3,421,52,369,ru
392,AnimeDeadAngel,DIAMOND III,35,15.1,212,32,180,ru
393,nook3r,DIAMOND III,34,16.1,254,41,213,ru
394,Georgekubi,DIAMOND III,34,28.1,89,25,64,ru
395,Onemelo,DIAMOND III,33,15.3,281,43,238,ru
396,Darkrayed,DIAMOND III,33,9.2,240,22,218,ru
397,NeBeriLopatu,DIAMOND III,32,12.6,712,90,622,ru
398,barkit,DIAMOND III,32,23.9,373,89,284,ru
399,Francis FU96785,DIAMOND III,32,26.8,112,30,82,ru
400,7ava3eans,DIAMOND III,31,7.6,922,70,852,ru
401,Panchess,DIAMOND III,31,25.0,120,30,90,ru
402,Kotleteus,DIAMOND III,30,12.3,375,46,329,ru
403,Antananarivu,DIAMOND III,29,16.3,430,70,360,ru
404,DIGAZAR,DIAMOND III,29,13.8,174,24,150,ru
405,Hybas,DIAMOND III,28,16.7,323,54,269,ru
406,motakyji,DIAMOND III,26,18.2,296,54,242,ru
407,SS best teacherr,DIAMOND III,26,8.9,169,15,154,ru
408,eXpertFr0mChat,DIAMOND III,25,22.8,246,56,190,ru
409,Dengziqiwang,DIAMOND III,25,26.3,171,45,126,ru
410,ZuliuSs,DIAMOND III,25,27.5,142,39,103,ru
411,GG Habib,DIAMOND III,25,15.5,252,39,213,ru
412,Xameleon Arzamas,DIAMOND III,25,10.3,349,36,313,ru
413,Aha1burn,DIAMOND III,25,21.9,137,30,107,ru
414,Мид это война,DIAMOND III,25,12.7,237,30,207,ru
415,chenghaowu,DIAMOND III,25,34.2,79,27,52,ru
416,Третийглаз,DIAMOND III,25,18.9,143,27,116,ru
417,1ittle1mmortal,DIAMOND III,25,23.2,99,23,76,ru
418,ManyFaced God,DIAMOND III,24,20.3,360,73,287,ru
419,StarburstStream,DIAMOND III,24,12.2,385,47,338,ru
420,Ajbarra,DIAMOND III,23,19.1,298,57,241,ru
421,Xopycwar,DIAMOND III,23,16.8,167,28,139,ru
422,Неоли,DIAMOND III,22,13.3,585,78,507,ru
423,Эль Дамирио,DIAMOND III,22,16.6,271,45,226,ru
424,GreshnikDevil,DIAMOND III,22,11.7,206,24,182,ru
425,КОРОЛЬ БОГ КОСМО,DIAMOND III,21,17.5,616,108,508,ru
426,Arclight SnoopCi,DIAMOND III,21,14.3,203,29,174,ru
427,Teax,DIAMOND III,20,17.6,170,30,140,ru
428,Aglibol,DIAMOND III,19,12.9,564,73,491,ru
429,GinGL,DIAMOND III,18,17.5,200,35,165,ru
430,Igrid1,DIAMOND III,18,11.7,120,14,106,ru
431,IDreamDiamond,DIAMOND III,18,7.6,158,12,146,ru
432,Afоnjja,DIAMOND III,17,13.0,285,37,248,ru
433,GanjaFourWay,DIAMOND III,17,9.8,194,19,175,ru
434,Zelosin,DIAMOND III,15,15.9,138,22,116,ru
435,Позор Джунглей,DIAMOND III,15,12.3,146,18,128,ru
436,EviL Holy,DIAMOND III,13,10.7,681,73,608,ru
437,Kostanayskiy,DIAMOND III,13,19.4,227,44,183,ru
438,ikorostilev,DIAMOND III,13,16.7,150,25,125,ru
439,iNLоve,DIAMOND III,12,12.2,351,43,308,ru
440,Dev1l Ykt,DIAMOND III,11,13.5,416,56,360,ru
441,NOMADEKB,DIAMOND III,11,14.9,148,22,126,ru
442,Винча,DIAMOND III,10,17.6,188,33,155,ru
443,married isSHIT,DIAMOND III,9,22.2,203,45,158,ru
444,ЛоуСкил,DIAMOND III,8,12.8,406,52,354,ru
445,VERENGUE UA,DIAMOND III,7,15.3,242,37,205,ru
446,отправь ню,DIAMOND III,7,22.2,90,20,70,ru
447,lywh,DIAMOND III,7,13.1,61,8,53,ru
448,lukoshko,DIAMOND III,6,7.7,443,34,409,ru
449,Herr Schrödinger,DIAMOND III,6,18.6,156,29,127,ru
450,Xitoriki,DIAMOND III,6,12.4,153,19,134,ru
451,Benedetta Love,DIAMOND III,5,10.8,185,20,165,ru
452,Azu,DIAMOND III,3,11.6,610,71,539,ru
453,Raome,DIAMOND III,3,14.6,253,37,216,ru
454,Fastshott,DIAMOND III,3,12.4,226,28,198,ru
455,ХхX,DIAMOND III,3,11.0,163,18,145,ru
456,Dragonall,DIAMOND III,2,22.7,225,51,174,ru
457,Ной,DIAMOND III,2,10.0,249,25,224,ru
458,zergoood,DIAMOND III,2,16.1,137,22,115,ru
459,Fack you girl,DIAMOND III,1,16.1,354,57,297,ru
460,Сальери,DIAMOND III,1,9.9,506,50,456,ru
461,Brentaal,DIAMOND III,1,22.8,197,45,152,ru
462,Мальчик анальчик,DIAMOND III,1,23.5,153,36,117,ru
463,zhangyi111,DIAMOND III,1,21.6,111,24,87,ru
464,Alive4ever,DIAMOND III,0,18.1,343,62,281,ru
465,3610bashmak,DIAMOND III,0,15.7,299,47,252,ru
466,DonJuanHS,DIAMOND III,0,15.9,289,46,243,ru
467,FG KING rank1,DIAMOND III,0,19.6,230,45,185,ru
468,GothMercer,DIAMOND III,0,16.0,281,45,236,ru
469,ToxIIcTEN,DIAMOND III,0,17.1,251,43,208,ru
470,XХXTENTAСION,DIAMOND III,0,11.8,322,38,284,ru
471,Luuthienan,DIAMOND III,0,26.8,138,37,101,ru
472,China BaoBao,DIAMOND III,0,26.3,133,35,98,ru
473,Ozarin,DIAMOND III,0,9.1,385,35,350,ru
474,HolyTRVP,DIAMOND III,0,17.4,195,34,161,ru
475,DeathWeeng,DIAMOND III,0,9.7,352,34,318,ru
476,spaNe,DIAMOND III,0,31.4,102,32,70,ru
477,EA7 AshpAreniJ,DIAMOND III,0,19.8,162,32,130,ru
478,Die Young,DIAMOND III,0,26.5,113,30,83,ru
479,Чики Бoмбини,DIAMOND III,0,12.4,241,30,211,ru
480,55dd,DIAMOND III,0,13.3,218,29,189,ru
481,DutchAngle,DIAMOND III,0,16.9,166,28,138,ru
482,little ma,DIAMOND III,0,32.5,83,27,56,ru
483,Xлeбушeк,DIAMOND III,0,16.3,166,27,139,ru
484,Tiasik,DIAMOND III,0,17.1,140,24,116,ru
485,Smokeee,DIAMOND III,0,12.5,192,24,168,ru
486,Holy Nightroad,DIAMOND III,0,9.8,244,24,220,ru
487,Ласточка,DIAMOND III,0,13.8,166,23,143,ru
488,FaraonApple,DIAMOND III,0,9.2,240,22,218,ru
489,Angostura,DIAMOND III,0,21.6,97,21,76,ru
490,Kaitouz,DIAMOND III,0,18.8,112,21,91,ru
491,MaMa Я Не РаК,DIAMOND III,0,11.9,176,21,155,ru
492,АНГЕЛСМЕРТИ2009,DIAMOND III,0,16.9,118,20,98,ru
493,White BloodAngel,DIAMOND III,0,16.0,119,19,100,ru
494,Stan Truman,DIAMOND III,0,11.2,170,19,151,ru
495,Jedis2C2S,DIAMOND III,0,15.3,111,17,94,ru
496,TiltMasta,DIAMOND IV,99,14.1,149,21,128,ru
497,AzureDn,DIAMOND IV,95,17.3,202,35,167,ru
498,MANNЯK,DIAMOND IV,94,20.4,367,75,292,ru
499,Юраa,DIAMOND IV,94,60.5,43,26,17,ru
500,CrazyNik,DIAMOND IV,92,11.2,410,46,364,ru
