RANK,NAME,TIER,LP,WIN RATE,PLAYED,WINS,LOSSES,REGION
1,Mismatched Socks,CHALLENGER I,1495,21.4,491,105,386,na
2,Ms MatchedSocks,CHALLENGER I,1492,21.9,451,99,352,na
3,Salvyyy,CHALLENGER I,1479,26.6,282,75,207,na
4,gv8,CHALLENGER I,1385,21.1,554,117,437,na
5,FluffyHS,CHALLENGER I,1354,18.3,453,83,370,na
6,GrandVice8,CHALLENGER I,1259,19.7,727,143,584,na
7,bertasaurus,CHALLENGER I,1241,17.7,943,167,776,na
8,Naturesbf,CHALLENGER I,1238,15.4,934,144,790,na
9,Kurumx,CHALLENGER I,1181,20.0,585,117,468,na
10,Hiraino,CHALLENGER I,1125,15.9,880,140,740,na
11,ajmonsta,CHALLENGER I,1105,16.5,533,88,445,na
12,Cottontail,CHALLENGER I,1026,15.4,689,106,583,na
13,Krmx,CHALLENGER I,1009,20.3,634,129,505,na
14,themackerel,CHALLENGER I,1003,13.4,730,98,632,na
15,JIGEJIUWO,CHALLENGER I,1000,16.7,521,87,434,na
16,Silliest,CHALLENGER I,983,25.4,358,91,267,na
17,lLykus,CHALLENGER I,957,16.4,880,144,736,na
18,AceofSpadesDAC,CHALLENGER I,954,18.0,668,120,548,na
19,111094 R,CHALLENGER I,942,13.7,1697,233,1464,na
20,Gunmay,CHALLENGER I,942,11.0,498,55,443,na
21,GoyoTV,CHALLENGER I,920,15.7,842,132,710,na
22,Old Lodo,CHALLENGER I,915,16.2,406,66,340,na
23,Grillsyy,CHALLENGER I,911,15.8,735,116,619,na
24,The Cxk,CHALLENGER I,901,17.0,411,70,341,na
25,Kiyoon,CHALLENGER I,876,18.6,1004,187,817,na
26,Inphinit3,CHALLENGER I,853,16.2,494,80,414,na
27,EAOST,CHALLENGER I,846,14.8,562,83,479,na
28,ttv KitingisHard,CHALLENGER I,843,17.2,956,165,791,na
29,HiROKKKKJP,CHALLENGER I,836,16.4,598,98,500,na
30,Nice Mister Kien,CHALLENGER I,826,16.8,489,82,407,na
31,Agon,CHALLENGER I,822,18.1,803,145,658,na
32,Kled Bundy,CHALLENGER I,821,13.7,1352,185,1167,na
33,v Köi v,CHALLENGER I,817,21.9,366,80,286,na
34,dowfu ph,CHALLENGER I,817,20.6,267,55,212,na
35,ItzYaBoyBeasty,CHALLENGER I,813,17.1,1014,173,841,na
36,influrrier,CHALLENGER I,812,16.1,948,153,795,na
37,C9 k3soju,CHALLENGER I,811,20.6,1031,213,818,na
38,BIuePrincess,CHALLENGER I,811,18.9,243,46,197,na
39,Live for the Day,CHALLENGER I,809,19.4,839,163,676,na
40,Ripple Overdrive,CHALLENGER I,806,15.3,307,47,260,na
41,enchabi,CHALLENGER I,796,16.2,297,48,249,na
42,WhySofaKing,CHALLENGER I,792,14.8,506,75,431,na
43,inay,CHALLENGER I,763,15.9,979,156,823,na
44,Eason with U,CHALLENGER I,762,20.9,297,62,235,na
45,H2211,CHALLENGER I,744,20.0,1180,236,944,na
46,wx qq258790278,CHALLENGER I,738,19.4,422,82,340,na
47,Flandre Bot,CHALLENGER I,733,17.0,241,41,200,na
48,M35S,CHALLENGER I,721,15.0,921,138,783,na
49,Ex Railgun,CHALLENGER I,715,16.7,786,131,655,na
50,Fxxx Yaaa,CHALLENGER I,710,18.1,414,75,339,na
51,TempestLife,CHALLENGER I,710,19.6,281,55,226,na
52,KurumWintrade4,CHALLENGER I,710,16.9,284,48,236,na
53,TheMagykal,CHALLENGER I,708,16.6,928,154,774,na
54,PockyGom,CHALLENGER I,704,15.6,729,114,615,na
55,theMaskedPatel,CHALLENGER I,704,16.6,326,54,272,na
56,Me Predator,CHALLENGER I,693,18.1,314,57,257,na
57,Souless,CHALLENGER I,684,23.2,185,43,142,na
58,Ol Lodo,CHALLENGER I,680,15.7,464,73,391,na
59,McDull,CHALLENGER I,676,14.6,830,121,709,na
60,Xerluk,CHALLENGER I,671,14.0,666,93,573,na
61,Zadust TFT,CHALLENGER I,670,15.7,586,92,494,na
62,TwitchTV Odyceuz,CHALLENGER I,667,17.7,481,85,396,na
63,pastafartianist,CHALLENGER I,666,22.5,231,52,179,na
64,qieqie,CHALLENGER I,665,19.1,540,103,437,na
65,wo chi bu pang,CHALLENGER I,665,18.1,293,53,240,na
66,MaskedPatel,CHALLENGER I,664,15.3,241,37,204,na
67,ChrisKillsX,CHALLENGER I,661,20.1,159,32,127,na
68,WANG SHUO ZHE,CHALLENGER I,654,18.3,289,53,236,na
69,NA SMURF KEKW,CHALLENGER I,653,17.2,221,38,183,na
70,Humilis,CHALLENGER I,645,13.5,281,38,243,na
71,BeIiever,CHALLENGER I,644,20.9,623,130,493,na
72,Sphinx,CHALLENGER I,642,9.8,755,74,681,na
73,ogapmaler cuck,CHALLENGER I,642,24.5,147,36,111,na
74,brofael,CHALLENGER I,640,12.9,1208,156,1052,na
75,Akurai,CHALLENGER I,640,18.1,349,63,286,na
76,JayGeBee,CHALLENGER I,634,14.5,656,95,561,na
77,PureAlohaa,CHALLENGER I,634,16.7,383,64,319,na
78,Jangsterang,CHALLENGER I,632,15.4,397,61,336,na
79,ME EIGHTH,CHALLENGER I,629,16.7,240,40,200,na
80,TTV Kenya1,CHALLENGER I,613,15.3,704,108,596,na
81,Bulls0717,CHALLENGER I,611,12.0,484,58,426,na
82,Cris,CHALLENGER I,609,14.2,1502,213,1289,na
83,FinaldF,CHALLENGER I,609,13.0,1393,181,1212,na
84,Mango TheHun,CHALLENGER I,608,17.2,250,43,207,na
85,firest0ne,CHALLENGER I,604,7.5,1637,123,1514,na
86,Wrackle,CHALLENGER I,604,13.9,388,54,334,na
87,enaek,CHALLENGER I,602,20.6,402,83,319,na
88,Aesah,CHALLENGER I,601,19.2,630,121,509,na
89,DoraAmon,CHALLENGER I,600,27.4,124,34,90,na
90,DeadlyCO2,CHALLENGER I,598,11.9,537,64,473,na
91,paulhnlee,CHALLENGER I,597,22.1,213,47,166,na
92,Broccóli,CHALLENGER I,596,14.5,516,75,441,na
93,slippinbug,CHALLENGER I,596,17.2,303,52,251,na
94,Coleman TFT,CHALLENGER I,596,19.1,220,42,178,na
95,FroSteeMate,CHALLENGER I,594,15.1,1188,179,1009,na
96,iCopyKeane,CHALLENGER I,593,12.1,346,42,304,na
97,P1KACHuuuuuuu,CHALLENGER I,593,31.1,103,32,71,na
98,Blaim,CHALLENGER I,592,16.3,706,115,591,na
99,Stompalittle,CHALLENGER I,591,14.6,1271,185,1086,na
100,TFT Parval,CHALLENGER I,591,13.9,519,72,447,na
101,Xeno,CHALLENGER I,587,19.7,299,59,240,na
102,lnaban,CHALLENGER I,585,15.6,674,105,569,na
103,Twitch RayditzFN,CHALLENGER I,583,15.8,1236,195,1041,na
104,VX15152242663,CHALLENGER I,582,19.2,572,110,462,na
105,Simple Plan,CHALLENGER I,580,14.1,629,89,540,na
106,birdwings,CHALLENGER I,572,13.5,349,47,302,na
107,TTV OmniPieTV,CHALLENGER I,571,16.2,974,158,816,na
108,qie77777mimi,CHALLENGER I,568,17.9,284,51,233,na
109,Nhân tâm TFT,CHALLENGER I,565,18.4,282,52,230,na
110,morellos,CHALLENGER I,564,17.6,262,46,216,na
111,Kalsuo,CHALLENGER I,563,16.7,888,148,740,na
112,TFTbigJB,CHALLENGER I,558,17.0,458,78,380,na
113,Oonnii,CHALLENGER I,558,21.0,353,74,279,na
114,Turn1Delver,CHALLENGER I,557,14.4,1607,231,1376,na
115,Eunwilf,CHALLENGER I,557,18.1,314,57,257,na
116,Tinkady,CHALLENGER I,556,18.3,590,108,482,na
117,Doublezzzz,CHALLENGER I,555,13.4,691,93,598,na
118,Mean Mister Kien,CHALLENGER I,554,14.4,735,106,629,na
119,BetOnMe,CHALLENGER I,553,15.2,402,61,341,na
120,RIOT thatsPRIMAL,CHALLENGER I,552,11.2,953,107,846,na
121,DxnTFT,CHALLENGER I,549,15.9,812,129,683,na
122,LGD Wet1less,CHALLENGER I,548,14.8,304,45,259,na
123,Elvisbeback,CHALLENGER I,546,10.7,308,33,275,na
124,17º C,CHALLENGER I,542,18.4,452,83,369,na
125,Terde,CHALLENGER I,541,17.7,622,110,512,na
126,Ashe The Frost,CHALLENGER I,540,11.3,687,78,609,na
127,TheHentaiGod,CHALLENGER I,539,15.8,738,117,621,na
128,BlackBigBig,CHALLENGER I,538,18.2,506,92,414,na
129,RippleOverdrive2,CHALLENGER I,538,21.6,176,38,138,na
130,DeliciousMilkGG,CHALLENGER I,534,25.6,489,125,364,na
131,Scoped32,CHALLENGER I,534,16.1,410,66,344,na
132,Lab Member 001,CHALLENGER I,532,16.0,343,55,288,na
133,Moggy Mako,CHALLENGER I,530,9.0,663,60,603,na
134,Kira,CHALLENGER I,528,16.6,578,96,482,na
135,JinxedJKK,CHALLENGER I,527,16.2,340,55,285,na
136,Sojin,CHALLENGER I,525,15.4,841,130,711,na
137,Kłaytøn,CHALLENGER I,525,15.1,509,77,432,na
138,robinsongz,CHALLENGER I,523,15.1,404,61,343,na
139,Sin 94 ToFu,CHALLENGER I,523,14.9,370,55,315,na
140,BadlandzTV,CHALLENGER I,523,19.7,132,26,106,na
141,ttv influrrier,CHALLENGER I,522,14.2,614,87,527,na
142,Dairon TFT,CHALLENGER I,522,16.8,298,50,248,na
143,KomradeKush,CHALLENGER I,519,12.1,808,98,710,na
144,Eunsol    K,CHALLENGER I,518,14.4,381,55,326,na
145,douyuTV980762,CHALLENGER I,516,15.2,512,78,434,na
146,BentoBot,CHALLENGER I,515,15.5,689,107,582,na
147,kavan,CHALLENGER I,514,16.1,372,60,312,na
148,Reigncat,CHALLENGER I,510,15.0,300,45,255,na
149,eyafeyafeyaf,CHALLENGER I,504,14.3,602,86,516,na
150,lilsteppy,CHALLENGER I,504,20.5,380,78,302,na
151,NicholasLy6,CHALLENGER I,504,19.9,287,57,230,na
152,blackwhited,CHALLENGER I,502,14.3,439,63,376,na
153,chickensaveme,CHALLENGER I,502,15.0,273,41,232,na
154,Agaze,CHALLENGER I,502,17.2,209,36,173,na
155,Jaekun3maX,CHALLENGER I,502,28.6,112,32,80,na
156,running 300golds,CHALLENGER I,500,18.1,738,134,604,na
157,piglet2448,CHALLENGER I,500,23.3,176,41,135,na
158,You MDZZ,CHALLENGER I,498,16.4,310,51,259,na
159,21 Zsy,CHALLENGER I,497,21.4,495,106,389,na
160,ttvGooGieGaminG,CHALLENGER I,497,13.7,388,53,335,na
161,tomrocks,CHALLENGER I,493,16.7,359,60,299,na
162,Lemon IceCream,CHALLENGER I,492,12.7,754,96,658,na
163,NED carry,CHALLENGER I,491,17.7,316,56,260,na
164,birdy511,CHALLENGER I,491,15.2,367,56,311,na
165,Fountaiin,CHALLENGER I,491,15.3,254,39,215,na
166,Catybear,CHALLENGER I,490,14.9,488,73,415,na
167,Liquid Saint,CHALLENGER I,490,19.2,359,69,290,na
168,TacticalLukarina,CHALLENGER I,488,15.0,840,126,714,na
169,Humilis TFT,CHALLENGER I,486,19.5,195,38,157,na
170,MikeP,CHALLENGER I,484,17.2,151,26,125,na
171,Wolves Save Me,CHALLENGER I,483,13.0,1028,134,894,na
172,sugasugasofly,CHALLENGER I,483,18.1,387,70,317,na
173,OrAnGe JuIc3,CHALLENGER I,483,13.5,399,54,345,na
174,Gurt Games,CHALLENGER I,483,9.1,517,47,470,na
175,AndyofSmurf,CHALLENGER I,483,19.4,180,35,145,na
176,kpopfan7,CHALLENGER I,482,14.1,163,23,140,na
177,Garchompro,CHALLENGER I,481,11.8,458,54,404,na
178,enchaB,CHALLENGER I,481,18.0,278,50,228,na
179,Cindys Dave,CHALLENGER I,478,15.4,622,96,526,na
180,the OCE special,CHALLENGER I,478,11.4,844,96,748,na
181,Jaekun2maX,CHALLENGER I,476,17.5,263,46,217,na
182,Jaekun4maX,CHALLENGER I,476,22.2,180,40,140,na
183,Muffinn TFT,CHALLENGER I,476,18.3,219,40,179,na
184,chitosechitose,CHALLENGER I,475,14.2,649,92,557,na
185,Mister Lau,CHALLENGER I,474,16.2,808,131,677,na
186,WúJi,CHALLENGER I,473,18.1,248,45,203,na
187,WafWafWaffle,CHALLENGER I,472,15.6,392,61,331,na
188,zTaidana,CHALLENGER I,472,16.4,354,58,296,na
189,TTV iantyler,CHALLENGER I,471,16.8,346,58,288,na
190,FayeBae,CHALLENGER I,469,14.1,440,62,378,na
191,yyasuooo,CHALLENGER I,469,22.2,144,32,112,na
192,Keane fans,CHALLENGER I,468,17.0,1232,209,1023,na
193,AndyofLove,CHALLENGER I,467,17.2,303,52,251,na
194,George Brown TFT,CHALLENGER I,465,14.5,491,71,420,na
195,RamKev,CHALLENGER I,463,14.9,818,122,696,na
196,DouYu 980762,CHALLENGER I,460,23.1,208,48,160,na
197,chainpullz,CHALLENGER I,454,13.8,296,41,255,na
198,eue,CHALLENGER I,441,11.0,862,95,767,na
199,Yondai,CHALLENGER I,433,16.1,477,77,400,na
200,TTV NatrixGGs,CHALLENGER I,345,12.8,1158,148,1010,na
201,Midrash,"GRANDMASTER I
G",507,16.0,394,63,331,na
202,HappyMuffinn,"GRANDMASTER I
G",487,18.5,259,48,211,na
203,DreamErica,"GRANDMASTER I
G",473,14.6,1000,146,854,na
204,Visual,"GRANDMASTER I
G",471,16.6,488,81,407,na
205,ootay,"GRANDMASTER I
G",461,22.1,316,70,246,na
206,Stonerule,"GRANDMASTER I
G",460,17.9,419,75,344,na
207,Sun Astronaut,"GRANDMASTER I
G",460,14.0,321,45,276,na
208,Kintsugí,"GRANDMASTER I
G",458,12.8,852,109,743,na
209,JiaJiaJiaJiaJia,"GRANDMASTER I
G",457,18.8,489,92,397,na
210,NALelouuch,"GRANDMASTER I
G",455,12.8,879,113,766,na
211,esportslaw jr,"GRANDMASTER I
G",455,23.8,193,46,147,na
212,LEGOGOGO,"GRANDMASTER I
G",453,17.2,180,31,149,na
213,xplitcit,"GRANDMASTER I
G",451,14.7,937,138,799,na
214,x BadlandzTV x,"GRANDMASTER I
G",448,18.0,206,37,169,na
215,C9 Khroen,"GRANDMASTER I
G",444,19.2,381,73,308,na
216,AlanLube,"GRANDMASTER I
G",437,15.8,183,29,154,na
217,El Conejo Malo,"GRANDMASTER I
G",433,20.4,284,58,226,na
218,Msquared,"GRANDMASTER I
G",433,14.5,325,47,278,na
219,Deleuzer,"GRANDMASTER I
G",432,13.6,514,70,444,na
220,piggy2448,"GRANDMASTER I
G",430,18.5,372,69,303,na
221,Tapaz,"GRANDMASTER I
G",428,25.8,186,48,138,na
222,thomas tft,"GRANDMASTER I
G",427,13.0,570,74,496,na
223,Decisivewayy,"GRANDMASTER I
G",425,13.4,732,98,634,na
224,Keane tf,"GRANDMASTER I
G",425,18.8,356,67,289,na
225,felice,"GRANDMASTER I
G",424,15.9,176,28,148,na
226,Ayetrix,"GRANDMASTER I
G",419,12.3,734,90,644,na
227,TwTv Funkyyfrog,"GRANDMASTER I
G",411,13.5,347,47,300,na
228,tapiokaoisii,"GRANDMASTER I
G",405,11.0,528,58,470,na
229,tinkady69,"GRANDMASTER I
G",402,16.7,239,40,199,na
230,Leii,"GRANDMASTER I
G",401,12.8,592,76,516,na
231,TFT TheTian,"GRANDMASTER I
G",401,17.4,259,45,214,na
232,DiDiDik,"GRANDMASTER I
G",393,18.0,339,61,278,na
233,Fyslexic Duck,"GRANDMASTER I
G",390,15.4,253,39,214,na
234,zzzzzzZ7,"GRANDMASTER I
G",389,19.8,227,45,182,na
235,tran98huy,"GRANDMASTER I
G",386,18.4,435,80,355,na
236,Azcryte,"GRANDMASTER I
G",386,16.7,245,41,204,na
237,WuHB,"GRANDMASTER I
G",385,17.2,933,161,772,na
238,2418,"GRANDMASTER I
G",385,14.7,334,49,285,na
239,ItzBeastyTFT69,"GRANDMASTER I
G",381,21.3,164,35,129,na
240,Scoped23,"GRANDMASTER I
G",379,20.4,211,43,168,na
241,A shadowy figure,"GRANDMASTER I
G",377,15.8,568,90,478,na
242,TheMambaMachine,"GRANDMASTER I
G",375,18.3,579,106,473,na
243,anmin9nb,"GRANDMASTER I
G",372,14.5,448,65,383,na
244,DannySaysNo,"GRANDMASTER I
G",371,14.9,585,87,498,na
245,micheIIe obama,"GRANDMASTER I
G",367,12.9,340,44,296,na
246,Incompl,"GRANDMASTER I
G",365,11.2,453,51,402,na
247,DeIiciousMilfGG,"GRANDMASTER I
G",364,17.7,310,55,255,na
248,ShakeShakeFries,"GRANDMASTER I
G",362,18.6,242,45,197,na
249,Incite,"GRANDMASTER I
G",361,15.6,749,117,632,na
250,zugrug,"GRANDMASTER I
G",360,13.4,782,105,677,na
251,WafWafWaf,"GRANDMASTER I
G",358,16.8,345,58,287,na
252,DLvx15299128725,"GRANDMASTER I
G",356,19.4,443,86,357,na
253,vaIsartan,"GRANDMASTER I
G",353,16.1,466,75,391,na
254,WorldFamousFries,"GRANDMASTER I
G",352,18.3,421,77,344,na
255,Tonyoff,"GRANDMASTER I
G",351,17.8,281,50,231,na
256,TwTV neekynooky,"GRANDMASTER I
G",347,14.8,1377,204,1173,na
257,FFception,"GRANDMASTER I
G",347,16.8,273,46,227,na
258,buscusu,"GRANDMASTER I
G",344,18.4,791,146,645,na
259,YxmNA,"GRANDMASTER I
G",343,15.8,202,32,170,na
260,ARee,"GRANDMASTER I
G",342,13.9,582,81,501,na
261,mcsorley33,"GRANDMASTER I
G",342,18.8,181,34,147,na
262,LilRoyW,"GRANDMASTER I
G",338,11.1,963,107,856,na
263,OmniPie,"GRANDMASTER I
G",338,13.2,797,105,692,na
264,L1ssandra,"GRANDMASTER I
G",337,14.5,427,62,365,na
265,jwolly,"GRANDMASTER I
G",333,15.1,350,53,297,na
266,a wittle penguin,"GRANDMASTER I
G",331,16.1,267,43,224,na
267,MegaInfernoBomb,"GRANDMASTER I
G",328,15.6,250,39,211,na
268,NALiocardia,"GRANDMASTER I
G",328,28.3,120,34,86,na
269,TTV iGJaeger,"GRANDMASTER I
G",326,19.6,199,39,160,na
270,TheWaterBearr,"GRANDMASTER I
G",325,13.6,663,90,573,na
271,Balrox,"GRANDMASTER I
G",324,14.7,184,27,157,na
272,Dealer Buling,"GRANDMASTER I
G",322,14.3,537,77,460,na
273,best Taro NA,"GRANDMASTER I
G",319,15.0,393,59,334,na
274,mdngplz,"GRANDMASTER I
G",317,9.4,933,88,845,na
275,TTVHentaiGodTFT,"GRANDMASTER I
G",315,22.3,148,33,115,na
276,matchedsock,"GRANDMASTER I
G",313,19.4,93,18,75,na
277,VenusZ,"GRANDMASTER I
G",311,17.6,776,137,639,na
278,gead813,"GRANDMASTER I
G",311,17.9,440,79,361,na
279,Ricechong,"GRANDMASTER I
G",309,14.1,326,46,280,na
280,MrEllusive,"GRANDMASTER I
G",309,19.6,204,40,164,na
281,Jaekun1maX,"GRANDMASTER I
G",305,18.2,242,44,198,na
282,fast eighth,"GRANDMASTER I
G",304,13.7,219,30,189,na
283,BKrisz TFT,"GRANDMASTER I
G",303,13.0,555,72,483,na
284,4arp,"GRANDMASTER I
G",303,9.9,676,67,609,na
285,Volc4884,"GRANDMASTER I
G",301,18.3,306,56,250,na
286,Keíko Kubota,"GRANDMASTER I
G",300,20.3,123,25,98,na
287,wxqq757081727,"GRANDMASTER I
G",299,25.3,154,39,115,na
288,DivìNe,"GRANDMASTER I
G",297,15.8,392,62,330,na
289,zebroe,"GRANDMASTER I
G",295,13.8,704,97,607,na
290,Lodo,"GRANDMASTER I
G",293,23.3,150,35,115,na
291,JukeYou,"GRANDMASTER I
G",292,18.2,329,60,269,na
292,Slooper TFT,"GRANDMASTER I
G",291,27.0,122,33,89,na
293,DocPwn,"GRANDMASTER I
G",290,17.0,395,67,328,na
294,Riot C,"GRANDMASTER I
G",290,17.5,285,50,235,na
295,Cheney,"GRANDMASTER I
G",290,15.4,266,41,225,na
296,Purify,"GRANDMASTER I
G",289,13.5,1020,138,882,na
297,TurboARAM,"GRANDMASTER I
G",288,14.5,518,75,443,na
298,Nhân Tâm,"GRANDMASTER I
G",288,16.6,374,62,312,na
299,thi3n,"GRANDMASTER I
G",286,14.9,1458,217,1241,na
300,KurumsSoreNut,"GRANDMASTER I
G",286,25.6,125,32,93,na
301,Qwat02,"GRANDMASTER I
G",285,16.2,1473,239,1234,na
302,JustinPerson,"GRANDMASTER I
G",283,12.3,511,63,448,na
303,Cuan TianhouRRRR,"GRANDMASTER I
G",281,16.4,401,66,335,na
304,Yiggles,"GRANDMASTER I
G",279,15.4,786,121,665,na
305,Flashbâng,"GRANDMASTER I
G",279,8.8,860,76,784,na
306,IllllllIIIIlllll,"GRANDMASTER I
G",279,18.3,301,55,246,na
307,alohu,"GRANDMASTER I
G",279,11.6,447,52,395,na
308,anewwplayer,"GRANDMASTER I
G",279,17.7,265,47,218,na
309,jªrred,"GRANDMASTER I
G",277,14.0,659,92,567,na
310,Pawnup,"GRANDMASTER I
G",277,14.2,339,48,291,na
311,MO LI LV CHA,"GRANDMASTER I
G",275,13.3,503,67,436,na
312,Crapchi,"GRANDMASTER I
G",274,19.4,175,34,141,na
313,mawco,"GRANDMASTER I
G",274,15.3,196,30,166,na
314,1375,"GRANDMASTER I
G",274,22.9,105,24,81,na
315,I Died To A Bard,"GRANDMASTER I
G",273,16.2,536,87,449,na
316,michhh12,"GRANDMASTER I
G",273,11.8,433,51,382,na
317,ttvidontdocardio,"GRANDMASTER I
G",273,14.2,211,30,181,na
318,CrazyGuimei,"GRANDMASTER I
G",272,11.9,757,90,667,na
319,skunkywinn,"GRANDMASTER I
G",272,15.9,517,82,435,na
320,markersx TFT,"GRANDMASTER I
G",270,14.8,623,92,531,na
321,Darthnater,"GRANDMASTER I
G",270,11.6,258,30,228,na
322,a speedy boi,"GRANDMASTER I
G",266,17.0,159,27,132,na
323,Dios12138,"GRANDMASTER I
G",265,12.6,348,44,304,na
324,ShaftMcBuldge,"GRANDMASTER I
G",264,19.1,283,54,229,na
325,Âzarin,"GRANDMASTER I
G",264,15.4,272,42,230,na
326,GUAO,"GRANDMASTER I
G",261,14.2,351,50,301,na
327,Olive JP,"GRANDMASTER I
G",260,14.4,375,54,321,na
328,GIXinGGG,"GRANDMASTER I
G",260,13.8,312,43,269,na
329,Bonzolo,"GRANDMASTER I
G",259,14.6,808,118,690,na
330,shireen4,"GRANDMASTER I
G",259,16.3,392,64,328,na
331,TFT Moody,"GRANDMASTER I
G",259,18.1,232,42,190,na
332,hâppy game,"GRANDMASTER I
G",257,17.0,294,50,244,na
333,leepaul,"GRANDMASTER I
G",254,24.2,153,37,116,na
334,paxytft,"GRANDMASTER I
G",252,12.8,1019,130,889,na
335,Oonii,"GRANDMASTER I
G",252,16.1,477,77,400,na
336,uhouhochao,"GRANDMASTER I
G",252,9.9,769,76,693,na
337,Twitch Josepao1o,"GRANDMASTER I
G",252,23.1,324,75,249,na
338,d u j b,"GRANDMASTER I
G",250,14.3,546,78,468,na
339,CounTerWu,"GRANDMASTER I
G",249,13.5,624,84,540,na
340,George Brown,"GRANDMASTER I
G",248,12.0,618,74,544,na
341,Anbicion,"GRANDMASTER I
G",247,12.3,267,33,234,na
342,edzwoo,"GRANDMASTER I
G",246,17.3,295,51,244,na
343,thresh hook me,"GRANDMASTER I
G",246,9.5,262,25,237,na
344,Fearcely,"GRANDMASTER I
G",245,17.9,257,46,211,na
345,buu buu desu,"GRANDMASTER I
G",244,13.0,783,102,681,na
346,dontbullme,"GRANDMASTER I
G",242,16.1,322,52,270,na
347,vAhern,"GRANDMASTER I
G",242,22.2,212,47,165,na
348,OFF WHITE XLV,"GRANDMASTER I
G",241,10.8,1531,165,1366,na
349,AsianGamer5,"GRANDMASTER I
G",240,17.9,989,177,812,na
350,Ballhurts,"GRANDMASTER I
G",239,14.6,622,91,531,na
351,garet,"GRANDMASTER I
G",239,13.6,528,72,456,na
352,King Kenneth,"GRANDMASTER I
G",239,13.1,510,67,443,na
353,Goko Ruri,"GRANDMASTER I
G",235,15.5,322,50,272,na
354,Twitch Sendohrai,"GRANDMASTER I
G",233,17.3,133,23,110,na
355,Binhja,"GRANDMASTER I
G",232,16.3,306,50,256,na
356,dpei,"GRANDMASTER I
G",231,16.7,424,71,353,na
357,adreh NA,"GRANDMASTER I
G",230,16.8,250,42,208,na
358,HKBag,"GRANDMASTER I
G",229,22.1,149,33,116,na
359,kentwuhoo,"GRANDMASTER I
G",228,15.7,242,38,204,na
360,Bananaramic,"GRANDMASTER I
G",227,10.6,432,46,386,na
361,Genosins,"GRANDMASTER I
G",225,13.8,290,40,250,na
362,PrímeTime,"GRANDMASTER I
G",224,13.3,784,104,680,na
363,Ian952,"GRANDMASTER I
G",224,18.2,466,85,381,na
364,GreenbeingTFT,"GRANDMASTER I
G",224,14.1,595,84,511,na
365,Whae,"GRANDMASTER I
G",222,16.4,561,92,469,na
366,The Capsules,"GRANDMASTER I
G",222,16.2,500,81,419,na
367,Blueeeeeeeeeee2,"GRANDMASTER I
G",222,15.2,328,50,278,na
368,Zhaosongyanisson,"GRANDMASTER I
G",222,13.7,307,42,265,na
369,Atherton Wing,"GRANDMASTER I
G",220,15.7,402,63,339,na
370,PogiTheCorgi,"GRANDMASTER I
G",220,15.7,267,42,225,na
371,WeiXin Jerry79x,"GRANDMASTER I
G",219,21.3,183,39,144,na
372,Vitamnss,"GRANDMASTER I
G",218,13.8,289,40,249,na
373,AceKandil,"GRANDMASTER I
G",217,11.5,584,67,517,na
374,02l022,"GRANDMASTER I
G",217,15.9,384,61,323,na
375,FZY  love,"GRANDMASTER I
G",217,14.7,381,56,325,na
376,TTV TangibleTFT,"GRANDMASTER I
G",216,10.5,573,60,513,na
377,lovecyt,"GRANDMASTER I
G",216,14.2,381,54,327,na
378,nMercy Redcode,"GRANDMASTER I
G",216,15.8,317,50,267,na
379,TFT Cayrub,"GRANDMASTER I
G",215,14.4,1056,152,904,na
380,ShineBright,"GRANDMASTER I
G",215,15.8,556,88,468,na
381,Quweuwe,"GRANDMASTER I
G",215,17.7,344,61,283,na
382,Lex94wo,"GRANDMASTER I
G",214,16.1,577,93,484,na
383,QAQ TAT TvT,"GRANDMASTER I
G",214,17.7,231,41,190,na
384,2YoHae7,"GRANDMASTER I
G",214,12.4,201,25,176,na
385,ChiTown Riven,"GRANDMASTER I
G",213,18.4,158,29,129,na
386,vaziri,"GRANDMASTER I
G",212,13.4,793,106,687,na
387,Waifu,"GRANDMASTER I
G",211,28.1,146,41,105,na
388,eusouumlucas,"GRANDMASTER I
G",209,13.5,192,26,166,na
389,numanotaihasin,"GRANDMASTER I
G",209,13.5,148,20,128,na
390,Georgetown Siyu,"GRANDMASTER I
G",206,21.7,318,69,249,na
391,Marwin,"GRANDMASTER I
G",205,12.8,840,108,732,na
392,Timmy the Hog,"GRANDMASTER I
G",204,14.1,553,78,475,na
393,xiaqigaoshou,"GRANDMASTER I
G",202,20.8,173,36,137,na
394,Lenom,"GRANDMASTER I
G",201,16.5,522,86,436,na
395,C0C0NUT,"GRANDMASTER I
G",200,10.6,349,37,312,na
396,Master Soul,"GRANDMASTER I
G",199,20.0,544,109,435,na
397,xin luan le,"GRANDMASTER I
G",198,15.1,390,59,331,na
398,WowSilenceWow,"GRANDMASTER I
G",198,18.1,288,52,236,na
399,flyingup008,"GRANDMASTER I
G",198,17.8,287,51,236,na
400,beach body,"GRANDMASTER I
G",198,14.4,305,44,261,na
401,emilyywang,"GRANDMASTER I
G",196,13.2,1100,145,955,na
402,captain kookie,"GRANDMASTER I
G",196,11.0,661,73,588,na
403,nickrystaL,"GRANDMASTER I
G",196,16.4,165,27,138,na
404,Ym444,"GRANDMASTER I
G",194,18.3,229,42,187,na
405,Nefz7,"GRANDMASTER I
G",193,19.6,158,31,127,na
406,The Man From Far,"GRANDMASTER I
G",192,19.0,195,37,158,na
407,DeejGG,"GRANDMASTER I
G",188,12.0,357,43,314,na
408,VX13120537372,"GRANDMASTER I
G",187,14.2,352,50,302,na
409,zennonlwr,"GRANDMASTER I
G",187,14.0,299,42,257,na
410,Nyghty,"GRANDMASTER I
G",187,12.0,342,41,301,na
411,King TFT,"GRANDMASTER I
G",186,10.5,1138,120,1018,na
412,MoeMerkedYou,"GRANDMASTER I
G",185,14.1,709,100,609,na
413,lonelyfox803,"GRANDMASTER I
G",185,23.0,217,50,167,na
414,CrazyKoala,"GRANDMASTER I
G",185,16.5,242,40,202,na
415,Cici XD,"GRANDMASTER I
G",184,14.1,561,79,482,na
416,Takes,"GRANDMASTER I
G",183,13.3,188,25,163,na
417,Michael0107,"GRANDMASTER I
G",182,19.3,327,63,264,na
418,10th Page Xoxo,"GRANDMASTER I
G",180,13.9,618,86,532,na
419,MID NightShadw,"GRANDMASTER I
G",180,15.1,344,52,292,na
420,Kyouko Hori,"GRANDMASTER I
G",179,15.0,559,84,475,na
421,php and java,"GRANDMASTER I
G",179,19.7,309,61,248,na
422,DokoMoko,"GRANDMASTER I
G",179,10.5,171,18,153,na
423,Doril,"GRANDMASTER I
G",178,13.0,1318,171,1147,na
424,waiting77777,"GRANDMASTER I
G",178,13.1,466,61,405,na
425,Nerdong Bukid,"GRANDMASTER I
G",177,15.6,243,38,205,na
426,Memefite Tactics,"GRANDMASTER I
G",177,18.2,176,32,144,na
427,senorhyder,"GRANDMASTER I
G",176,14.2,751,107,644,na
428,twentyyi,"GRANDMASTER I
G",176,16.8,392,66,326,na
429,trísh,"GRANDMASTER I
G",175,12.9,774,100,674,na
430,NutscrackerosTw,"GRANDMASTER I
G",175,10.7,234,25,209,na
431,Vibrant,"GRANDMASTER I
G",174,15.2,574,87,487,na
432,Mortemo,"GRANDMASTER I
G",173,9.2,1017,94,923,na
433,IG TheWen,"GRANDMASTER I
G",172,22.9,109,25,84,na
434,Subism,"GRANDMASTER I
G",171,12.9,517,67,450,na
435,gunning4you,"GRANDMASTER I
G",170,16.5,437,72,365,na
436,Toast9197,"GRANDMASTER I
G",170,14.3,447,64,383,na
437,xStrangelove,"GRANDMASTER I
G",170,18.4,174,32,142,na
438,showmesomeflash,"GRANDMASTER I
G",170,17.1,170,29,141,na
439,Haí Keyi,"GRANDMASTER I
G",168,15.5,587,91,496,na
440,derajwal,"GRANDMASTER I
G",166,11.7,316,37,279,na
441,nujac,"GRANDMASTER I
G",166,16.9,201,34,167,na
442,all3nvan,"GRANDMASTER I
G",165,14.9,565,84,481,na
443,HostyIam,"GRANDMASTER I
G",165,17.4,270,47,223,na
444,7cjk,"GRANDMASTER I
G",165,12.4,209,26,183,na
445,Que paso,"GRANDMASTER I
G",164,13.5,363,49,314,na
446,BlakeAustin,"GRANDMASTER I
G",163,14.9,476,71,405,na
447,Holyfk,"GRANDMASTER I
G",162,19.7,300,59,241,na
448,RushWizard,"GRANDMASTER I
G",162,14.4,409,59,350,na
449,Jonghyuk Park,"GRANDMASTER I
G",162,35.0,80,28,52,na
450,Chikapu,"GRANDMASTER I
G",161,23.0,213,49,164,na
451,Amasuro,"GRANDMASTER I
G",161,15.8,158,25,133,na
452,BBLance,"GRANDMASTER I
G",160,19.0,331,63,268,na
453,Pandana,"GRANDMASTER I
G",159,15.9,340,54,286,na
454,PekiM,"GRANDMASTER I
G",159,20.1,134,27,107,na
455,Strangelove TFT,"GRANDMASTER I
G",159,16.2,160,26,134,na
456,tra8edy,"GRANDMASTER I
G",156,19.6,271,53,218,na
457,Geadtft,"GRANDMASTER I
G",156,20.2,257,52,205,na
458,philôlin,"GRANDMASTER I
G",155,13.6,391,53,338,na
459,mc2van,"GRANDMASTER I
G",155,24.2,124,30,94,na
460,Markersxx,"GRANDMASTER I
G",155,20.8,120,25,95,na
461,Smart Muggle,"GRANDMASTER I
G",153,17.4,769,134,635,na
462,jaby4,"GRANDMASTER I
G",152,15.4,663,102,561,na
463,SKT T1 Taco Bell,"GRANDMASTER I
G",152,35.4,99,35,64,na
464,DEFLECTABLE NA,"GRANDMASTER I
G",152,16.0,150,24,126,na
465,ToooCubed,"GRANDMASTER I
G",151,16.5,357,59,298,na
466,Tsun,"GRANDMASTER I
G",151,15.9,353,56,297,na
467,JellyReturns,"GRANDMASTER I
G",149,16.0,407,65,342,na
468,atownrocky,"GRANDMASTER I
G",149,16.7,293,49,244,na
469,Kyivix,"GRANDMASTER I
G",149,14.0,300,42,258,na
470,M2keP,"GRANDMASTER I
G",149,14.7,177,26,151,na
471,4boh,"GRANDMASTER I
G",148,26.4,318,84,234,na
472,aaronmb2,"GRANDMASTER I
G",148,18.3,415,76,339,na
473,Knight9z2,"GRANDMASTER I
G",148,15.8,418,66,352,na
474,lisakowww,"GRANDMASTER I
G",148,12.7,496,63,433,na
475,NA Opal,"GRANDMASTER I
G",148,13.1,351,46,305,na
476,Ducksquad,"GRANDMASTER I
G",148,15.5,238,37,201,na
477,guru9,"GRANDMASTER I
G",147,17.3,850,147,703,na
478,T TV bigdirty00,"GRANDMASTER I
G",146,13.7,702,96,606,na
479,pb1njam,"GRANDMASTER I
G",146,11.2,170,19,151,na
480,TingaTaco,"GRANDMASTER I
G",145,17.6,370,65,305,na
481,Phantom TFT,"GRANDMASTER I
G",143,12.5,777,97,680,na
482,JinxedJK,"GRANDMASTER I
G",143,16.2,463,75,388,na
483,Puppy Astronaut,"GRANDMASTER I
G",143,10.3,406,42,364,na
484,wjlee911,"GRANDMASTER I
G",143,24.1,116,28,88,na
485,DJ NOclue,"GRANDMASTER I
G",142,16.6,507,84,423,na
486,BestTimmmmm,"GRANDMASTER I
G",142,12.2,394,48,346,na
487,douyu296806,"GRANDMASTER I
G",141,20.7,203,42,161,na
488,swishersweets1,"GRANDMASTER I
G",140,10.2,770,79,691,na
489,Mapez,"GRANDMASTER I
G",140,15.5,200,31,169,na
490,Kurumix fangirl,"GRANDMASTER I
G",140,18.8,144,27,117,na
491,Botsvar,"GRANDMASTER I
G",140,31.6,76,24,52,na
492,TheArmoredTitant,"GRANDMASTER I
G",139,13.3,682,91,591,na
493,ÐrownedGod,"GRANDMASTER I
G",139,12.4,483,60,423,na
494,Sıx,"GRANDMASTER I
G",139,16.4,189,31,158,na
495,oSkyoo,"GRANDMASTER I
G",138,14.1,1003,141,862,na
496,Jeï,"GRANDMASTER I
G",138,15.3,366,56,310,na
497,Mattek,"GRANDMASTER I
G",138,14.2,332,47,285,na
498,Budget Agon,"GRANDMASTER I
G",138,12.0,150,18,132,na
499,GeneralPillage,"GRANDMASTER I
G",138,6.7,268,18,250,na
500,freedom sky,"GRANDMASTER I
G",137,16.8,244,41,203,na
1,bruninho sl,CHALLENGER I,1822,21.3,591,126,465,br
2,Zadust,CHALLENGER I,1606,33.3,339,113,226,br
3,cuckmyblade,CHALLENGER I,1546,23.9,485,116,369,br
4,inc mplete,CHALLENGER I,1401,17.3,761,132,629,br
5,eusouolucas,CHALLENGER I,1346,18.0,700,126,574,br
6,FabledDofus,CHALLENGER I,1317,19.8,479,95,384,br
7,techzz,CHALLENGER I,1312,23.7,579,137,442,br
8,Odyceuz,CHALLENGER I,1303,23.9,498,119,379,br
9,Slooper,CHALLENGER I,1242,24.6,366,90,276,br
10,Serask,CHALLENGER I,1195,21.8,541,118,423,br
11,Higuree,CHALLENGER I,1119,21.2,548,116,432,br
12,Paralelepipo,CHALLENGER I,1093,26.0,254,66,188,br
13,BarksdaIe,CHALLENGER I,1068,28.9,239,69,170,br
14,ftdrain,CHALLENGER I,1061,30.2,275,83,192,br
15,Medico do SUS22,CHALLENGER I,1053,18.5,584,108,476,br
16,Archway,CHALLENGER I,1047,17.1,439,75,364,br
17,Dairon,CHALLENGER I,981,21.4,322,69,253,br
18,tartaruguinhas2,CHALLENGER I,977,20.8,558,116,442,br
19,Koala Esbelto,CHALLENGER I,973,20.0,721,144,577,br
20,Gúne,CHALLENGER I,959,22.8,382,87,295,br
21,TG Wed,CHALLENGER I,905,16.9,721,122,599,br
22,Past,CHALLENGER I,889,25.1,470,118,352,br
23,m3rdapequena,CHALLENGER I,889,25.9,255,66,189,br
24,escolinha do inc,CHALLENGER I,812,21.5,418,90,328,br
25,Mierdagrande,CHALLENGER I,782,29.2,212,62,150,br
26,Twitch NickTFT,CHALLENGER I,777,21.4,537,115,422,br
27,Jael TFT,CHALLENGER I,761,20.8,404,84,320,br
28,OOO,CHALLENGER I,759,18.5,514,95,419,br
29,CD ERICK,CHALLENGER I,759,18.5,260,48,212,br
30,Royal Kvasterr,CHALLENGER I,732,14.2,435,62,373,br
31,Lünna,CHALLENGER I,723,20.1,814,164,650,br
32,ViT4O xD,CHALLENGER I,722,18.4,423,78,345,br
33,Miss Queen,CHALLENGER I,716,12.7,386,49,337,br
34,Haxwei,CHALLENGER I,710,18.8,213,40,173,br
35,Neves,CHALLENGER I,684,18.1,371,67,304,br
36,TFT Azura,CHALLENGER I,684,23.5,234,55,179,br
37,mDobZ,CHALLENGER I,677,18.3,251,46,205,br
38,RFK Azura,CHALLENGER I,676,26.1,468,122,346,br
39,Vowtz,CHALLENGER I,668,16.6,361,60,301,br
40,Levi,CHALLENGER I,663,23.1,428,99,329,br
41,Yvissaur,CHALLENGER I,654,22.0,305,67,238,br
42,Billy Bait,CHALLENGER I,651,16.3,699,114,585,br
43,Nescau Insolúvel,CHALLENGER I,647,19.8,339,67,272,br
44,odyceuZEDeletric,CHALLENGER I,624,43.5,85,37,48,br
45,O HIPER CARRY,CHALLENGER I,621,15.8,500,79,421,br
46,T F Toddy,CHALLENGER I,608,26.4,148,39,109,br
47,kirinde,CHALLENGER I,607,15.1,651,98,553,br
48,Bioosfera,CHALLENGER I,602,15.6,481,75,406,br
49,Lula Livrão TFT,CHALLENGER I,580,15.7,426,67,359,br
50,Kirbyzin,CHALLENGER I,564,16.1,639,103,536,br
51,DEZZlN,"GRANDMASTER I
G",638,16.7,491,82,409,br
52,the ego illusion,"GRANDMASTER I
G",628,27.4,219,60,159,br
53,AdrianoK,"GRANDMASTER I
G",612,17.9,340,61,279,br
54,CD CFCDuuuuds,"GRANDMASTER I
G",602,14.2,697,99,598,br
55,faker indiano,"GRANDMASTER I
G",601,14.9,470,70,400,br
56,B Lara,"GRANDMASTER I
G",585,21.9,315,69,246,br
57,TwitchTV Patr0ci,"GRANDMASTER I
G",548,15.4,748,115,633,br
58,O HIPER CRIME,"GRANDMASTER I
G",542,14.5,408,59,349,br
59,Encatroll é trix,"GRANDMASTER I
G",537,16.7,275,46,229,br
60,Tsuuzaki,"GRANDMASTER I
G",521,20.4,465,95,370,br
61,MATEUS DO SUS DF,"GRANDMASTER I
G",514,16.8,476,80,396,br
62,Ezo,"GRANDMASTER I
G",493,16.7,508,85,423,br
63,Nihonjin,"GRANDMASTER I
G",486,18.1,376,68,308,br
64,Felipolv000,"GRANDMASTER I
G",485,20.7,198,41,157,br
65,Jvão,"GRANDMASTER I
G",470,19.2,526,101,425,br
66,HawkEyeCs7,"GRANDMASTER I
G",461,16.9,679,115,564,br
67,ego illusions,"GRANDMASTER I
G",453,20.9,253,53,200,br
68,R Angra,"GRANDMASTER I
G",448,17.9,273,49,224,br
69,É o tal do Lula,"GRANDMASTER I
G",435,27.0,318,86,232,br
70,Mon Nom,"GRANDMASTER I
G",418,15.5,633,98,535,br
71,Allahu TK,"GRANDMASTER I
G",412,11.7,856,100,756,br
72,Bandu,"GRANDMASTER I
G",412,17.9,519,93,426,br
73,Batata Rufles,"GRANDMASTER I
G",400,18.4,272,50,222,br
74,tft igor18,"GRANDMASTER I
G",398,21.7,175,38,137,br
75,Irisdescent,"GRANDMASTER I
G",394,20.8,236,49,187,br
76,SÄNT hyun,"GRANDMASTER I
G",383,13.1,786,103,683,br
77,Ovas de Peixe,"GRANDMASTER I
G",376,15.0,580,87,493,br
78,jelly roll blues,"GRANDMASTER I
G",376,15.1,464,70,394,br
79,xCyborg,"GRANDMASTER I
G",373,19.5,328,64,264,br
80,Garras of Rivia,"GRANDMASTER I
G",372,21.8,216,47,169,br
81,SannTFT,"GRANDMASTER I
G",371,19.2,365,70,295,br
82,Eu só jogo TFT,"GRANDMASTER I
G",361,17.5,572,100,472,br
83,BlasHelldder,"GRANDMASTER I
G",361,19.3,383,74,309,br
84,Tallis Sauro,"GRANDMASTER I
G",361,18.2,346,63,283,br
85,haveaboavida,"GRANDMASTER I
G",354,25.6,164,42,122,br
86,Shinobu300,"GRANDMASTER I
G",353,19.0,358,68,290,br
87,TWITCHTV Stykr,"GRANDMASTER I
G",352,21.0,338,71,267,br
88,Goiano,"GRANDMASTER I
G",351,15.2,368,56,312,br
89,l Hyper Carry,"GRANDMASTER I
G",333,16.9,1024,173,851,br
90,Melança,"GRANDMASTER I
G",330,16.2,661,107,554,br
91,dG Fuhrmann,"GRANDMASTER I
G",330,25.6,262,67,195,br
92,Siilent,"GRANDMASTER I
G",329,14.4,660,95,565,br
93,TFT Médico,"GRANDMASTER I
G",322,21.5,163,35,128,br
94,itzzLara,"GRANDMASTER I
G",312,16.8,220,37,183,br
95,twitch narkesh1,"GRANDMASTER I
G",307,19.4,324,63,261,br
96,Royalzito,"GRANDMASTER I
G",305,17.6,450,79,371,br
97,MonteiroLombrado,"GRANDMASTER I
G",305,14.4,443,64,379,br
98,y Satsue,"GRANDMASTER I
G",304,13.8,138,19,119,br
99,MominhoGameplays,"GRANDMASTER I
G",303,17.8,398,71,327,br
100,Daníela,"GRANDMASTER I
G",299,17.6,222,39,183,br
101,Doutor Wily,"GRANDMASTER I
G",298,24.5,294,72,222,br
102,ttvSidekool,"GRANDMASTER I
G",295,13.7,531,73,458,br
103,Duest,"GRANDMASTER I
G",294,18.9,206,39,167,br
104,RafaStark,"GRANDMASTER I
G",292,18.1,281,51,230,br
105,Flangonator,"GRANDMASTER I
G",286,16.4,519,85,434,br
106,BARbahh,"GRANDMASTER I
G",285,15.2,323,49,274,br
107,SKT1 RyuZUU,"GRANDMASTER I
G",278,13.9,237,33,204,br
108,NeeverGiveUp,"GRANDMASTER I
G",276,14.0,477,67,410,br
109,Hisekken,"GRANDMASTER I
G",276,16.4,389,64,325,br
110,Beastar,"GRANDMASTER I
G",275,17.4,304,53,251,br
111,Sènna,"GRANDMASTER I
G",275,10.2,412,42,370,br
112,Paciente67,"GRANDMASTER I
G",274,24.6,126,31,95,br
113,LosAngelesLakers,"GRANDMASTER I
G",273,20.4,152,31,121,br
114,CD Noah Hunter,"GRANDMASTER I
G",271,15.4,351,54,297,br
115,Warrior Lulis,"GRANDMASTER I
G",264,20.8,221,46,175,br
116,Arckie,"GRANDMASTER I
G",263,19.7,361,71,290,br
117,Titos,"GRANDMASTER I
G",259,16.6,386,64,322,br
118,San Smurf,"GRANDMASTER I
G",253,17.8,281,50,231,br
119,Edinaldo Safadão,"GRANDMASTER I
G",252,14.7,292,43,249,br
120,divino Jax JG,"GRANDMASTER I
G",250,11.0,1038,114,924,br
121,SKEPET,"GRANDMASTER I
G",247,12.0,558,67,491,br
122,huggz,"GRANDMASTER I
G",243,17.9,896,160,736,br
123,Numb3r2,"GRANDMASTER I
G",239,17.9,362,65,297,br
124,DonCrazy,"GRANDMASTER I
G",238,12.3,813,100,713,br
125,HeathClyff,"GRANDMASTER I
G",237,19.0,247,47,200,br
126,MittCrowen,"GRANDMASTER I
G",237,17.8,230,41,189,br
127,JahBullOn,"GRANDMASTER I
G",234,12.3,341,42,299,br
128,Greafen,"GRANDMASTER I
G",232,17.7,570,101,469,br
129,maça docinha,"GRANDMASTER I
G",229,16.7,263,44,219,br
130,ZaionShow,"GRANDMASTER I
G",217,14.5,296,43,253,br
131,JhoyLow,"GRANDMASTER I
G",217,21.2,193,41,152,br
132,twí,"GRANDMASTER I
G",216,15.4,311,48,263,br
133,TAKOKUCHEIROSO,"GRANDMASTER I
G",216,17.0,235,40,195,br
134,Djcaveira TFT,"GRANDMASTER I
G",215,17.4,637,111,526,br
135,Zamora Lindão,"GRANDMASTER I
G",214,11.4,421,48,373,br
136,xXperrsonXx,"GRANDMASTER I
G",211,19.0,274,52,222,br
137,StrongAndFlowers,"GRANDMASTER I
G",209,14.4,292,42,250,br
138,CD Bruel,"GRANDMASTER I
G",208,13.8,419,58,361,br
139,maçãcomcanela,"GRANDMASTER I
G",207,13.3,467,62,405,br
140,anuib,"GRANDMASTER I
G",202,9.1,916,83,833,br
141,Ahri FIiperama,"GRANDMASTER I
G",198,16.1,566,91,475,br
142,l HaX l,"GRANDMASTER I
G",198,11.6,541,63,478,br
143,War Lambari,"GRANDMASTER I
G",197,16.8,364,61,303,br
144,RESIDENT DA ESCS,"GRANDMASTER I
G",195,13.9,791,110,681,br
145,Crackudo Pistola,"GRANDMASTER I
G",177,15.5,290,45,245,br
146,deiSHA COmigo rs,"GRANDMASTER I
G",171,11.6,735,85,650,br
147,Adboy,"GRANDMASTER I
G",166,19.5,262,51,211,br
148,CD Koiti,"GRANDMASTER I
G",164,17.0,259,44,215,br
149,RoronoaVinny,"GRANDMASTER I
G",159,18.7,715,134,581,br
150,RyüZU,"GRANDMASTER I
G",159,12.0,466,56,410,br
151,Vampyrus,MASTER I,234,17.3,872,151,721,br
152,GarrastaClean,MASTER I,233,19.8,248,49,199,br
153,Smurf divino Jax,MASTER I,232,19.9,226,45,181,br
154,Don Batatone,MASTER I,225,12.2,221,27,194,br
155,vcs sao pateta,MASTER I,222,12.7,640,81,559,br
156,Tuiu ZX,MASTER I,211,11.5,200,23,177,br
157,Kamimurathan,MASTER I,195,12.4,614,76,538,br
158,X Yudi,MASTER I,185,14.5,420,61,359,br
159,dedinho do lula,MASTER I,185,12.8,280,36,244,br
160,Walladi,MASTER I,172,15.7,191,30,161,br
161,Mino Th,MASTER I,170,19.7,152,30,122,br
162,FrostxD1,MASTER I,164,12.5,1033,129,904,br
163,gazzsinhoxD,MASTER I,164,16.6,247,41,206,br
164,Jokerrx,MASTER I,159,15.9,208,33,175,br
165,NgMartins,MASTER I,157,13.3,548,73,475,br
166,Deyrot,MASTER I,153,22.1,195,43,152,br
167,Terror16,MASTER I,147,13.9,724,101,623,br
168,Ruivão,MASTER I,147,21.5,219,47,172,br
169,Yuu Better,MASTER I,146,13.0,1381,180,1201,br
170,JUJU DO TFT,MASTER I,145,8.2,1063,87,976,br
171,JãoZao13,MASTER I,138,11.2,552,62,490,br
172,D A M N    777,MASTER I,137,12.0,815,98,717,br
173,XebeckX3,MASTER I,136,17.2,314,54,260,br
174,Noé Mechanics,MASTER I,136,12.0,366,44,322,br
175,haze is vibing,MASTER I,135,16.9,485,82,403,br
176,AdminDiego,MASTER I,134,13.9,725,101,624,br
177,Gorila Quevoa,MASTER I,133,15.5,827,128,699,br
178,brnztz,MASTER I,133,15.2,362,55,307,br
179,Guizi16,MASTER I,132,23.2,198,46,152,br
180,King Vinon,MASTER I,132,17.0,153,26,127,br
181,Tarky,MASTER I,131,22.0,558,123,435,br
182,xShanks,MASTER I,129,13.0,253,33,220,br
183,zMysto,MASTER I,126,12.2,188,23,165,br
184,Behold Imperius,MASTER I,125,28.5,144,41,103,br
185,Interplanetário,MASTER I,124,13.9,201,28,173,br
186,Feedei no Ferro4,MASTER I,120,13.3,520,69,451,br
187,Batooré,MASTER I,120,22.1,213,47,166,br
188,sakatoba,MASTER I,119,16.9,361,61,300,br
189,the little gab,MASTER I,118,18.5,189,35,154,br
190,xOnlyx,MASTER I,114,17.8,421,75,346,br
191,JoliasJolaias,MASTER I,114,13.5,193,26,167,br
192,pedinshow,MASTER I,113,14.6,342,50,292,br
193,Sonsa Esterco,MASTER I,113,15.8,133,21,112,br
194,07031997,MASTER I,110,15.5,373,58,315,br
195,LOVER 97,MASTER I,110,16.4,158,26,132,br
196,Kvrão,MASTER I,109,48.7,78,38,40,br
197,Shugas,MASTER I,107,14.7,395,58,337,br
198,HIGOR HIGOR TFT,MASTER I,106,18.9,344,65,279,br
199,guuih7,MASTER I,106,17.6,205,36,169,br
200,MarkLinv,MASTER I,104,19.5,220,43,177,br
201,Dani Dani TFT,MASTER I,103,16.6,308,51,257,br
202,AugustoKyouma,MASTER I,101,11.5,260,30,230,br
203,Djanz,MASTER I,98,16.8,304,51,253,br
204,TAKOKUFEDENO,MASTER I,96,30.2,96,29,67,br
205,ViroseMata,MASTER I,95,20.2,262,53,209,br
206,GlaucondE,MASTER I,94,12.6,167,21,146,br
207,Jarvan IV Jungle,MASTER I,93,13.1,505,66,439,br
208,MAMILOENDURECIDO,MASTER I,91,15.5,614,95,519,br
209,CapelaOMeior,MASTER I,91,15.5,515,80,435,br
210,dereguejhon,MASTER I,90,22.1,412,91,321,br
211,Dede1 TFT,MASTER I,90,19.4,253,49,204,br
212,bom coração,MASTER I,90,15.2,296,45,251,br
213,xewelzer,MASTER I,89,23.9,351,84,267,br
214,TFT ATEU FALIDO,MASTER I,89,9.7,673,65,608,br
215,Dézim TFT,MASTER I,89,18.3,164,30,134,br
216,Sukesvs,MASTER I,88,14.5,905,131,774,br
217,mitastico,MASTER I,86,15.7,312,49,263,br
218,Giovanni Toth,MASTER I,83,14.1,725,102,623,br
219,sir blackpwner,MASTER I,83,10.5,607,64,543,br
220,CygnusReborn,MASTER I,82,9.4,469,44,425,br
221,soares novo,MASTER I,82,24.1,108,26,82,br
222,O Tatá é Fota,MASTER I,81,14.1,482,68,414,br
223,LeMort,MASTER I,80,12.8,273,35,238,br
224,MAMI TIROTEIO,MASTER I,80,18.9,175,33,142,br
225,Rafinha TheExile,MASTER I,78,17.1,216,37,179,br
226,BixoCarpado,MASTER I,77,14.4,167,24,143,br
227,Marketeiro,MASTER I,76,17.4,293,51,242,br
228,BRTitan,MASTER I,76,16.0,250,40,210,br
229,Bronze,MASTER I,76,15.0,193,29,164,br
230,Padawan p1,MASTER I,76,7.5,386,29,357,br
231,Major Tactics,MASTER I,75,14.8,431,64,367,br
232,Kovah,MASTER I,75,13.5,193,26,167,br
233,NXL Phoenix,MASTER I,74,11.8,397,47,350,br
234,Eddie Jr,MASTER I,72,20.2,421,85,336,br
235,FunEngine,MASTER I,71,13.8,296,41,255,br
236,Rubimhood 2,MASTER I,68,18.9,153,29,124,br
237,nao bane heimer,MASTER I,66,8.3,372,31,341,br
238,A Bia me Come,MASTER I,65,13.7,388,53,335,br
239,Shiurphy,MASTER I,62,14.1,735,104,631,br
240,Kawori Miyazono,MASTER I,62,9.4,1092,103,989,br
241,PolariZed,MASTER I,62,30.8,65,20,45,br
242,TFT Ryok,MASTER I,61,21.8,133,29,104,br
243,Fã da Gal Gadot,MASTER I,60,14.0,456,64,392,br
244,merymy,MASTER I,60,9.3,591,55,536,br
245,Lipex,MASTER I,60,20.9,167,35,132,br
246,SpotNik,MASTER I,60,18.8,128,24,104,br
247,DeBitous,MASTER I,58,14.8,559,83,476,br
248,Gama Goblins,MASTER I,58,22.3,139,31,108,br
249,MinoThalysson,MASTER I,56,22.6,239,54,185,br
250,Park Ro Jin,MASTER I,54,13.8,282,39,243,br
251,SwordaNN,MASTER I,54,10.1,328,33,295,br
252,MNK Talrand,MASTER I,53,18.0,405,73,332,br
253,Nelpike,MASTER I,53,15.4,298,46,252,br
254,Pagnig0d,MASTER I,52,15.7,293,46,247,br
255,FireDiamond,MASTER I,51,17.6,159,28,131,br
256,killua do rj,MASTER I,50,12.0,677,81,596,br
257,Satyr1,MASTER I,50,13.1,511,67,444,br
258,Lil Darius Bro,MASTER I,50,22.4,107,24,83,br
259,Bad TFT playerr,MASTER I,49,20.4,113,23,90,br
260,ÖDlN,MASTER I,47,17.5,285,50,235,br
261,RV Thrash,MASTER I,47,17.2,122,21,101,br
262,Amon TFT,MASTER I,46,12.3,511,63,448,br
263,LeleoBlindãoTFT,MASTER I,46,18.9,281,53,228,br
264,chemistryMAN,MASTER I,45,15.2,237,36,201,br
265,Strixy,MASTER I,44,16.5,394,65,329,br
266,Guiziin,MASTER I,44,17.8,309,55,254,br
267,LEONERIX,MASTER I,44,12.8,359,46,313,br
268,RamonRF,MASTER I,42,15.9,605,96,509,br
269,IntoxiG,MASTER I,42,15.8,486,77,409,br
270,Buttenbender TFT,MASTER I,42,11.4,559,64,495,br
271,XebeckX1,MASTER I,42,15.5,238,37,201,br
272,Ieko,MASTER I,41,17.5,342,60,282,br
273,Heathcote,MASTER I,41,15.6,199,31,168,br
274,Gabymar10,MASTER I,39,14.9,361,54,307,br
275,Cornélio69,MASTER I,38,23.9,247,59,188,br
276,Wyzer,MASTER I,38,14.5,325,47,278,br
277,ALFA,MASTER I,38,16.3,172,28,144,br
278,Roubaram o meu,MASTER I,38,15.1,166,25,141,br
279,Draicker,MASTER I,38,16.6,145,24,121,br
280,Okabuloz,MASTER I,37,13.2,1269,168,1101,br
281,Zamora TFT,MASTER I,37,15.3,157,24,133,br
282,A CABEÇA,MASTER I,36,18.8,425,80,345,br
283,SaudosaMaloca,MASTER I,36,15.1,403,61,342,br
284,TFT Jorjão 1v7,MASTER I,36,19.6,158,31,127,br
285,Mitsuzord TFT,MASTER I,36,17.0,176,30,146,br
286,Ulth,MASTER I,35,18.4,565,104,461,br
287,zDaimon,MASTER I,35,17.9,246,44,202,br
288,Sina TFT,MASTER I,34,27.7,101,28,73,br
289,BrydenRivers,MASTER I,33,16.0,401,64,337,br
290,xOgunx,MASTER I,33,21.8,234,51,183,br
291,Mr Kappa,MASTER I,33,23.1,173,40,133,br
292,FLIPEZERA,MASTER I,33,18.8,208,39,169,br
293,ivelthin2,MASTER I,33,14.4,215,31,184,br
294,Vermiliom,MASTER I,33,10.9,247,27,220,br
295,Diegocosta28,MASTER I,32,14.4,348,50,298,br
296,uaahaha,MASTER I,32,15.3,314,48,266,br
297,Kaelllll,MASTER I,32,15.6,262,41,221,br
298,mateuslanhoso,MASTER I,32,20.4,142,29,113,br
299,SNEPIN DOG,MASTER I,31,16.0,692,111,581,br
300,Hadex666,MASTER I,31,19.3,486,94,392,br
301,Somos OM,MASTER I,31,14.2,478,68,410,br
302,Tiagod Rx,MASTER I,31,15.1,271,41,230,br
303,DobZ,MASTER I,31,31.0,116,36,80,br
304,I just play TFT,MASTER I,31,26.5,132,35,97,br
305,Infestissumam,MASTER I,30,15.4,584,90,494,br
306,BtG Wonderweiss,MASTER I,30,14.4,431,62,369,br
307,Darth Hergeir,MASTER I,30,12.9,472,61,411,br
308,Dérp,MASTER I,29,13.4,546,73,473,br
309,Yellow Umbrella,MASTER I,29,14.9,403,60,343,br
310,Boludo Aweonado,MASTER I,28,15.9,420,67,353,br
311,bora demoção,MASTER I,28,16.4,189,31,158,br
312,sup sem chat,MASTER I,28,27.5,109,30,79,br
313,Maestoso,MASTER I,27,17.8,439,78,361,br
314,Tony o Motoboy,MASTER I,27,13.2,355,47,308,br
315,Renato o Delgado,MASTER I,26,15.5,566,88,478,br
316,Citric,MASTER I,26,22.1,131,29,102,br
317,Bruno Raposo,MASTER I,26,11.3,185,21,164,br
318,HohenshaoBanshoo,MASTER I,25,20.0,140,28,112,br
319,Smurf do Vovo,MASTER I,24,20.6,155,32,123,br
320,lBulleTT,MASTER I,23,20.0,195,39,156,br
321,FoxYin,MASTER I,23,20.4,186,38,148,br
322,Stephen Hawkings,MASTER I,23,13.1,275,36,239,br
323,MiragePH,MASTER I,23,13.2,166,22,144,br
324,Firesilver,MASTER I,23,12.3,138,17,121,br
325,Mitsuzord,MASTER I,22,9.0,810,73,737,br
326,BieuL,MASTER I,22,18.2,275,50,225,br
327,Chera meu shacco,MASTER I,21,17.9,554,99,455,br
328,Vixabali,MASTER I,21,12.6,486,61,425,br
329,Carinha de Raiva,MASTER I,21,18.9,244,46,198,br
330,CADU xTFTx,MASTER I,21,11.2,402,45,357,br
331,xSoulsuke,MASTER I,21,13.7,219,30,189,br
332,Aillon,MASTER I,21,19.4,98,19,79,br
333,1 2 3 4 5 6 7,MASTER I,20,20.6,335,69,266,br
334,Balalaika Pura,MASTER I,20,20.8,279,58,221,br
335,BuGad0 TFT,MASTER I,20,10.6,321,34,287,br
336,xDCariocaxD,MASTER I,19,20.3,192,39,153,br
337,DoctorMadeira2,MASTER I,19,11.9,320,38,282,br
338,Volt TFT,MASTER I,19,15.5,239,37,202,br
339,BoyM Deatcrusher,MASTER I,19,17.3,139,24,115,br
340,BiscoitoS2,MASTER I,18,18.6,338,63,275,br
341,KidoSuno,MASTER I,18,13.1,360,47,313,br
342,i9Sedex,MASTER I,17,22.3,273,61,212,br
343,twt sirius,MASTER I,17,16.0,244,39,205,br
344,RoyallBurN,MASTER I,17,13.7,285,39,246,br
345,Inside Digitally,MASTER I,17,20.9,153,32,121,br
346,miIes halter,MASTER I,16,15.4,505,78,427,br
347,Lucas reformado,MASTER I,16,17.5,366,64,302,br
348,Mestre no TFT,MASTER I,16,17.5,291,51,240,br
349,É o Rauzitus né,MASTER I,16,22.5,142,32,110,br
350,Meu nome é isso,MASTER I,16,15.5,168,26,142,br
351,CHON5,MASTER I,15,22.8,298,68,230,br
352,bluish flame,MASTER I,15,13.5,355,48,307,br
353,Zesizeru,MASTER I,15,18.2,220,40,180,br
354,Rubimhood,MASTER I,15,11.5,304,35,269,br
355,Le ismym4in,MASTER I,15,13.1,198,26,172,br
356,PheonixS W,MASTER I,14,18.5,378,70,308,br
357,Cyber Legacy,MASTER I,14,18.4,282,52,230,br
358,TeMameiAjoelhado,MASTER I,14,26.1,184,48,136,br
359,Cavalo Gaúcho,MASTER I,14,11.8,372,44,328,br
360,znx,MASTER I,14,14.1,256,36,220,br
361,kratos2123,MASTER I,14,20.3,133,27,106,br
362,Criisto,MASTER I,13,14.4,438,63,375,br
363,Ana Beatriz,MASTER I,13,19.5,277,54,223,br
364,Vïni,MASTER I,13,10.3,300,31,269,br
365,JV O Pendante,MASTER I,13,14.5,200,29,171,br
366,Dogue,MASTER I,12,21.1,156,33,123,br
367,Wertech,MASTER I,12,20.6,155,32,123,br
368,Palácio,MASTER I,12,15.8,184,29,155,br
369,Inalvejavel,MASTER I,12,17.4,161,28,133,br
370,tachyonic,MASTER I,12,18.1,149,27,122,br
371,Gonzalez666,MASTER I,11,10.9,475,52,423,br
372,SweGGRED,MASTER I,11,19.9,231,46,185,br
373,WL Arthurzinho,MASTER I,11,17.4,218,38,180,br
374,MisakaS2,MASTER I,11,18.3,175,32,143,br
375,TFT JV,MASTER I,10,16.0,407,65,342,br
376,Ratochinski,MASTER I,10,14.7,265,39,226,br
377,O Tal do Cabeça,MASTER I,10,12.7,299,38,261,br
378,MC Ainzinho,MASTER I,10,13.6,273,37,236,br
379,Cheleia,MASTER I,10,13.1,251,33,218,br
380,NARNIANOjr,MASTER I,10,11.9,251,30,221,br
381,Lucin do TFT,MASTER I,9,15.4,492,76,416,br
382,Riconss,MASTER I,9,21.7,272,59,213,br
383,Maiyinha,MASTER I,9,20.6,282,58,224,br
384,Kidzinho,MASTER I,9,14.3,384,55,329,br
385,Urso Árabe,MASTER I,9,21.5,246,53,193,br
386,I John l,MASTER I,9,14.7,319,47,272,br
387,Joe Fury,MASTER I,9,17.0,253,43,210,br
388,MC Ana Raio,MASTER I,9,23.7,173,41,132,br
389,Tequilera,MASTER I,9,15.6,224,35,189,br
390,vo pro dofus,MASTER I,9,27.6,87,24,63,br
391,telessena,MASTER I,8,22.4,313,70,243,br
392,FawZer,MASTER I,8,17.7,373,66,307,br
393,Bruno FP de Melo,MASTER I,8,15.0,314,47,267,br
394,Weiro,MASTER I,8,19.0,147,28,119,br
395,Devil1,MASTER I,7,24.2,252,61,191,br
396,Eduu,MASTER I,7,16.7,342,57,285,br
397,Lombrah,MASTER I,7,15.4,221,34,187,br
398,Kh1laf,MASTER I,6,17.2,436,75,361,br
399,Vladinhomir,MASTER I,6,19.3,290,56,234,br
400,Sydney Cole,MASTER I,6,19.0,268,51,217,br
401,mikocon,MASTER I,6,25.8,151,39,112,br
402,Until i Die,MASTER I,5,10.9,705,77,628,br
403,Marlboro IceMint,MASTER I,5,21.1,355,75,280,br
404,Totto,MASTER I,5,15.1,496,75,421,br
405,MBokos,MASTER I,5,18.6,392,73,319,br
406,l Floky l,MASTER I,5,25.0,236,59,177,br
407,iEnergy,MASTER I,5,14.9,355,53,302,br
408,Atr0th,MASTER I,5,16.7,275,46,229,br
409,Valor is my main,MASTER I,5,23.9,180,43,137,br
410,Viking Vaporuub,MASTER I,5,18.8,224,42,182,br
411,IG Balzana,MASTER I,5,18.6,177,33,144,br
412,SpaCeZark,MASTER I,5,17.5,183,32,151,br
413,Krayvhus Luvith,MASTER I,5,11.1,287,32,255,br
414,Chimarraio,MASTER I,5,14.8,210,31,179,br
415,Pessoinha101,MASTER I,5,19.5,154,30,124,br
416,alvesjp,MASTER I,5,16.2,148,24,124,br
417,Amo um Palhaço,MASTER I,4,18.9,334,63,271,br
418,Big beijo pra vc,MASTER I,4,14.8,297,44,253,br
419,Death Aragorn,MASTER I,4,26.2,164,43,121,br
420,Golden Wings,MASTER I,4,15.8,272,43,229,br
421,ReiCasca,MASTER I,3,13.0,516,67,449,br
422,SpeIIman,MASTER I,3,22.6,274,62,212,br
423,xDuracelx,MASTER I,3,17.3,323,56,267,br
424,Excelsior XD,MASTER I,3,22.3,224,50,174,br
425,Mãe da Karma,MASTER I,3,18.7,235,44,191,br
426,Mathsilver,MASTER I,3,15.1,271,41,230,br
427,Äyrton Senna,MASTER I,3,17.7,203,36,167,br
428,Goiano3Estrelas,MASTER I,3,16.0,219,35,184,br
429,germanTFT,MASTER I,3,22.2,135,30,105,br
430,Little Yumie,MASTER I,2,8.3,879,73,806,br
431,Gahilan,MASTER I,2,14.8,487,72,415,br
432,Guiczar,MASTER I,2,11.9,588,70,518,br
433,Feeddersticks,MASTER I,2,24.4,279,68,211,br
434,Lermi,MASTER I,2,13.9,446,62,384,br
435,xLosTxSouLx,MASTER I,2,16.4,304,50,254,br
436,Ryok,MASTER I,2,15.7,216,34,182,br
437,Fabulas,MASTER I,2,8.9,313,28,285,br
438,BestOne,MASTER I,2,14.4,118,17,101,br
439,KaiSadaw,MASTER I,1,15.1,491,74,417,br
440,DETETIVE ALINE,MASTER I,1,18.7,363,68,295,br
441,RehDuarte,MASTER I,1,13.8,369,51,318,br
442,iCorry,MASTER I,1,22.4,201,45,156,br
443,Beach Goth,MASTER I,1,10.4,404,42,362,br
444,TA IN SHOCK KK,MASTER I,1,9.8,356,35,321,br
445,Niicoso,MASTER I,1,12.7,205,26,179,br
446,cythtei,MASTER I,1,22.3,112,25,87,br
447,LyrikGG,MASTER I,0,15.8,660,104,556,br
448,TFT Win,MASTER I,0,14.6,630,92,538,br
449,Oliver FAR,MASTER I,0,11.5,793,91,702,br
450,FBC é Muito Zika,MASTER I,0,16.7,474,79,395,br
451,ALEK SULISTA,MASTER I,0,13.6,579,79,500,br
452,OusadoRJ,MASTER I,0,12.4,637,79,558,br
453,SilverSoldier,MASTER I,0,22.0,354,78,276,br
454,is cool shooter,MASTER I,0,18.4,412,76,336,br
455,C Marighella,MASTER I,0,19.0,389,74,315,br
456,ItaIIo Lima,MASTER I,0,14.2,500,71,429,br
457,ArenaBulldog TFT,MASTER I,0,15.4,441,68,373,br
458,its doomed,MASTER I,0,20.4,329,67,262,br
459,TFT Japalterado,MASTER I,0,17.1,368,63,305,br
460,2v2,MASTER I,0,10.9,570,62,508,br
461,FLA Visconde,MASTER I,0,18.6,328,61,267,br
462,nyaw,MASTER I,0,16.1,367,59,308,br
463,Neguh Jamaica,MASTER I,0,14.6,398,58,340,br
464,Aphroddi,MASTER I,0,17.2,285,49,236,br
465,WUK EPICURISTA,MASTER I,0,12.7,378,48,330,br
466,felipeeanjos,MASTER I,0,15.9,296,47,249,br
467,Iorek TFT,MASTER I,0,16.4,275,45,230,br
468,Cadê a namorada,MASTER I,0,11.3,390,44,346,br
469,GadaoDeDeus,MASTER I,0,15.5,278,43,235,br
470,O Mini Boi,MASTER I,0,10.7,394,42,352,br
471,Yninjabrasil,MASTER I,0,27.8,144,40,104,br
472,O Bessa,MASTER I,0,21.7,184,40,144,br
473,Grakehall,MASTER I,0,12.1,321,39,282,br
474,Daemonfeuer,MASTER I,0,16.0,237,38,199,br
475,Pabloht,MASTER I,0,12.5,295,37,258,br
476,Adellos,MASTER I,0,11.6,319,37,282,br
477,Bettina,MASTER I,0,26.5,136,36,100,br
478,Wolker05,MASTER I,0,20.0,180,36,144,br
479,BADBatavo TFT,MASTER I,0,21.1,166,35,131,br
480,Caesar Clown,MASTER I,0,17.7,198,35,163,br
481,DSM CallMeGod,MASTER I,0,14.5,241,35,206,br
482,Tryndamere King,MASTER I,0,18.1,188,34,154,br
483,AtomicFinger26,MASTER I,0,16.2,210,34,176,br
484,Rendras,MASTER I,0,18.0,183,33,150,br
485,Policial boa,MASTER I,0,18.9,169,32,137,br
486,PouWalki,MASTER I,0,17.6,182,32,150,br
487,bshow,MASTER I,0,13.7,234,32,202,br
488,H1p3rioN,MASTER I,0,24.2,128,31,97,br
489,Hater De Kpoper,MASTER I,0,14.4,215,31,184,br
490,YOJak SL,MASTER I,0,12.1,239,29,210,br
491,polar,MASTER I,0,24.0,104,25,79,br
492,Rickon Kent,MASTER I,0,22.9,109,25,84,br
493,7sCeyEkwaH,MASTER I,0,15.0,160,24,136,br
494,Twitch Yudii,MASTER I,0,16.7,138,23,115,br
495,ANDREA 10 FILHOS,MASTER I,0,11.6,190,22,168,br
496,S1lm4r,DIAMOND I,99,19.9,236,47,189,br
497,PedrodoPovo,DIAMOND I,97,17.2,174,30,144,br
498,xLosTxSouLx TFT,DIAMOND I,96,17.5,126,22,104,br
499,nolliA,DIAMOND I,95,29.0,69,20,49,br
500,sorcer,DIAMOND I,93,16.4,244,40,204,br
1,DaSaEbaVMo6niq,CHALLENGER I,1811,25.6,441,113,328,eune
2,TFT Hadaf,CHALLENGER I,1529,26.5,442,117,325,eune
3,Hi Im Hadaf,CHALLENGER I,1160,21.8,280,61,219,eune
4,Deepityy,CHALLENGER I,1159,27.1,277,75,202,eune
5,Chinese Superbot,CHALLENGER I,1105,24.9,708,176,532,eune
6,Deepityyy,CHALLENGER I,1099,29.6,280,83,197,eune
7,nuenueyouyuegou,CHALLENGER I,1009,31.0,229,71,158,eune
8,yingyi,CHALLENGER I,992,25.7,183,47,136,eune
9,qqqwwweeerrrttt,CHALLENGER I,942,27.5,309,85,224,eune
10,ShayonZ,CHALLENGER I,923,24.1,398,96,302,eune
11,Spatula Rasa,CHALLENGER I,904,12.6,1013,128,885,eune
12,Barbalofono,CHALLENGER I,818,13.9,533,74,459,eune
13,Quevash,CHALLENGER I,805,21.7,235,51,184,eune
14,kocham michasia,CHALLENGER I,789,33.0,215,71,144,eune
15,Ambitious Noob,CHALLENGER I,779,21.7,355,77,278,eune
16,Kumihowo,CHALLENGER I,753,27.3,183,50,133,eune
17,Abo Sreee3,CHALLENGER I,749,25.2,305,77,228,eune
18,Kier0n,CHALLENGER I,746,24.1,245,59,186,eune
19,Sting Youclif,CHALLENGER I,730,19.9,211,42,169,eune
20,End of The Line,CHALLENGER I,728,15.5,1085,168,917,eune
21,BBit,CHALLENGER I,688,25.8,159,41,118,eune
22,Fadder,CHALLENGER I,676,18.2,484,88,396,eune
23,Maro0N,CHALLENGER I,650,25.8,155,40,115,eune
24,WP Szati,CHALLENGER I,640,20.2,316,64,252,eune
25,longlive,CHALLENGER I,635,13.6,339,46,293,eune
26,Tokuchi Toua,CHALLENGER I,616,18.5,249,46,203,eune
27,Strikerko,CHALLENGER I,614,19.6,618,121,497,eune
28,Cebo v9,CHALLENGER I,610,23.0,178,41,137,eune
29,acoj,CHALLENGER I,595,16.7,246,41,205,eune
30,Daniels sagor,CHALLENGER I,586,19.4,222,43,179,eune
31,Electrolyze,CHALLENGER I,584,21.4,243,52,191,eune
32,Bardton Senna,CHALLENGER I,574,17.3,329,57,272,eune
33,shonun,CHALLENGER I,574,26.5,132,35,97,eune
34,Endø,CHALLENGER I,564,17.1,298,51,247,eune
35,SnailDaddy,CHALLENGER I,556,15.5,592,92,500,eune
36,Sesard,CHALLENGER I,554,16.7,293,49,244,eune
37,pjsaig,CHALLENGER I,540,30.6,124,38,86,eune
38,Freak Simba,CHALLENGER I,535,13.0,415,54,361,eune
39,Άνεργος,CHALLENGER I,535,14.5,366,53,313,eune
40,Tw1stedFate1,CHALLENGER I,532,28.6,154,44,110,eune
41,Im Sneaky,CHALLENGER I,524,16.7,592,99,493,eune
42,DIV Fortanu,CHALLENGER I,523,18.0,339,61,278,eune
43,SB CCisMyCounter,CHALLENGER I,509,18.3,301,55,246,eune
44,No Ragrets,CHALLENGER I,505,20.0,300,60,240,eune
45,SaintBlacky,CHALLENGER I,501,13.1,624,82,542,eune
46,MosPeΙeush,CHALLENGER I,498,17.1,210,36,174,eune
47,Boudist,CHALLENGER I,495,16.8,285,48,237,eune
48,4NDI,CHALLENGER I,494,20.0,689,138,551,eune
49,tokkila,CHALLENGER I,460,18.3,334,61,273,eune
50,BillKong,CHALLENGER I,435,20.3,271,55,216,eune
51,rngshinyruo,"GRANDMASTER I
G",538,25.3,174,44,130,eune
52,Swimmable Toast,"GRANDMASTER I
G",494,27.1,133,36,97,eune
53,TryndabeardFTW,"GRANDMASTER I
G",491,20.9,187,39,148,eune
54,Redundancia,"GRANDMASTER I
G",489,25.5,298,76,222,eune
55,ARNOLD,"GRANDMASTER I
G",487,15.8,748,118,630,eune
56,Brynool,"GRANDMASTER I
G",484,22.0,236,52,184,eune
57,Cuudi,"GRANDMASTER I
G",482,17.3,398,69,329,eune
58,jakecn,"GRANDMASTER I
G",482,19.4,196,38,158,eune
59,VERONICA RUN RUN,"GRANDMASTER I
G",466,26.1,234,61,173,eune
60,Brixilolzsk,"GRANDMASTER I
G",449,16.9,445,75,370,eune
61,RaVen v1,"GRANDMASTER I
G",446,21.6,217,47,170,eune
62,Epitheoritiς,"GRANDMASTER I
G",440,15.7,305,48,257,eune
63,malac1,"GRANDMASTER I
G",434,14.5,338,49,289,eune
64,masterboi,"GRANDMASTER I
G",419,12.4,453,56,397,eune
65,lBigossl,"GRANDMASTER I
G",412,11.8,355,42,313,eune
66,deqiang,"GRANDMASTER I
G",392,19.8,257,51,206,eune
67,JointBongo,"GRANDMASTER I
G",392,26.1,134,35,99,eune
68,abe the savior,"GRANDMASTER I
G",386,15.9,629,100,529,eune
69,LuQ876,"GRANDMASTER I
G",384,14.3,734,105,629,eune
70,RNGuziuziuzi,"GRANDMASTER I
G",373,30.1,126,38,88,eune
71,ŹZ ZZ ZZ ZZ ZZ,"GRANDMASTER I
G",370,15.2,963,146,817,eune
72,Slanof,"GRANDMASTER I
G",369,15.4,389,60,329,eune
73,Wykonc,"GRANDMASTER I
G",365,18.0,233,42,191,eune
74,Fine11,"GRANDMASTER I
G",361,15.2,506,77,429,eune
75,tftsoftexe,"GRANDMASTER I
G",357,19.2,318,61,257,eune
76,victor victoris,"GRANDMASTER I
G",356,13.3,502,67,435,eune
77,forever52,"GRANDMASTER I
G",356,23.9,167,40,127,eune
78,tousinimab,"GRANDMASTER I
G",352,18.1,299,54,245,eune
79,hemourenya,"GRANDMASTER I
G",349,20.0,250,50,200,eune
80,LyAmAm,"GRANDMASTER I
G",345,23.8,143,34,109,eune
81,SeekN7eak,"GRANDMASTER I
G",339,18.0,1161,209,952,eune
82,Chieftan Nessus,"GRANDMASTER I
G",330,15.2,191,29,162,eune
83,dendek,"GRANDMASTER I
G",325,20.8,317,66,251,eune
84,Id sex me,"GRANDMASTER I
G",325,36.8,117,43,74,eune
85,yuquan,"GRANDMASTER I
G",320,22.6,349,79,270,eune
86,mozhili,"GRANDMASTER I
G",315,17.6,410,72,338,eune
87,OFC Cute,"GRANDMASTER I
G",314,14.5,448,65,383,eune
88,xiaozhuhuijie,"GRANDMASTER I
G",313,19.8,187,37,150,eune
89,Riku Na,"GRANDMASTER I
G",299,30.8,117,36,81,eune
90,MLxDDD,"GRANDMASTER I
G",298,18.5,373,69,304,eune
91,yyyyyye,"GRANDMASTER I
G",296,20.0,395,79,316,eune
92,Nickon,"GRANDMASTER I
G",296,16.8,381,64,317,eune
93,qiqi277,"GRANDMASTER I
G",296,28.0,118,33,85,eune
94,Pana2525,"GRANDMASTER I
G",291,21.1,261,55,206,eune
95,huyabinzi,"GRANDMASTER I
G",283,19.1,214,41,173,eune
96,MaKharg JG,"GRANDMASTER I
G",275,17.6,426,75,351,eune
97,Laamakuiskaaja,"GRANDMASTER I
G",271,11.7,632,74,558,eune
98,MARStoiAN,"GRANDMASTER I
G",271,11.1,559,62,497,eune
99,tinmar,"GRANDMASTER I
G",270,16.9,320,54,266,eune
100,maurhapilhGR,"GRANDMASTER I
G",269,17.1,239,41,198,eune
101,FENG13144,"GRANDMASTER I
G",267,25.3,249,63,186,eune
102,Baschtian,"GRANDMASTER I
G",262,26.5,151,40,111,eune
103,Ih8java,"GRANDMASTER I
G",260,18.5,552,102,450,eune
104,Cant Touch Dis,"GRANDMASTER I
G",259,17.1,591,101,490,eune
105,wangweichuizi,"GRANDMASTER I
G",257,15.4,214,33,181,eune
106,For chr1st sake,"GRANDMASTER I
G",254,11.1,720,80,640,eune
107,SKT Mexes,"GRANDMASTER I
G",252,15.3,229,35,194,eune
108,shalockkrie,"GRANDMASTER I
G",243,19.5,174,34,140,eune
109,K3NNY1337,"GRANDMASTER I
G",241,14.1,347,49,298,eune
110,Darosch,"GRANDMASTER I
G",241,13.4,276,37,239,eune
111,wenfan,"GRANDMASTER I
G",241,21.5,149,32,117,eune
112,CHINCZYQ,"GRANDMASTER I
G",240,16.2,136,22,114,eune
113,0rchide,"GRANDMASTER I
G",236,14.1,441,62,379,eune
114,Cerebel22,"GRANDMASTER I
G",235,14.3,238,34,204,eune
115,ETSIDETHABENEIS,"GRANDMASTER I
G",234,16.6,337,56,281,eune
116,sfedis,"GRANDMASTER I
G",232,15.1,365,55,310,eune
117,duange666,"GRANDMASTER I
G",232,24.3,136,33,103,eune
118,Ćelestial,"GRANDMASTER I
G",228,15.4,410,63,347,eune
119,DotaTerrorblade,"GRANDMASTER I
G",226,17.3,428,74,354,eune
120,Cebanthon,"GRANDMASTER I
G",226,26.0,177,46,131,eune
121,kuaileFN666,"GRANDMASTER I
G",224,29.6,189,56,133,eune
122,DcStarz,"GRANDMASTER I
G",224,19.4,252,49,203,eune
123,drma330,"GRANDMASTER I
G",224,16.1,291,47,244,eune
124,Ο Β Ε Υ,"GRANDMASTER I
G",222,17.0,305,52,253,eune
125,Tiro X Eqt,"GRANDMASTER I
G",221,13.8,267,37,230,eune
126,gyybtomorrow,"GRANDMASTER I
G",220,18.2,198,36,162,eune
127,Lucifer Junior,"GRANDMASTER I
G",219,18.5,400,74,326,eune
128,shenchao1,"GRANDMASTER I
G",219,21.8,225,49,176,eune
129,NBDandan,"GRANDMASTER I
G",218,17.1,170,29,141,eune
130,Lil Vayne J7,"GRANDMASTER I
G",217,19.0,716,136,580,eune
131,fangshen,"GRANDMASTER I
G",217,17.9,218,39,179,eune
132,Chinese0008,"GRANDMASTER I
G",216,25.4,110,28,82,eune
133,onik1997,"GRANDMASTER I
G",215,40.8,98,40,58,eune
134,klausrofl twitch,"GRANDMASTER I
G",214,13.6,352,48,304,eune
135,božský tureto,"GRANDMASTER I
G",212,13.5,244,33,211,eune
136,TFT Poulaki,"GRANDMASTER I
G",208,14.6,707,103,604,eune
137,laonazaici,"GRANDMASTER I
G",207,14.9,222,33,189,eune
138,BarneyStinsonGG,"GRANDMASTER I
G",203,16.8,493,83,410,eune
139,islam alghoul,"GRANDMASTER I
G",203,15.3,267,41,226,eune
140,Challenger Heart,"GRANDMASTER I
G",202,19.8,177,35,142,eune
141,kEEN v7,"GRANDMASTER I
G",197,22.3,121,27,94,eune
142,KombaTeH,"GRANDMASTER I
G",196,20.2,347,70,277,eune
143,Žiks,"GRANDMASTER I
G",196,20.1,209,42,167,eune
144,liminghui,"GRANDMASTER I
G",190,18.5,259,48,211,eune
145,KREATOPITA,"GRANDMASTER I
G",184,16.0,225,36,189,eune
146,tiesIgnas,"GRANDMASTER I
G",170,12.1,519,63,456,eune
147,Mvp UnFeeLer,"GRANDMASTER I
G",131,20.8,264,55,209,eune
148,theshy1994,"GRANDMASTER I
G",129,20.7,135,28,107,eune
149,llllllssh,"GRANDMASTER I
G",107,23.1,268,62,206,eune
150,MiNo21,"GRANDMASTER I
G",99,17.2,279,48,231,eune
151,aosjsjz,MASTER I,280,22.7,163,37,126,eune
152,earlyheart,MASTER I,267,24.8,133,33,100,eune
153,qwbctyz,MASTER I,258,30.7,127,39,88,eune
154,Nevilter,MASTER I,248,14.3,301,43,258,eune
155,Cynamon TFT,MASTER I,243,13.9,647,90,557,eune
156,aal233,MASTER I,232,15.7,382,60,322,eune
157,DarkSynapse,MASTER I,229,11.6,998,116,882,eune
158,Donger Bonger,MASTER I,223,31.0,113,35,78,eune
159,TheLazyBastard,MASTER I,214,22.8,158,36,122,eune
160,qaqqqqq,MASTER I,214,17.7,192,34,158,eune
161,ZBlang,MASTER I,214,29.8,94,28,66,eune
162,o kalos NOE,MASTER I,208,19.7,299,59,240,eune
163,Kőrean Jungler,MASTER I,200,16.4,775,127,648,eune
164,harimania,MASTER I,200,24.7,150,37,113,eune
165,jiaozhiaini,MASTER I,199,17.4,236,41,195,eune
166,PantherBlood,MASTER I,198,15.2,532,81,451,eune
167,sdR,MASTER I,196,18.6,440,82,358,eune
168,jijn3rj4j,MASTER I,193,23.5,136,32,104,eune
169,Ykxnbo,MASTER I,191,19.1,215,41,174,eune
170,SS Srpska Mafija,MASTER I,189,6.5,888,58,830,eune
171,lordpepigz,MASTER I,186,15.3,307,47,260,eune
172,tego typu,MASTER I,185,21.6,148,32,116,eune
173,Biaaaaaaaatch,MASTER I,184,13.8,376,52,324,eune
174,Mesh Shayfak,MASTER I,182,15.2,672,102,570,eune
175,rekklescranetail,MASTER I,182,29.8,131,39,92,eune
176,Unlucky Team,MASTER I,178,16.1,186,30,156,eune
177,qiong1v7,MASTER I,172,23.9,188,45,143,eune
178,Hajzen ˉ,MASTER I,169,28.4,102,29,73,eune
179,nayemnau,MASTER I,168,19.2,297,57,240,eune
180,tiaotiao111,MASTER I,168,15.3,216,33,183,eune
181,Hari,MASTER I,167,16.9,136,23,113,eune
182,ssssyu,MASTER I,165,19.0,252,48,204,eune
183,vvloveyping,MASTER I,164,25.6,117,30,87,eune
184,ziyoumowang,MASTER I,163,28.4,141,40,101,eune
185,lowroll,MASTER I,161,12.9,466,60,406,eune
186,jg díff,MASTER I,157,20.2,257,52,205,eune
187,Razyo,MASTER I,157,16.5,273,45,228,eune
188,LTUGAMER,MASTER I,154,15.9,226,36,190,eune
189,l StreamR l,MASTER I,150,17.4,477,83,394,eune
190,huawuyan,MASTER I,150,16.0,169,27,142,eune
191,plotak,MASTER I,147,20.5,185,38,147,eune
192,1Hadez2,MASTER I,147,16.1,205,33,172,eune
193,sixoutofsix,MASTER I,147,15.7,198,31,167,eune
194,baobaowo,MASTER I,144,12.8,235,30,205,eune
195,Lethal Presencee,MASTER I,143,15.3,418,64,354,eune
196,Smith 40i4,MASTER I,142,15.5,387,60,327,eune
197,kecsketej5,MASTER I,139,19.3,393,76,317,eune
198,OSG Legend,MASTER I,139,16.7,222,37,185,eune
199,IceButcher,MASTER I,139,13.8,254,35,219,eune
200,CoLdQQ,MASTER I,139,15.8,152,24,128,eune
201,Th3 Mask,MASTER I,138,18.5,520,96,424,eune
202,The Balla,MASTER I,138,13.1,404,53,351,eune
203,Tizy,MASTER I,138,19.8,258,51,207,eune
204,Voltisz,MASTER I,136,14.3,440,63,377,eune
205,faker1209,MASTER I,135,18.7,423,79,344,eune
206,Mattinyehedarhed,MASTER I,132,24.0,154,37,117,eune
207,Life Priority,MASTER I,132,17.1,204,35,169,eune
208,dapianke,MASTER I,132,18.1,149,27,122,eune
209,Szymán,MASTER I,130,15.2,230,35,195,eune
210,Apa,MASTER I,129,14.2,176,25,151,eune
211,asd110,MASTER I,127,15.9,591,94,497,eune
212,Eldhrimr,MASTER I,127,17.3,214,37,177,eune
213,icehit,MASTER I,126,13.5,977,132,845,eune
214,wiiiii,MASTER I,126,12.0,259,31,228,eune
215,Saimonald,MASTER I,125,16.8,274,46,228,eune
216,ALEXPOTTERZ,MASTER I,125,15.4,195,30,165,eune
217,vghjkijnm,MASTER I,125,30.6,85,26,59,eune
218,Krecik x13,MASTER I,122,17.9,145,26,119,eune
219,WojtoszGG,MASTER I,120,17.1,491,84,407,eune
220,In Too Deep,MASTER I,118,14.5,736,107,629,eune
221,shou7810,MASTER I,118,17.1,152,26,126,eune
222,Ginoooooo,MASTER I,117,16.7,204,34,170,eune
223,MiNo22,MASTER I,116,14.8,243,36,207,eune
224,Ex Samurai,MASTER I,114,20.0,370,74,296,eune
225,SKT UZI T1,MASTER I,114,14.9,390,58,332,eune
226,felicia999,MASTER I,114,20.7,174,36,138,eune
227,Alfa Bard,MASTER I,114,23.9,142,34,108,eune
228,citrusZZ,MASTER I,112,16.7,276,46,230,eune
229,Sbgogogo,MASTER I,112,22.4,165,37,128,eune
230,youzaifanfu,MASTER I,110,19.1,409,78,331,eune
231,D1e With Me,MASTER I,110,14.3,441,63,378,eune
232,Caramyx,MASTER I,110,13.6,419,57,362,eune
233,Bluntzkri3g420,MASTER I,108,15.6,397,62,335,eune
234,laige1314,MASTER I,106,22.9,170,39,131,eune
235,Jiangyw888,MASTER I,105,14.1,377,53,324,eune
236,Paljo,MASTER I,105,17.8,163,29,134,eune
237,Foreverstar2,MASTER I,104,23.0,239,55,184,eune
238,Erik0 MDMA,MASTER I,103,18.6,430,80,350,eune
239,Stavv,MASTER I,103,18.5,216,40,176,eune
240,Neebo,MASTER I,101,17.9,218,39,179,eune
241,FuriatZ,MASTER I,100,19.6,240,47,193,eune
242,china55open,MASTER I,100,31.8,107,34,73,eune
243,ShadoωMoon,MASTER I,99,15.3,412,63,349,eune
244,BT Treide1,MASTER I,98,16.7,281,47,234,eune
245,Czo Tén Master,MASTER I,98,14.3,195,28,167,eune
246,YanYanzzZ,MASTER I,97,22.6,181,41,140,eune
247,dlskssss,MASTER I,96,30.3,99,30,69,eune
248,Petrusxa030,MASTER I,93,16.5,303,50,253,eune
249,the blackcok,MASTER I,93,21.1,227,48,179,eune
250,IchibanEnjo,MASTER I,91,15.5,174,27,147,eune
251,Efrebee,MASTER I,90,21.8,124,27,97,eune
252,Kayle Upton,MASTER I,89,10.0,408,41,367,eune
253,godiiiii,MASTER I,84,23.1,130,30,100,eune
254,Irôn Sägitta,MASTER I,83,28.3,92,26,66,eune
255,17zhangpaiNMW,MASTER I,82,18.2,121,22,99,eune
256,LeBronze Jàmes,MASTER I,80,19.5,486,95,391,eune
257,kobe24and8,MASTER I,80,16.3,369,60,309,eune
258,mosszhou,MASTER I,80,16.2,345,56,289,eune
259,haopi99,MASTER I,80,19.3,202,39,163,eune
260,942946,MASTER I,80,23.8,130,31,99,eune
261,Sòt,MASTER I,79,19.5,210,41,169,eune
262,Hemaaa,MASTER I,79,27.4,102,28,74,eune
263,dang23,MASTER I,79,20.8,130,27,103,eune
264,zhukerong111,MASTER I,78,19.3,243,47,196,eune
265,theq123,MASTER I,78,18.2,159,29,130,eune
266,fange666,MASTER I,78,23.4,107,25,82,eune
267,yundingfapaiyuan,MASTER I,77,16.7,257,43,214,eune
268,Zsoltikawa,MASTER I,77,11.0,381,42,339,eune
269,KarnageTheCrane,MASTER I,77,13.3,279,37,242,eune
270,xiaofeng998,MASTER I,77,23.8,126,30,96,eune
271,Renandonizet,MASTER I,77,12.1,157,19,138,eune
272,Last Christmas,MASTER I,76,15.6,128,20,108,eune
273,Maaczka,MASTER I,75,15.1,317,48,269,eune
274,CW Arrow,MASTER I,75,25.7,144,37,107,eune
275,defouy,MASTER I,75,18.5,157,29,128,eune
276,songtongyu,MASTER I,75,19.6,138,27,111,eune
277,SupriZ,MASTER I,74,13.8,247,34,213,eune
278,baristaEddy,MASTER I,73,23.2,151,35,116,eune
279,Bad High Roller,MASTER I,73,9.6,218,21,197,eune
280,GetHoooked,MASTER I,70,12.6,277,35,242,eune
281,Niziurski,MASTER I,69,13.8,341,47,294,eune
282,qp2o2oqp,MASTER I,68,22.5,111,25,86,eune
283,loveLD,MASTER I,68,25.5,94,24,70,eune
284,cy9696,MASTER I,67,23.7,139,33,106,eune
285,tianddh,MASTER I,67,18.3,180,33,147,eune
286,chuangzao0o,MASTER I,67,20.7,150,31,119,eune
287,PIka pUUU,MASTER I,66,13.7,300,41,259,eune
288,nóChance,MASTER I,65,15.2,433,66,367,eune
289,axuandog,MASTER I,65,28.6,98,28,70,eune
290,6hhh6bbb,MASTER I,65,20.4,93,19,74,eune
291,Black TFT,MASTER I,64,18.2,247,45,202,eune
292,Høwto1v9,MASTER I,64,10.3,155,16,139,eune
293,SBzwx3,MASTER I,63,44.9,247,111,136,eune
294,522131,MASTER I,63,21.2,151,32,119,eune
295,haaaayugcr,MASTER I,63,16.3,190,31,159,eune
296,Smd k,MASTER I,63,11.1,279,31,248,eune
297,hucanwei,MASTER I,62,24.1,220,53,167,eune
298,Ròot,MASTER I,62,10.4,431,45,386,eune
299,WarlordVengeance,MASTER I,62,13.3,233,31,202,eune
300,SP00KK,MASTER I,60,15.6,681,106,575,eune
301,zyfather,MASTER I,58,14.0,336,47,289,eune
302,RRandomNoob,MASTER I,57,19.8,303,60,243,eune
303,aerodynamicc,MASTER I,57,18.8,288,54,234,eune
304,Róach,MASTER I,56,18.2,363,66,297,eune
305,Tarosch,MASTER I,56,16.9,171,29,142,eune
306,johnniedrake,MASTER I,55,23.0,578,133,445,eune
307,AllSkillNoLuck8,MASTER I,55,18.6,156,29,127,eune
308,dafengxiongdi,MASTER I,55,21.4,98,21,77,eune
309,shaodong,MASTER I,54,13.4,321,43,278,eune
310,Jeckey Chen,MASTER I,53,17.6,567,100,467,eune
311,darksin555,MASTER I,53,15.7,331,52,279,eune
312,Zz52000,MASTER I,53,19.3,166,32,134,eune
313,Hi Im Laure,MASTER I,53,17.6,182,32,150,eune
314,854576720,MASTER I,53,22.1,140,31,109,eune
315,Dethrook,MASTER I,52,22.1,357,79,278,eune
316,YhongL,MASTER I,52,12.0,249,30,219,eune
317,OGoneas1sas,MASTER I,52,31.1,74,23,51,eune
318,gvfgrh4,MASTER I,51,18.2,198,36,162,eune
319,Blackspy48,MASTER I,51,14.8,182,27,155,eune
320,NguyenAn,MASTER I,50,21.3,437,93,344,eune
321,muppymupp,MASTER I,50,22.8,149,34,115,eune
322,EDwarDOG,MASTER I,49,20.1,263,53,210,eune
323,chaojisaiyaren,MASTER I,49,22.4,161,36,125,eune
324,bukzna,MASTER I,49,17.8,135,24,111,eune
325,Wacho,MASTER I,47,19.4,484,94,390,eune
326,douyu696,MASTER I,47,21.7,184,40,144,eune
327,xia555,MASTER I,47,14.7,177,26,151,eune
328,Q6r,MASTER I,46,16.6,673,112,561,eune
329,Sói Ca,MASTER I,46,17.4,275,48,227,eune
330,rainisnice,MASTER I,46,16.4,231,38,193,eune
331,Hamootz,MASTER I,44,24.9,329,82,247,eune
332,helllok,MASTER I,44,21.2,193,41,152,eune
333,ACIDONIN,MASTER I,43,18.9,233,44,189,eune
334,amir rbs,MASTER I,42,13.5,310,42,268,eune
335,Zivotinja,MASTER I,42,14.8,276,41,235,eune
336,zhazhahui,MASTER I,42,21.1,147,31,116,eune
337,BesJhin,MASTER I,42,24.8,121,30,91,eune
338,kasux,MASTER I,41,26.1,211,55,156,eune
339,wddmw111,MASTER I,41,19.9,226,45,181,eune
340,hesuaige,MASTER I,41,20.4,167,34,133,eune
341,SER,MASTER I,40,16.0,363,58,305,eune
342,lmffff,MASTER I,40,18.9,249,47,202,eune
343,huanghaitao,MASTER I,40,14.9,141,21,120,eune
344,Female XD,MASTER I,39,16.0,632,101,531,eune
345,ghostcc,MASTER I,39,18.4,256,47,209,eune
346,AAAndrius,MASTER I,38,11.2,338,38,300,eune
347,AJunii,MASTER I,38,19.9,156,31,125,eune
348,sowilo,MASTER I,37,13.9,287,40,247,eune
349,ffqaqpp,MASTER I,37,15.4,221,34,187,eune
350,nano9B,MASTER I,36,13.6,213,29,184,eune
351,JaguarKWT,MASTER I,36,12.4,153,19,134,eune
352,uzirrr,MASTER I,35,17.3,243,42,201,eune
353,Su6699,MASTER I,35,14.5,228,33,195,eune
354,playgosha,MASTER I,34,12.8,758,97,661,eune
355,SoJeon,MASTER I,34,8.4,639,54,585,eune
356,ST oRO,MASTER I,34,12.3,261,32,229,eune
357,pujsapepa,MASTER I,33,21.8,358,78,280,eune
358,fix this bug pls,MASTER I,33,15.5,323,50,273,eune
359,Aryasfanboy,MASTER I,33,12.9,355,46,309,eune
360,lizhijian,MASTER I,33,17.3,110,19,91,eune
361,kst123l,MASTER I,33,18.1,94,17,77,eune
362,wojiu20limi,MASTER I,32,22.0,186,41,145,eune
363,Kubańczy,MASTER I,32,18.4,223,41,182,eune
364,CreepyBabun,MASTER I,32,18.1,210,38,172,eune
365,PLouSIosLeGenD,MASTER I,32,7.0,525,37,488,eune
366,nousernamesleft,MASTER I,31,15.7,287,45,242,eune
367,xxN0N4M3xx,MASTER I,30,24.4,238,58,180,eune
368,Aggressive Top,MASTER I,30,13.4,299,40,259,eune
369,Hënkyz ßööm,MASTER I,29,16.0,219,35,184,eune
370,Marker775,MASTER I,29,15.9,170,27,143,eune
371,Yuu Noya,MASTER I,29,28.0,75,21,54,eune
372,Champzyme,MASTER I,28,17.0,482,82,400,eune
373,Tsükuyomi,MASTER I,28,13.4,276,37,239,eune
374,qiwangwuxiaodi,MASTER I,28,30.4,115,35,80,eune
375,wusuo9,MASTER I,28,16.8,173,29,144,eune
376,PoistMussy,MASTER I,27,22.5,240,54,186,eune
377,Leaguereaper,MASTER I,27,15.8,310,49,261,eune
378,iximaaa,MASTER I,27,19.1,199,38,161,eune
379,UbicaHer0 No1,MASTER I,27,15.7,210,33,177,eune
380,abclulu,MASTER I,27,23.1,130,30,100,eune
381,Trapdub,MASTER I,27,17.1,146,25,121,eune
382,Thrae,MASTER I,26,23.3,493,115,378,eune
383,mxdzxx,MASTER I,26,17.5,314,55,259,eune
384,SmolFeetTopDif,MASTER I,26,17.6,210,37,173,eune
385,Mr Hops,MASTER I,26,7.6,475,36,439,eune
386,Mikæla,MASTER I,26,22.8,149,34,115,eune
387,FL Baby xQi,MASTER I,26,15.0,180,27,153,eune
388,hi8823,MASTER I,26,18.6,113,21,92,eune
389,LcS MiRiFiQuE,MASTER I,25,13.3,519,69,450,eune
390,Xilzao,MASTER I,25,19.2,224,43,181,eune
391,pig8trotters,MASTER I,25,20.1,179,36,143,eune
392,Lord of jugle,MASTER I,25,10.1,286,29,257,eune
393,Mine is Bigger,MASTER I,25,21.9,96,21,75,eune
394,Abed,MASTER I,24,13.6,572,78,494,eune
395,lourio,MASTER I,24,13.8,522,72,450,eune
396,EG Tropical,MASTER I,24,17.3,404,70,334,eune
397,withboy,MASTER I,24,11.0,508,56,452,eune
398,f0reigner20,MASTER I,24,19.9,176,35,141,eune
399,Jollteon,MASTER I,23,14.8,541,80,461,eune
400,kunxiang1028,MASTER I,23,20.7,198,41,157,eune
401,lidayea,MASTER I,23,14.4,257,37,220,eune
402,DDlittleTsu,MASTER I,23,25.3,91,23,68,eune
403,Achy88,MASTER I,22,14.0,494,69,425,eune
404,Yung Yan,MASTER I,22,14.5,290,42,248,eune
405,shenchao6666,MASTER I,22,25.2,147,37,110,eune
406,Yulicc,MASTER I,22,17.9,173,31,142,eune
407,Joul,MASTER I,22,13.4,201,27,174,eune
408,JustÁbro,MASTER I,21,20.8,288,60,228,eune
409,one shot shaco,MASTER I,21,16.5,328,54,274,eune
410,Disguised omak,MASTER I,21,16.5,267,44,223,eune
411,MoNtEnEgReEn,MASTER I,21,16.1,242,39,203,eune
412,Dominator17,MASTER I,21,14.3,231,33,198,eune
413,xiaotian1,MASTER I,21,23.5,136,32,104,eune
414,BlackCats,MASTER I,20,13.9,517,72,445,eune
415,Stephen Càrry,MASTER I,20,17.6,227,40,187,eune
416,MariöM,MASTER I,20,17.7,158,28,130,eune
417,Shean19,MASTER I,19,11.1,570,63,507,eune
418,maxiaohui,MASTER I,19,15.4,214,33,181,eune
419,ValkyrieSHD,MASTER I,19,15.4,175,27,148,eune
420,K1nGsane,MASTER I,18,28.8,226,65,161,eune
421,YshenA,MASTER I,18,18.8,154,29,125,eune
422,jhghgh,MASTER I,18,22.4,125,28,97,eune
423,xiaoxuanl,MASTER I,18,19.5,118,23,95,eune
424,AirForceTFT,MASTER I,18,16.4,116,19,97,eune
425,Piertucha,MASTER I,17,20.1,164,33,131,eune
426,xinku1e,MASTER I,17,18.2,181,33,148,eune
427,guaguajiang,MASTER I,17,16.7,198,33,165,eune
428,guanyong,MASTER I,17,25.9,108,28,80,eune
429,callmezd,MASTER I,17,15.1,152,23,129,eune
430,DynaM1X1,MASTER I,16,19.4,242,47,195,eune
431,Tuken19,MASTER I,16,20.2,198,40,158,eune
432,xRaTaTA,MASTER I,15,22.4,236,53,183,eune
433,nongshalei1,MASTER I,15,15.2,257,39,218,eune
434,NicTheMan,MASTER I,15,20.3,177,36,141,eune
435,zishi123,MASTER I,15,20.0,165,33,132,eune
436,LetmeZzz,MASTER I,15,23.7,118,28,90,eune
437,szTFTko,MASTER I,15,15.6,173,27,146,eune
438,1122334466,MASTER I,15,17.7,147,26,121,eune
439,Cnouke,MASTER I,15,14.7,177,26,151,eune
440,nikollaje,MASTER I,14,21.4,392,84,308,eune
441,joy761c,MASTER I,14,20.9,201,42,159,eune
442,VermilIion,MASTER I,14,16.2,234,38,196,eune
443,LuZErTX,MASTER I,14,16.3,129,21,108,eune
444,LetoMallory7,MASTER I,13,12.6,609,77,532,eune
445,Vicvicv,MASTER I,13,33.3,114,38,76,eune
446,mid łane banter,MASTER I,12,22.1,222,49,173,eune
447,AnubiS Inpu,MASTER I,12,11.7,402,47,355,eune
448,lyy0202,MASTER I,12,14.3,224,32,192,eune
449,Poporori,MASTER I,11,12.0,593,71,522,eune
450,Yolo Top here,MASTER I,11,21.4,309,66,243,eune
451,Dark of Death,MASTER I,11,17.5,343,60,283,eune
452,Rank1OrDeath,MASTER I,11,14.5,345,50,295,eune
453,7454088,MASTER I,11,26.9,108,29,79,eune
454,morzers,MASTER I,11,25.5,98,25,73,eune
455,suoliyaketong,MASTER I,10,15.8,234,37,197,eune
456,Mingminghenaini,MASTER I,10,24.8,105,26,79,eune
457,iPolaczek,MASTER I,10,11.1,190,21,169,eune
458,fuki30,MASTER I,10,10.8,195,21,174,eune
459,NorvaTheOne,MASTER I,9,9.7,486,47,439,eune
460,Cazamatu,MASTER I,9,16.6,229,38,191,eune
461,cff1234,MASTER I,9,16.3,215,35,180,eune
462,LegìtJJ,MASTER I,9,18.1,171,31,140,eune
463,HzTeiry,MASTER I,9,12.3,252,31,221,eune
464,BixLegolas21,MASTER I,9,16.5,121,20,101,eune
465,Torgo Nudho,MASTER I,8,15.4,1133,175,958,eune
466,Aethna,MASTER I,8,12.9,829,107,722,eune
467,Trix4Loki,MASTER I,8,14.9,571,85,486,eune
468,Napaljenko,MASTER I,8,16.2,432,70,362,eune
469,NewFlopy,MASTER I,8,11.8,591,70,521,eune
470,ImmolatePL,MASTER I,8,16.8,410,69,341,eune
471,chinajiangliuer,MASTER I,8,23.8,122,29,93,eune
472,beshko,MASTER I,8,30.1,83,25,58,eune
473,gladiator3828,MASTER I,7,12.4,787,98,689,eune
474,SoloAlistarOnly,MASTER I,7,13.1,579,76,503,eune
475,Cwaniak Z Polski,MASTER I,7,11.4,484,55,429,eune
476,xXLady StinkXx,MASTER I,7,15.0,353,53,300,eune
477,nibuxiang,MASTER I,7,12.3,146,18,128,eune
478,Mamobacje,MASTER I,7,12.0,150,18,132,eune
479,Keri,MASTER I,6,16.7,492,82,410,eune
480,BobboViking,MASTER I,6,17.8,398,71,327,eune
481,manancasuflete,MASTER I,6,17.2,332,57,275,eune
482,Starbestol,MASTER I,6,20.2,163,33,130,eune
483,PigvCarry,MASTER I,6,11.6,242,28,214,eune
484,ThinkGlobal,MASTER I,5,15.5,380,59,321,eune
485,nidebabaOO,MASTER I,5,28.3,184,52,132,eune
486,toitos21,MASTER I,5,11.7,419,49,370,eune
487,My E Doesnt Work,MASTER I,5,15.9,282,45,237,eune
488,zizixixi,MASTER I,5,18.1,237,43,194,eune
489,liushuai2020,MASTER I,5,13.7,291,40,251,eune
490,Kanibals,MASTER I,5,25.0,156,39,117,eune
491,Axiuww,MASTER I,5,22.6,168,38,130,eune
492,moli1996,MASTER I,5,20.3,172,35,137,eune
493,Hivcii,MASTER I,5,18.5,157,29,128,eune
494,spasa016,MASTER I,4,19.6,290,57,233,eune
495,Cormag,MASTER I,4,21.5,209,45,164,eune
496,BDS MrRedik,MASTER I,4,14.8,291,43,248,eune
497,TriHard7Cx,MASTER I,4,16.5,249,41,208,eune
498,haonaodan,MASTER I,4,16.6,169,28,141,eune
499,UNleash the Fury,MASTER I,4,17.6,148,26,122,eune
500,Hy I m Busu,MASTER I,4,11.1,235,26,209,eune
1,Salvyyy,CHALLENGER I,1691,23.9,280,67,213,euw
2,l2yKo,CHALLENGER I,1658,21.7,1225,266,959,euw
3,Deis1k,CHALLENGER I,1651,21.3,634,135,499,euw
4,Salvyyy TFT,CHALLENGER I,1648,24.8,379,94,285,euw
5,DarkHighroll,CHALLENGER I,1537,22.9,428,98,330,euw
6,DarkHydra,CHALLENGER I,1378,21.3,582,124,458,euw
7,SwellerTiger,CHALLENGER I,1306,18.9,381,72,309,euw
8,Gìngg,CHALLENGER I,1280,24.9,325,81,244,euw
9,Leon Trotskij,CHALLENGER I,1269,24.0,338,81,257,euw
10,Voltariusx,CHALLENGER I,1242,18.4,429,79,350,euw
11,GingGG,CHALLENGER I,1232,22.1,742,164,578,euw
12,ImSøFresh,CHALLENGER I,1191,17.7,879,156,723,euw
13,Sunny Lu,CHALLENGER I,1174,17.9,941,168,773,euw
14,Hotline ming,CHALLENGER I,1163,16.0,780,125,655,euw
15,Tcejer,CHALLENGER I,1158,21.0,352,74,278,euw
16,Kagerou OwO,CHALLENGER I,1148,21.2,430,91,339,euw
17,fan2Kstagne,CHALLENGER I,1137,22.6,195,44,151,euw
18,SwellerTigerTFT,CHALLENGER I,1127,12.9,644,83,561,euw
19,Lallana,CHALLENGER I,1116,18.6,360,67,293,euw
20,FluffyHS,CHALLENGER I,1105,17.2,378,65,313,euw
21,Un33d,CHALLENGER I,1070,17.4,674,117,557,euw
22,Qetzer,CHALLENGER I,1025,15.5,670,104,566,euw
23,Phabal,CHALLENGER I,1016,14.3,655,94,561,euw
24,Liquid Tabzz,CHALLENGER I,1012,22.0,558,123,435,euw
25,Lipo Razak,CHALLENGER I,1010,16.6,547,91,456,euw
26,Phbl,CHALLENGER I,1007,14.1,679,96,583,euw
27,Sologesang,CHALLENGER I,988,14.9,583,87,496,euw
28,Sñus,CHALLENGER I,985,18.6,1185,221,964,euw
29,Wet Jungler,CHALLENGER I,985,14.9,677,101,576,euw
30,Voltariux,CHALLENGER I,972,17.4,507,88,419,euw
31,Pazi4S,CHALLENGER I,961,12.2,484,59,425,euw
32,Sbstn TFT,CHALLENGER I,924,14.6,535,78,457,euw
33,Magarky,CHALLENGER I,922,16.4,493,81,412,euw
34,RyKo v2,CHALLENGER I,919,25.4,319,81,238,euw
35,kassellen,CHALLENGER I,903,13.4,955,128,827,euw
36,BozzBrain v2,CHALLENGER I,896,14.7,340,50,290,euw
37,AceofSpadesITA,CHALLENGER I,886,19.0,348,66,282,euw
38,Lev D Trotskij,CHALLENGER I,872,17.8,517,92,425,euw
39,Deisik,CHALLENGER I,870,18.9,364,69,295,euw
40,BenVK,CHALLENGER I,869,16.3,619,101,518,euw
41,Raizuken,CHALLENGER I,856,18.4,370,68,302,euw
42,TSM Guillosko,CHALLENGER I,852,15.6,867,135,732,euw
43,sayvallahbru,CHALLENGER I,829,14.7,387,57,330,euw
44,Luque,CHALLENGER I,820,17.1,784,134,650,euw
45,Iunci,CHALLENGER I,817,17.7,215,38,177,euw
46,ahuia,CHALLENGER I,814,20.3,217,44,173,euw
47,Zididi,CHALLENGER I,804,16.0,1459,233,1226,euw
48,MogamboDTB,CHALLENGER I,798,12.7,276,35,241,euw
49,TFT ArKoK,CHALLENGER I,793,15.7,889,140,749,euw
50,BeasTFT2,CHALLENGER I,790,20.0,200,40,160,euw
51,lsochan,CHALLENGER I,787,16.7,281,47,234,euw
52,Monphis,CHALLENGER I,785,16.4,1208,198,1010,euw
53,Sizm,CHALLENGER I,781,19.5,727,142,585,euw
54,iHG Tuttek,CHALLENGER I,778,16.2,734,119,615,euw
55,SmileyCereal,CHALLENGER I,772,17.6,1076,189,887,euw
56,lucky smile boy,CHALLENGER I,770,15.7,1191,187,1004,euw
57,Freezzette,CHALLENGER I,766,12.1,634,77,557,euw
58,Bèst Heca EUW,CHALLENGER I,763,18.0,1305,235,1070,euw
59,Doud78,CHALLENGER I,750,17.9,323,58,265,euw
60,Sparakay TFT,CHALLENGER I,743,15.7,261,41,220,euw
61,rare not nice,CHALLENGER I,741,15.3,568,87,481,euw
62,bstln2,CHALLENGER I,740,24.3,251,61,190,euw
63,Kezman,CHALLENGER I,731,19.7,340,67,273,euw
64,Zyriosly,CHALLENGER I,725,16.7,902,151,751,euw
65,outplayingmyself,CHALLENGER I,725,17.2,452,78,374,euw
66,RICH H0MIE QUAN,CHALLENGER I,724,15.1,285,43,242,euw
67,PUNISH1nG,CHALLENGER I,723,18.2,280,51,229,euw
68,Lorus,CHALLENGER I,721,9.1,736,67,669,euw
69,Tits,CHALLENGER I,719,24.3,230,56,174,euw
70,ajoe1231,CHALLENGER I,718,17.5,810,142,668,euw
71,slime03,CHALLENGER I,717,17.4,530,92,438,euw
72,Khristor,CHALLENGER I,716,14.9,397,59,338,euw
73,TehSilli,CHALLENGER I,712,19.2,400,77,323,euw
74,JdnTagNovoline,CHALLENGER I,712,20.6,194,40,154,euw
75,Banisher95,CHALLENGER I,711,13.5,488,66,422,euw
76,dknsbs,CHALLENGER I,708,15.9,552,88,464,euw
77,Palaloa,CHALLENGER I,708,16.6,241,40,201,euw
78,Göl D Roger,CHALLENGER I,704,12.7,805,102,703,euw
79,Just so xi so,CHALLENGER I,704,19.0,310,59,251,euw
80,ll TFT KEKW ll,CHALLENGER I,703,13.7,423,58,365,euw
81,Ev4ngelion,CHALLENGER I,698,16.4,694,114,580,euw
82,IBRAHIMOVIĆ777,CHALLENGER I,698,25.4,209,53,156,euw
83,Jedi Master AK,CHALLENGER I,697,16.4,936,154,782,euw
84,Sayorï best girl,CHALLENGER I,695,17.4,242,42,200,euw
85,BALOTELLI777,CHALLENGER I,693,18.4,516,95,421,euw
86,RazakTFT,CHALLENGER I,690,15.0,1065,160,905,euw
87,męntal,CHALLENGER I,686,13.4,535,72,463,euw
88,Palaloa TFT,CHALLENGER I,686,13.0,470,61,409,euw
89,Un11d,CHALLENGER I,681,18.0,339,61,278,euw
90,TFT Buttons,CHALLENGER I,679,16.1,576,93,483,euw
91,Can I mock you,CHALLENGER I,679,29.6,135,40,95,euw
92,o0OLyReO0o,CHALLENGER I,675,20.1,288,58,230,euw
93,LeDuck TFT,CHALLENGER I,671,17.0,1136,193,943,euw
94,Kÿu,CHALLENGER I,668,17.5,399,70,329,euw
95,BenVK TFT,CHALLENGER I,668,17.1,315,54,261,euw
96,TarteMan TFT,CHALLENGER I,667,14.9,455,68,387,euw
97,Xeno TFTx,CHALLENGER I,666,10.3,778,80,698,euw
98,iamTLT,CHALLENGER I,666,12.6,310,39,271,euw
99,Waazabii,CHALLENGER I,665,20.0,190,38,152,euw
100,Subahibi,CHALLENGER I,664,14.7,429,63,366,euw
101,Drunkiris,CHALLENGER I,658,19.8,298,59,239,euw
102,Nutscrackeros,CHALLENGER I,656,15.6,224,35,189,euw
103,Cachual,CHALLENGER I,655,25.0,212,53,159,euw
104,Bränk,CHALLENGER I,651,15.9,439,70,369,euw
105,PonRoo,CHALLENGER I,650,12.4,1021,127,894,euw
106,5454,CHALLENGER I,650,14.9,509,76,433,euw
107,NinjaPavels,CHALLENGER I,648,17.4,298,52,246,euw
108,Drünkiris,CHALLENGER I,646,19.4,427,83,344,euw
109,Gôn Freeçss,CHALLENGER I,645,20.9,273,57,216,euw
110,Itario,CHALLENGER I,645,12.8,446,57,389,euw
111,AmuuMuu,CHALLENGER I,643,12.1,1053,127,926,euw
112,Can I trust you,CHALLENGER I,640,20.1,279,56,223,euw
113,dirtyspear,CHALLENGER I,639,15.4,479,74,405,euw
114,iPoPz v2,CHALLENGER I,638,19.6,204,40,164,euw
115,Yanís,CHALLENGER I,635,16.1,409,66,343,euw
116,OnlyBetter,CHALLENGER I,633,10.0,409,41,368,euw
117,YowiTFT,CHALLENGER I,631,20.6,243,50,193,euw
118,TFT Enzosexe,CHALLENGER I,629,12.2,878,107,771,euw
119,Doud TFT,CHALLENGER I,629,20.7,232,48,184,euw
120,JedenTagNovoline,CHALLENGER I,626,23.6,191,45,146,euw
121,IceLoom,CHALLENGER I,625,17.8,241,43,198,euw
122,G2 ReventXz,CHALLENGER I,620,21.3,296,63,233,euw
123,I R INVINC1BLE,CHALLENGER I,618,15.1,734,111,623,euw
124,The Gay Minion,CHALLENGER I,618,13.7,630,86,544,euw
125,Suisaiga 2,CHALLENGER I,616,17.1,414,71,343,euw
126,kacpersky191TFT,CHALLENGER I,611,14.3,854,122,732,euw
127,Vicer v2,CHALLENGER I,609,14.7,299,44,255,euw
128,Némaïdès,CHALLENGER I,606,14.3,610,87,523,euw
129,hyuII,CHALLENGER I,605,16.7,670,112,558,euw
130,Rïft,CHALLENGER I,604,15.5,219,34,185,euw
131,Zebra TFT,CHALLENGER I,604,17.8,163,29,134,euw
132,always be hape,CHALLENGER I,602,17.5,378,66,312,euw
133,TFTits,CHALLENGER I,601,20.2,178,36,142,euw
134,AKA magic,CHALLENGER I,598,13.0,744,97,647,euw
135,Skiizield,CHALLENGER I,596,13.4,982,132,850,euw
136,Tatufo,CHALLENGER I,593,14.0,558,78,480,euw
137,idlemonk TFT,CHALLENGER I,593,10.8,617,67,550,euw
138,BALOTELLI777 TFT,CHALLENGER I,591,15.8,444,70,374,euw
139,ABEL748,CHALLENGER I,587,12.9,418,54,364,euw
140,Nescro,CHALLENGER I,586,15.7,407,64,343,euw
141,Warmeur le vrai,CHALLENGER I,585,23.1,216,50,166,euw
142,LeDuck v2,CHALLENGER I,583,15.4,435,67,368,euw
143,Racklure,CHALLENGER I,580,14.4,909,131,778,euw
144,TFT Emperador,CHALLENGER I,580,13.4,875,117,758,euw
145,iPoPz,CHALLENGER I,579,16.4,547,90,457,euw
146,zomgowy,CHALLENGER I,578,17.7,232,41,191,euw
147,Riƒt,CHALLENGER I,577,13.4,709,95,614,euw
148,stayl23,CHALLENGER I,573,13.8,478,66,412,euw
149,Kenopsia,CHALLENGER I,571,10.1,881,89,792,euw
150,YowiTFT2,CHALLENGER I,571,21.4,215,46,169,euw
151,Futaken,CHALLENGER I,567,16.9,255,43,212,euw
152,Miiouw,CHALLENGER I,561,14.5,511,74,437,euw
153,NouLTerass,CHALLENGER I,561,16.8,232,39,193,euw
154,TeemoDaSlayer420,CHALLENGER I,560,20.9,177,37,140,euw
155,diabifleur,CHALLENGER I,558,14.3,592,85,507,euw
156,gluteus maxímus,CHALLENGER I,558,16.4,385,63,322,euw
157,Whiteyeas2,CHALLENGER I,558,18.3,175,32,143,euw
158,Lornyk,CHALLENGER I,557,14.1,899,127,772,euw
159,TXK9z,CHALLENGER I,557,13.0,660,86,574,euw
160,Liber8 Hong Kong,CHALLENGER I,557,17.5,485,85,400,euw
161,Summuner Name,CHALLENGER I,556,19.4,289,56,233,euw
162,VicerTFT,CHALLENGER I,554,15.6,443,69,374,euw
163,Zaratuska,CHALLENGER I,552,16.1,448,72,376,euw
164,LIPO Absykos,CHALLENGER I,549,14.8,400,59,341,euw
165,Esel51,CHALLENGER I,549,11.7,386,45,341,euw
166,Xerxan,CHALLENGER I,548,15.0,667,100,567,euw
167,Oooouuiiiiiiii,CHALLENGER I,546,16.6,524,87,437,euw
168,HASHIDA,CHALLENGER I,544,13.9,717,100,617,euw
169,Kjekken123,CHALLENGER I,544,19.6,500,98,402,euw
170,KlimA,CHALLENGER I,544,15.9,465,74,391,euw
171,MCMCinITALY,CHALLENGER I,535,18.3,487,89,398,euw
172,At The Gates,CHALLENGER I,532,20.9,296,62,234,euw
173,DRLAMER,CHALLENGER I,531,17.9,1169,209,960,euw
174,ziro1997,CHALLENGER I,531,16.7,347,58,289,euw
175,Shσtgun,CHALLENGER I,530,15.6,778,121,657,euw
176,5454XD,CHALLENGER I,528,16.9,539,91,448,euw
177,Kirbes,CHALLENGER I,527,15.0,434,65,369,euw
178,YPRN Chwbk,CHALLENGER I,527,18.3,311,57,254,euw
179,hongmorongguang,CHALLENGER I,524,18.0,350,63,287,euw
180,AquareIIe,CHALLENGER I,520,17.0,323,55,268,euw
181,TFTACKK,CHALLENGER I,519,26.6,177,47,130,euw
182,Sløt,CHALLENGER I,518,17.2,313,54,259,euw
183,R1CH HOM1E QUAN,CHALLENGER I,518,18.3,213,39,174,euw
184,Bersalis,CHALLENGER I,513,15.7,325,51,274,euw
185,yooog,CHALLENGER I,511,14.1,547,77,470,euw
186,Lonnen,CHALLENGER I,509,14.0,534,75,459,euw
187,TwoBiers TFT,CHALLENGER I,509,15.4,371,57,314,euw
188,Bersa TFT,CHALLENGER I,507,15.7,508,80,428,euw
189,Ougie Boogie,CHALLENGER I,507,12.8,618,79,539,euw
190,Adonis17,CHALLENGER I,506,16.7,761,127,634,euw
191,birdyrrr,CHALLENGER I,506,18.6,242,45,197,euw
192,FengXiaoQiLing,CHALLENGER I,503,23.0,261,60,201,euw
193,San Jomian,CHALLENGER I,502,13.1,733,96,637,euw
194,Funkfreed,CHALLENGER I,501,16.1,336,54,282,euw
195,Gilozinho,CHALLENGER I,500,13.3,906,121,785,euw
196,WINZEEER,CHALLENGER I,499,14.9,705,105,600,euw
197,A French Rat,CHALLENGER I,498,15.9,470,75,395,euw
198,Gunmay,CHALLENGER I,498,9.5,778,74,704,euw
199,EnlèveTesMoufles,CHALLENGER I,498,17.3,294,51,243,euw
200,RaveeOnTFT,CHALLENGER I,497,12.6,547,69,478,euw
201,Banisher95 TFT,CHALLENGER I,493,12.0,443,53,390,euw
202,PITICHI,CHALLENGER I,491,13.8,1076,149,927,euw
203,JollyFaker777,CHALLENGER I,491,15.8,354,56,298,euw
204,Wholean,CHALLENGER I,490,12.3,520,64,456,euw
205,Whiteyeas,CHALLENGER I,490,14.5,338,49,289,euw
206,OxygenWhiite,CHALLENGER I,490,15.6,289,45,244,euw
207,Smokesick,CHALLENGER I,488,17.1,292,50,242,euw
208,DrGreenthumb0,CHALLENGER I,487,13.8,435,60,375,euw
209,DianaEatme,CHALLENGER I,486,12.7,858,109,749,euw
210,Lelouuch,CHALLENGER I,486,16.7,312,52,260,euw
211,SKT Help Me,CHALLENGER I,485,16.4,512,84,428,euw
212,WawaTatata,CHALLENGER I,485,13.7,553,76,477,euw
213,MapleKK,CHALLENGER I,482,19.7,188,37,151,euw
214,Sir Bobz,CHALLENGER I,480,10.6,442,47,395,euw
215,Lahar04,CHALLENGER I,479,18.6,215,40,175,euw
216,Sτοrm,CHALLENGER I,478,14.9,732,109,623,euw
217,ShinoPavels,CHALLENGER I,478,17.4,602,105,497,euw
218,zoomgowy,CHALLENGER I,477,19.2,219,42,177,euw
219,dameoiseau,CHALLENGER I,477,12.3,267,33,234,euw
220,Rehnz,CHALLENGER I,476,14.6,725,106,619,euw
221,Sirfetchd,CHALLENGER I,475,10.0,290,29,261,euw
222,TheAware,CHALLENGER I,473,12.7,553,70,483,euw
223,Genotik,CHALLENGER I,472,13.3,465,62,403,euw
224,1puRe Clinton,CHALLENGER I,471,15.2,552,84,468,euw
225,birdy513,CHALLENGER I,468,16.2,678,110,568,euw
226,LittlePiggyBF,CHALLENGER I,468,12.4,629,78,551,euw
227,Sparakay,CHALLENGER I,468,13.9,310,43,267,euw
228,Tschabading,CHALLENGER I,467,13.6,858,117,741,euw
229,OxygenWhiteTFT,CHALLENGER I,465,25.7,175,45,130,euw
230,RaveeOn,CHALLENGER I,463,13.2,478,63,415,euw
231,Tonsof,CHALLENGER I,463,19.6,107,21,86,euw
232,Nyan Zebra,CHALLENGER I,461,16.0,244,39,205,euw
233,Warmeur TFT,CHALLENGER I,458,18.1,359,65,294,euw
234,Ranceta,CHALLENGER I,458,11.4,553,63,490,euw
235,Woaigouge,CHALLENGER I,456,15.6,752,117,635,euw
236,Virfel,CHALLENGER I,455,13.5,858,116,742,euw
237,Stonyy v1,CHALLENGER I,455,14.7,530,78,452,euw
238,hi im hochin,CHALLENGER I,453,16.9,313,53,260,euw
239,sun666shine,CHALLENGER I,452,18.6,323,60,263,euw
240,AieZen 2,CHALLENGER I,452,10.1,276,28,248,euw
241,Warmeur,CHALLENGER I,450,16.2,400,65,335,euw
242,TarteMan,CHALLENGER I,450,17.9,318,57,261,euw
243,KAD Mason,CHALLENGER I,450,16.7,258,43,215,euw
244,redbyte7GR,CHALLENGER I,449,17.5,251,44,207,euw
245,Sweet Nydre,CHALLENGER I,449,19.4,139,27,112,euw
246,justinng,CHALLENGER I,447,17.6,386,68,318,euw
247,spongebob smiley,CHALLENGER I,447,16.8,405,68,337,euw
248,MuttaGanero,CHALLENGER I,446,16.0,451,72,379,euw
249,Naotan Mid,CHALLENGER I,445,18.3,317,58,259,euw
250,Lowlander,CHALLENGER I,445,15.9,289,46,243,euw
251,chainpullzEU,CHALLENGER I,445,15.9,170,27,143,euw
252,Sheriff1903,CHALLENGER I,443,11.4,686,78,608,euw
253,Emoktua,CHALLENGER I,442,19.5,457,89,368,euw
254,UnbornYordle,CHALLENGER I,442,17.7,486,86,400,euw
255,shiromonster000,CHALLENGER I,442,18.1,382,69,313,euw
256,Maxwellβoltzman,CHALLENGER I,442,17.1,246,42,204,euw
257,TheUnbornYordle,CHALLENGER I,440,13.3,346,46,300,euw
258,Benger923,CHALLENGER I,438,14.2,337,48,289,euw
259,Snoodyboo,CHALLENGER I,437,14.3,631,90,541,euw
260,xXD4rkN412uT0Xx,CHALLENGER I,436,24.8,165,41,124,euw
261,ÃFG,CHALLENGER I,435,10.7,531,57,474,euw
262,mixer Alx2020,CHALLENGER I,434,14.0,529,74,455,euw
263,Undercoverism,CHALLENGER I,434,15.2,394,60,334,euw
264,Fairy Breeder,CHALLENGER I,433,15.3,476,73,403,euw
265,Douyu4228274,CHALLENGER I,433,16.8,316,53,263,euw
266,Love anime boy,CHALLENGER I,430,14.5,475,69,406,euw
267,WalktheGangplank,CHALLENGER I,429,12.2,302,37,265,euw
268,TwTv T3BY,CHALLENGER I,429,14.8,230,34,196,euw
269,luffy57773,CHALLENGER I,427,14.0,741,104,637,euw
270,MrKok0,CHALLENGER I,427,11.9,644,77,567,euw
271,IWannaRideMyPyke,CHALLENGER I,427,14.1,283,40,243,euw
272,Strawberry fish,CHALLENGER I,426,19.7,350,69,281,euw
273,Ferra4Fun,CHALLENGER I,425,10.2,1201,122,1079,euw
274,IIDyonisosII,CHALLENGER I,425,13.4,538,72,466,euw
275,Mediaboy 2,CHALLENGER I,425,15.7,300,47,253,euw
276,mastameow,CHALLENGER I,424,15.4,299,46,253,euw
277,Nyu Zmurf,CHALLENGER I,424,13.1,337,44,293,euw
278,HagbardSolo,CHALLENGER I,424,20.7,116,24,92,euw
279,Maxobido,CHALLENGER I,423,8.3,1331,110,1221,euw
280,simplywojtek tft,CHALLENGER I,423,20.6,213,44,169,euw
281,Suriyargh,CHALLENGER I,422,12.4,1314,163,1151,euw
282,Paradise For All,CHALLENGER I,422,17.8,382,68,314,euw
283,VegaHD,CHALLENGER I,422,12.8,376,48,328,euw
284,TwSS Flash,CHALLENGER I,421,16.7,610,102,508,euw
285,Gelado de Buceta,CHALLENGER I,421,16.3,484,79,405,euw
286,Xarizzz,CHALLENGER I,421,14.1,397,56,341,euw
287,Razayel,CHALLENGER I,419,14.2,451,64,387,euw
288,Rioe,CHALLENGER I,419,16.4,299,49,250,euw
289,Ujo,CHALLENGER I,419,15.5,271,42,229,euw
290,Fofo x jisoo,CHALLENGER I,418,14.9,495,74,421,euw
291,Qetzz,CHALLENGER I,418,22.4,152,34,118,euw
292,Le inter masqué,CHALLENGER I,415,16.0,324,52,272,euw
293,Cute Crab,CHALLENGER I,414,15.7,217,34,183,euw
294,TNG Lucy Chan,CHALLENGER I,413,11.2,905,101,804,euw
295,MaCkTFT,CHALLENGER I,396,12.5,1473,184,1289,euw
296,Pray to RNG god,CHALLENGER I,385,13.3,286,38,248,euw
297,BKrisz,CHALLENGER I,383,12.6,635,80,555,euw
298,ttv NevyPT,CHALLENGER I,378,15.8,380,60,320,euw
299,Dandoo,CHALLENGER I,376,11.3,397,45,352,euw
300,Jeon Soyeon,CHALLENGER I,324,13.2,537,71,466,euw
301,S6767,"GRANDMASTER I
G",452,14.9,650,97,553,euw
302,Alpha Player 2,"GRANDMASTER I
G",442,15.7,464,73,391,euw
303,Fein7,"GRANDMASTER I
G",437,16.3,810,132,678,euw
304,Wedra TF,"GRANDMASTER I
G",432,18.0,189,34,155,euw
305,Il Mitra,"GRANDMASTER I
G",427,14.8,608,90,518,euw
306,VAieZen,"GRANDMASTER I
G",422,12.1,481,58,423,euw
307,Cry M0re Plz,"GRANDMASTER I
G",417,17.7,634,112,522,euw
308,White biubiu,"GRANDMASTER I
G",414,19.0,179,34,145,euw
309,YourLifeisMineEU,"GRANDMASTER I
G",413,13.8,1080,149,931,euw
310,Alrevan TFT,"GRANDMASTER I
G",413,12.5,343,43,300,euw
311,Lammendam,"GRANDMASTER I
G",410,12.2,540,66,474,euw
312,ZèRô,"GRANDMASTER I
G",409,12.9,734,95,639,euw
313,ahlinswag,"GRANDMASTER I
G",408,15.9,346,55,291,euw
314,Nydre,"GRANDMASTER I
G",407,19.2,172,33,139,euw
315,Furriya,"GRANDMASTER I
G",405,16.2,216,35,181,euw
316,Nutinut,"GRANDMASTER I
G",404,18.8,1091,205,886,euw
317,DatSharzy,"GRANDMASTER I
G",404,14.1,432,61,371,euw
318,butsex,"GRANDMASTER I
G",401,19.2,224,43,181,euw
319,OnlyEloBoost,"GRANDMASTER I
G",401,20.4,186,38,148,euw
320,Adastraa,"GRANDMASTER I
G",398,14.8,189,28,161,euw
321,dimaar,"GRANDMASTER I
G",394,13.6,619,84,535,euw
322,Dedicasse Fahd,"GRANDMASTER I
G",391,16.2,591,96,495,euw
323,iLLuuu TFT,"GRANDMASTER I
G",387,13.8,494,68,426,euw
324,KLeMx,"GRANDMASTER I
G",386,17.9,441,79,362,euw
325,TFT Mikkus,"GRANDMASTER I
G",386,11.6,586,68,518,euw
326,0chl0,"GRANDMASTER I
G",381,19.8,666,132,534,euw
327,amneLOL,"GRANDMASTER I
G",380,12.9,435,56,379,euw
328,Mynameisdodi,"GRANDMASTER I
G",380,9.5,549,52,497,euw
329,Korra HD,"GRANDMASTER I
G",378,26.4,125,33,92,euw
330,SpritneyBiers,"GRANDMASTER I
G",377,17.1,420,72,348,euw
331,KRIMEN,"GRANDMASTER I
G",373,11.0,792,87,705,euw
332,Tâp Quên Ði,"GRANDMASTER I
G",373,19.0,216,41,175,euw
333,Smartwings,"GRANDMASTER I
G",369,17.4,684,119,565,euw
334,TalexPrime,"GRANDMASTER I
G",367,11.6,1033,120,913,euw
335,Archie Stõne,"GRANDMASTER I
G",366,15.0,280,42,238,euw
336,Skipper173,"GRANDMASTER I
G",364,10.5,295,31,264,euw
337,Summer Influenza,"GRANDMASTER I
G",360,14.4,459,66,393,euw
338,TAKETHEHONKPILL,"GRANDMASTER I
G",359,12.9,473,61,412,euw
339,Higa,"GRANDMASTER I
G",358,17.5,520,91,429,euw
340,ShowYourDonger,"GRANDMASTER I
G",355,14.2,303,43,260,euw
341,LOLsPresident,"GRANDMASTER I
G",353,19.6,419,82,337,euw
342,HypnoHS,"GRANDMASTER I
G",352,14.9,571,85,486,euw
343,zoro5773,"GRANDMASTER I
G",350,12.8,823,105,718,euw
344,Êxii,"GRANDMASTER I
G",348,14.9,450,67,383,euw
345,you wont win xd,"GRANDMASTER I
G",345,20.3,143,29,114,euw
346,Zyríos,"GRANDMASTER I
G",343,14.3,446,64,382,euw
347,lovingmyplant,"GRANDMASTER I
G",343,16.9,225,38,187,euw
348,Drazar,"GRANDMASTER I
G",342,10.5,751,79,672,euw
349,Afase,"GRANDMASTER I
G",342,18.2,209,38,171,euw
350,TFT IlIIIllIIlIl,"GRANDMASTER I
G",339,22.4,152,34,118,euw
351,swaqt,"GRANDMASTER I
G",337,20.9,320,67,253,euw
352,Arestidios,"GRANDMASTER I
G",337,14.6,240,35,205,euw
353,Tonichoux,"GRANDMASTER I
G",335,20.2,243,49,194,euw
354,Kizhh,"GRANDMASTER I
G",332,17.4,230,40,190,euw
355,Hua Kai Hui Luo,"GRANDMASTER I
G",326,12.4,594,74,520,euw
356,Za  doggo warudo,"GRANDMASTER I
G",326,19.5,261,51,210,euw
357,Molarck,"GRANDMASTER I
G",326,15.8,317,50,267,euw
358,GRIEFER XDDD,"GRANDMASTER I
G",325,20.1,184,37,147,euw
359,IamnotTLT,"GRANDMASTER I
G",324,14.4,333,48,285,euw
360,iAFG,"GRANDMASTER I
G",324,11.3,318,36,282,euw
361,yoqueloque,"GRANDMASTER I
G",323,18.4,245,45,200,euw
362,TFT KΙNG,"GRANDMASTER I
G",319,17.2,232,40,192,euw
363,Les collègues,"GRANDMASTER I
G",319,15.7,166,26,140,euw
364,NèmSensei,"GRANDMASTER I
G",316,16.8,987,166,821,euw
365,JollyFaker,"GRANDMASTER I
G",316,15.1,471,71,400,euw
366,Elisav,"GRANDMASTER I
G",316,18.5,124,23,101,euw
367,LeBoisCaBrule,"GRANDMASTER I
G",313,17.6,205,36,169,euw
368,Billgax,"GRANDMASTER I
G",311,13.4,491,66,425,euw
369,Hyunjinbot,"GRANDMASTER I
G",310,12.7,275,35,240,euw
370,BKrisz TFT,"GRANDMASTER I
G",310,21.8,119,26,93,euw
371,Bananana,"GRANDMASTER I
G",309,15.0,695,104,591,euw
372,Le Grand Palmier,"GRANDMASTER I
G",308,14.6,576,84,492,euw
373,Danguardians,"GRANDMASTER I
G",307,13.5,282,38,244,euw
374,Scafista,"GRANDMASTER I
G",304,15.9,245,39,206,euw
375,bstln,"GRANDMASTER I
G",303,19.4,320,62,258,euw
376,Consistent luck,"GRANDMASTER I
G",303,19.5,205,40,165,euw
377,Ryuk DTB,"GRANDMASTER I
G",301,11.4,651,74,577,euw
378,Boguetta,"GRANDMASTER I
G",301,18.1,248,45,203,euw
379,Liocardia,"GRANDMASTER I
G",301,20.7,116,24,92,euw
380,Sit Sit,"GRANDMASTER I
G",295,15.9,145,23,122,euw
381,Döbereiner,"GRANDMASTER I
G",294,15.7,597,94,503,euw
382,aristocrat,"GRANDMASTER I
G",294,16.7,263,44,219,euw
383,kaiio,"GRANDMASTER I
G",293,13.1,244,32,212,euw
384,TaKK TFT,"GRANDMASTER I
G",289,14.7,531,78,453,euw
385,Red Tuxedo,"GRANDMASTER I
G",289,14.5,530,77,453,euw
386,Gryffus01,"GRANDMASTER I
G",288,12.8,533,68,465,euw
387,LLL Sneaky,"GRANDMASTER I
G",288,16.9,355,60,295,euw
388,Morcovell,"GRANDMASTER I
G",286,15.8,467,74,393,euw
389,Dinomies,"GRANDMASTER I
G",284,12.5,736,92,644,euw
390,Torlk,"GRANDMASTER I
G",282,14.3,1085,155,930,euw
391,Lux al 7,"GRANDMASTER I
G",281,13.2,347,46,301,euw
392,TheFray,"GRANDMASTER I
G",280,16.1,883,142,741,euw
393,Picikutyus192,"GRANDMASTER I
G",277,16.7,168,28,140,euw
394,Miháwk,"GRANDMASTER I
G",276,17.8,595,106,489,euw
395,Towati,"GRANDMASTER I
G",275,13.6,638,87,551,euw
396,N3m3s1X,"GRANDMASTER I
G",274,14.2,618,88,530,euw
397,Lost in ur smile,"GRANDMASTER I
G",273,13.7,694,95,599,euw
398,1027,"GRANDMASTER I
G",273,16.3,282,46,236,euw
399,HeadButtAlistar,"GRANDMASTER I
G",272,12.9,721,93,628,euw
400,SHAOGUOWEI,"GRANDMASTER I
G",271,16.7,412,69,343,euw
401,ninthie,"GRANDMASTER I
G",270,17.8,326,58,268,euw
402,MarooNTFT,"GRANDMASTER I
G",270,17.6,182,32,150,euw
403,Le Shot,"GRANDMASTER I
G",268,14.0,1253,176,1077,euw
404,Enclase,"GRANDMASTER I
G",268,14.4,564,81,483,euw
405,Pure B1ue,"GRANDMASTER I
G",267,14.1,377,53,324,euw
406,N3m3s1XSmrf,"GRANDMASTER I
G",266,21.2,189,40,149,euw
407,Momor Vig,"GRANDMASTER I
G",265,12.8,744,95,649,euw
408,Magnificent Feta,"GRANDMASTER I
G",265,14.2,296,42,254,euw
409,TheLudensEkko,"GRANDMASTER I
G",265,14.6,260,38,222,euw
410,clearlove6,"GRANDMASTER I
G",263,16.9,415,70,345,euw
411,Liocardia TFT,"GRANDMASTER I
G",263,28.4,74,21,53,euw
412,MaTT1926,"GRANDMASTER I
G",262,12.4,1394,173,1221,euw
413,vickytchii,"GRANDMASTER I
G",262,10.3,970,100,870,euw
414,daveblue3,"GRANDMASTER I
G",261,21.2,254,54,200,euw
415,Rhow,"GRANDMASTER I
G",261,16.6,319,53,266,euw
416,Oririi,"GRANDMASTER I
G",261,8.8,569,50,519,euw
417,FearTorgun,"GRANDMASTER I
G",261,16.2,240,39,201,euw
418,LACT,"GRANDMASTER I
G",261,21.2,151,32,119,euw
419,MALODORAN,"GRANDMASTER I
G",260,12.8,383,49,334,euw
420,grLdIbkqhU,"GRANDMASTER I
G",259,19.3,181,35,146,euw
421,XilaxamBoy,"GRANDMASTER I
G",258,22.3,166,37,129,euw
422,irrelevant RoIe,"GRANDMASTER I
G",257,18.1,271,49,222,euw
423,YuukiSamuse,"GRANDMASTER I
G",257,20.5,161,33,128,euw
424,samouna,"GRANDMASTER I
G",255,14.2,465,66,399,euw
425,TheInvinc1ble,"GRANDMASTER I
G",255,12.8,319,41,278,euw
426,Shielded,"GRANDMASTER I
G",254,11.9,588,70,518,euw
427,Zwingel,"GRANDMASTER I
G",251,12.5,561,70,491,euw
428,Galoubi,"GRANDMASTER I
G",250,17.3,485,84,401,euw
429,Dalesom,"GRANDMASTER I
G",250,16.8,304,51,253,euw
430,Boubsho,"GRANDMASTER I
G",248,13.3,737,98,639,euw
431,BeasTFT,"GRANDMASTER I
G",248,14.6,378,55,323,euw
432,sklzzkt,"GRANDMASTER I
G",247,14.6,357,52,305,euw
433,Asyfrost,"GRANDMASTER I
G",246,23.5,153,36,117,euw
434,bat les yeuks,"GRANDMASTER I
G",244,21.6,102,22,80,euw
435,BP Kim Jisoo,"GRANDMASTER I
G",244,16.7,108,18,90,euw
436,azzlacktumor,"GRANDMASTER I
G",243,15.6,487,76,411,euw
437,naphara,"GRANDMASTER I
G",243,14.7,259,38,221,euw
438,Iriiick,"GRANDMASTER I
G",243,16.3,227,37,190,euw
439,OniiiiChan,"GRANDMASTER I
G",242,18.8,511,96,415,euw
440,SirLowk,"GRANDMASTER I
G",241,11.8,398,47,351,euw
441,Cherrious HAN,"GRANDMASTER I
G",240,13.5,784,106,678,euw
442,Yanak1n,"GRANDMASTER I
G",240,11.8,482,57,425,euw
443,Bibia Be Ye Ye,"GRANDMASTER I
G",240,30.4,69,21,48,euw
444,Always top 8 TFT,"GRANDMASTER I
G",239,15.8,507,80,427,euw
445,Greed bld,"GRANDMASTER I
G",238,14.2,352,50,302,euw
446,SachenPro,"GRANDMASTER I
G",238,11.9,252,30,222,euw
447,GameTFT,"GRANDMASTER I
G",236,15.8,328,52,276,euw
448,Seksy,"GRANDMASTER I
G",235,21.1,227,48,179,euw
449,OOF MACHINE,"GRANDMASTER I
G",235,20.1,204,41,163,euw
450,Garen03,"GRANDMASTER I
G",234,12.2,514,63,451,euw
451,etre infame,"GRANDMASTER I
G",234,11.9,514,61,453,euw
452,Enimos,"GRANDMASTER I
G",233,16.0,524,84,440,euw
453,Kÿu v2,"GRANDMASTER I
G",233,20.6,126,26,100,euw
454,Diderot Le Croco,"GRANDMASTER I
G",232,15.3,248,38,210,euw
455,Lariano813,"GRANDMASTER I
G",232,14.8,236,35,201,euw
456,Ernilol,"GRANDMASTER I
G",232,15.0,207,31,176,euw
457,Marcoyoung4ever,"GRANDMASTER I
G",231,18.4,185,34,151,euw
458,FollowYourShadow,"GRANDMASTER I
G",230,14.3,968,139,829,euw
459,Long Ð,"GRANDMASTER I
G",230,13.4,389,52,337,euw
460,Chelito91,"GRANDMASTER I
G",229,14.1,488,69,419,euw
461,Hynan,"GRANDMASTER I
G",227,15.8,672,106,566,euw
462,StinkPuh,"GRANDMASTER I
G",227,16.5,273,45,228,euw
463,perfect sinner,"GRANDMASTER I
G",226,16.3,667,109,558,euw
464,DestructorXD,"GRANDMASTER I
G",225,15.0,320,48,272,euw
465,El Tomdill,"GRANDMASTER I
G",224,14.8,525,78,447,euw
466,Roboante,"GRANDMASTER I
G",224,18.4,206,38,168,euw
467,PRC Wilo,"GRANDMASTER I
G",223,15.5,431,67,364,euw
468,crapchiTFT,"GRANDMASTER I
G",223,18.0,294,53,241,euw
469,Mironia,"GRANDMASTER I
G",223,16.2,283,46,237,euw
470,Djøula,"GRANDMASTER I
G",221,19.9,282,56,226,euw
471,Havarianlolz,"GRANDMASTER I
G",218,20.0,185,37,148,euw
472,Crvor,"GRANDMASTER I
G",217,14.8,663,98,565,euw
473,castoro alfa,"GRANDMASTER I
G",217,16.8,196,33,163,euw
474,Feint TFT,"GRANDMASTER I
G",217,25.3,83,21,62,euw
475,Bobobätr,"GRANDMASTER I
G",215,14.2,449,64,385,euw
476,kEizy,"GRANDMASTER I
G",215,17.1,269,46,223,euw
477,Specter BS,"GRANDMASTER I
G",215,10.5,353,37,316,euw
478,Italian Urg0d,"GRANDMASTER I
G",214,16.6,511,85,426,euw
479,ThisChampIsHard,"GRANDMASTER I
G",214,14.6,323,47,276,euw
480,RiiKKz,"GRANDMASTER I
G",213,15.3,907,139,768,euw
481,TFT Mastermind,"GRANDMASTER I
G",213,15.3,216,33,183,euw
482,Dąrk Star Xerath,"GRANDMASTER I
G",212,12.3,764,94,670,euw
483,Laeta8,"GRANDMASTER I
G",212,15.2,367,56,311,euw
484,BlanecinTFT,"GRANDMASTER I
G",212,14.6,329,48,281,euw
485,DevilDream II,"GRANDMASTER I
G",212,15.0,274,41,233,euw
486,ThatCrit,"GRANDMASTER I
G",212,14.1,262,37,225,euw
487,Xarly1498,"GRANDMASTER I
G",211,13.5,757,102,655,euw
488,Grassouil,"GRANDMASTER I
G",211,16.9,367,62,305,euw
489,Mn Gaenvan,"GRANDMASTER I
G",211,15.3,222,34,188,euw
490,o OSi o,"GRANDMASTER I
G",208,16.6,500,83,417,euw
491,VESIPETO,"GRANDMASTER I
G",207,14.3,418,60,358,euw
492,Kìrby,"GRANDMASTER I
G",207,16.7,251,42,209,euw
493,Bren0,"GRANDMASTER I
G",207,18.4,168,31,137,euw
494,AR4B,"GRANDMASTER I
G",206,13.5,453,61,392,euw
495,xJPB,"GRANDMASTER I
G",206,16.9,348,59,289,euw
496,Udji,"GRANDMASTER I
G",205,15.5,566,88,478,euw
497,ShishiAnnie,"GRANDMASTER I
G",205,19.0,237,45,192,euw
498,ShishiAnnie Two,"GRANDMASTER I
G",205,17.5,189,33,156,euw
499,Badwòman,"GRANDMASTER I
G",204,16.1,460,74,386,euw
500,523666,"GRANDMASTER I
G",204,8.5,659,56,603,euw
1,Hiraino,CHALLENGER I,714,22.1,439,97,342,jp
2,KKQ,CHALLENGER I,676,21.3,333,71,262,jp
3,HiROKKtft,CHALLENGER I,569,19.7,309,61,248,jp
4,思い出の昼下がり,CHALLENGER I,512,26.0,208,54,154,jp
5,Best 佐藤 JP,CHALLENGER I,479,24.2,244,59,185,jp
6,hakutou,CHALLENGER I,452,23.7,658,156,502,jp
7,煩いマン,CHALLENGER I,450,18.0,233,42,191,jp
8,じーく,CHALLENGER I,444,19.3,321,62,259,jp
9,God Fukuoka,CHALLENGER I,436,19.9,357,71,286,jp
10,Best太郎JP,CHALLENGER I,433,21.9,329,72,257,jp
11,むむっ,CHALLENGER I,429,22.3,314,70,244,jp
12,dayona,CHALLENGER I,423,17.6,1108,195,913,jp
13,trotv,CHALLENGER I,423,16.0,505,81,424,jp
14,Age 21,CHALLENGER I,414,22.7,198,45,153,jp
15,害獣あらいぐま,CHALLENGER I,392,13.2,409,54,355,jp
16,rionest,CHALLENGER I,391,17.6,978,172,806,jp
17,chocotto,CHALLENGER I,373,21.4,459,98,361,jp
18,ひまわり準決勝,CHALLENGER I,372,24.9,193,48,145,jp
19,Shroud Fanboy,CHALLENGER I,370,15.8,1083,171,912,jp
20,kes,CHALLENGER I,341,19.3,368,71,297,jp
21,シャドウバース,CHALLENGER I,339,18.9,624,118,506,jp
22,ajun,CHALLENGER I,336,17.8,730,130,600,jp
23,pureheart player,CHALLENGER I,335,17.5,320,56,264,jp
24,ap top mom die,CHALLENGER I,272,23.3,227,53,174,jp
25,大門未知子,CHALLENGER I,237,19.0,189,36,153,jp
26,dozepk,CHALLENGER I,227,15.2,440,67,373,jp
27,Piyochan76,CHALLENGER I,222,16.5,260,43,217,jp
28,えっっ,CHALLENGER I,219,17.5,206,36,170,jp
29,etsuya0505,CHALLENGER I,217,16.5,550,91,459,jp
30,Tぽいんと,CHALLENGER I,202,21.4,275,59,216,jp
31,喚くマン,CHALLENGER I,201,18.3,416,76,340,jp
32,Adrenaline,CHALLENGER I,198,18.6,499,93,406,jp
33,さとるくん,CHALLENGER I,171,11.2,445,50,395,jp
34,山田周人,CHALLENGER I,168,16.5,454,75,379,jp
35,FoT DazzingDog,CHALLENGER I,167,21.6,269,58,211,jp
36,ぼんちょび,CHALLENGER I,149,27.6,152,42,110,jp
37,秋水宴,CHALLENGER I,144,16.1,267,43,224,jp
38,Bad Takahashi,CHALLENGER I,144,19.7,188,37,151,jp
39,Worst Takashi JP,CHALLENGER I,130,13.2,432,57,375,jp
40,bappy,CHALLENGER I,124,18.4,767,141,626,jp
41,にぶさき,CHALLENGER I,123,15.5,950,147,803,jp
42,loraplayer,CHALLENGER I,123,17.4,809,141,668,jp
43,KR blonde lov,CHALLENGER I,119,21.4,210,45,165,jp
44,nagatoevol,CHALLENGER I,117,17.2,378,65,313,jp
45,しかめまどか,CHALLENGER I,116,14.7,1174,173,1001,jp
46,sueno09,CHALLENGER I,110,13.3,279,37,242,jp
47,Count Mak,CHALLENGER I,105,20.0,435,87,348,jp
48,Jackn,CHALLENGER I,99,21.1,208,44,164,jp
49,かふす,CHALLENGER I,45,17.9,753,135,618,jp
50,bonchobi,CHALLENGER I,0,14.7,455,67,388,jp
51,まくらi,"GRANDMASTER I
G",203,22.9,118,27,91,jp
52,ますにゃ,"GRANDMASTER I
G",146,13.6,691,94,597,jp
53,りーり,"GRANDMASTER I
G",121,12.7,959,122,837,jp
54,しかめまどか2,"GRANDMASTER I
G",92,23.7,215,51,164,jp
55,マグロマート,"GRANDMASTER I
G",85,20.1,139,28,111,jp
56,XionNoi,"GRANDMASTER I
G",84,18.7,380,71,309,jp
57,xtc,"GRANDMASTER I
G",83,18.2,422,77,345,jp
58,Yaruo,"GRANDMASTER I
G",82,16.8,280,47,233,jp
59,モルディ貝,"GRANDMASTER I
G",80,15.9,314,50,264,jp
60,Waterfox,"GRANDMASTER I
G",74,13.1,291,38,253,jp
61,kotogane411,"GRANDMASTER I
G",73,17.7,198,35,163,jp
62,URUUUU,"GRANDMASTER I
G",68,20.1,442,89,353,jp
63,賃砲丸出侍,"GRANDMASTER I
G",68,23.0,209,48,161,jp
64,dngr,"GRANDMASTER I
G",67,15.8,246,39,207,jp
65,だよな,"GRANDMASTER I
G",67,21.4,154,33,121,jp
66,ekollon,"GRANDMASTER I
G",53,18.0,422,76,346,jp
67,elfiny,"GRANDMASTER I
G",49,17.8,163,29,134,jp
68,Ponty,"GRANDMASTER I
G",44,15.6,777,121,656,jp
69,karakuti,"GRANDMASTER I
G",39,20.4,206,42,164,jp
70,ぽんぽん桂,"GRANDMASTER I
G",38,16.2,563,91,472,jp
71,Twisted Fate Bot,"GRANDMASTER I
G",37,16.5,339,56,283,jp
72,pccc,"GRANDMASTER I
G",35,31.8,88,28,60,jp
73,にじむら,"GRANDMASTER I
G",33,12.7,686,87,599,jp
74,Sukizofureni,"GRANDMASTER I
G",28,13.2,532,70,462,jp
75,nijimuraact2,"GRANDMASTER I
G",28,15.4,428,66,362,jp
76,MELODY FLAG,"GRANDMASTER I
G",28,20.0,190,38,152,jp
77,Raias,"GRANDMASTER I
G",25,16.3,522,85,437,jp
78,おしっこちゃん,"GRANDMASTER I
G",23,11.9,622,74,548,jp
79,名取ざや,"GRANDMASTER I
G",23,23.6,229,54,175,jp
80,Hechima777,"GRANDMASTER I
G",22,14.6,666,97,569,jp
81,Satolis,"GRANDMASTER I
G",22,10.1,424,43,381,jp
82,hohe,"GRANDMASTER I
G",21,16.4,614,101,513,jp
83,沼の大破神,"GRANDMASTER I
G",16,19.4,247,48,199,jp
84,夜空丶,"GRANDMASTER I
G",15,19.6,189,37,152,jp
85,曖昧心,"GRANDMASTER I
G",15,15.1,232,35,197,jp
86,mikan0x0,"GRANDMASTER I
G",14,12.3,707,87,620,jp
87,contrail,"GRANDMASTER I
G",13,18.4,147,27,120,jp
88,Why So Serious,"GRANDMASTER I
G",11,14.8,311,46,265,jp
89,ぬこ丸,"GRANDMASTER I
G",10,18.7,471,88,383,jp
90,misomega,"GRANDMASTER I
G",10,16.2,388,63,325,jp
91,夏目純夏,"GRANDMASTER I
G",7,25.1,167,42,125,jp
92,macro11,"GRANDMASTER I
G",5,16.3,282,46,236,jp
93,GoodMannerU5,"GRANDMASTER I
G",3,14.2,438,62,376,jp
94,ロルから逃げるな,"GRANDMASTER I
G",3,19.1,162,31,131,jp
95,鳥取で一番強い男,"GRANDMASTER I
G",0,13.2,342,45,297,jp
96,クックパッド歩美,"GRANDMASTER I
G",0,21.1,147,31,116,jp
97,ゲッティスパ美,"GRANDMASTER I
G",0,18.4,163,30,133,jp
98,foxbaby123b,MASTER I,16,13.6,493,67,426,jp
99,丸の内LOLレイナ,MASTER I,13,16.1,429,69,360,jp
100,ZmLFs2z,DIAMOND I,97,21.9,155,34,121,jp
101,日高愛,DIAMOND I,96,15.5,420,65,355,jp
102,Eidechse,DIAMOND I,91,16.4,220,36,184,jp
103,お前のレベル笑,DIAMOND I,87,20.4,373,76,297,jp
104,shuraha3,DIAMOND I,87,16.3,380,62,318,jp
105,副頭取,DIAMOND I,86,13.7,212,29,183,jp
106,millepiedi,DIAMOND I,85,13.8,269,37,232,jp
107,じょん炊いたー,DIAMOND I,81,21.8,298,65,233,jp
108,CosplayGirl,DIAMOND I,79,23.7,219,52,167,jp
109,askrp,DIAMOND I,75,17.0,569,97,472,jp
110,lalabybyby,DIAMOND I,75,15.6,461,72,389,jp
111,MichaelChan,DIAMOND I,75,17.7,317,56,261,jp
112,ぴにゃぴっぴ,DIAMOND I,75,15.3,346,53,293,jp
113,てっくてっく,DIAMOND I,75,19.0,273,52,221,jp
114,ききちま,DIAMOND I,75,18.2,285,52,233,jp
115,福山はさまるJP,DIAMOND I,75,16.3,307,50,257,jp
116,ABEKANZOU,DIAMOND I,75,19.5,210,41,169,jp
117,ButaDaJoe,DIAMOND I,75,19.5,190,37,153,jp
118,dozeqk,DIAMOND I,75,19.0,189,36,153,jp
119,スルギすき,DIAMOND I,75,16.7,204,34,170,jp
120,オーシャン増永,DIAMOND I,75,18.8,176,33,143,jp
121,tola,DIAMOND I,75,14.3,230,33,197,jp
122,濃厚鶏白湯拉麺,DIAMOND I,75,17.3,156,27,129,jp
123,IKUTOMIE,DIAMOND I,75,11.4,228,26,202,jp
124,AikaS,DIAMOND I,74,16.3,728,119,609,jp
125,いまのん,DIAMOND I,71,17.9,352,63,289,jp
126,くりちゃん大好き,DIAMOND I,69,21.4,159,34,125,jp
127,HitujiDaJoe,DIAMOND I,63,16.4,195,32,163,jp
128,1515225,DIAMOND I,59,14.9,376,56,320,jp
129,汝何着品如衣,DIAMOND I,57,16.1,230,37,193,jp
130,shinano,DIAMOND I,56,16.2,154,25,129,jp
131,Gafu,DIAMOND I,55,13.6,795,108,687,jp
132,vvvvvvvvvipp,DIAMOND I,54,17.8,518,92,426,jp
133,tomonar1,DIAMOND I,54,14.6,362,53,309,jp
134,Ugokeru Debu Bot,DIAMOND I,53,16.5,218,36,182,jp
135,るきにゃん,DIAMOND I,52,17.1,450,77,373,jp
136,low roller,DIAMOND I,52,18.3,175,32,143,jp
137,Kyoutle,DIAMOND I,51,12.9,649,84,565,jp
138,gacchapin20,DIAMOND I,50,13.4,648,87,561,jp
139,ゆっちー,DIAMOND I,50,11.9,361,43,318,jp
140,たなってぃ,DIAMOND I,43,16.4,426,70,356,jp
141,koogie,DIAMOND I,39,14.3,343,49,294,jp
142,うーきち TFT,DIAMOND I,38,19.0,564,107,457,jp
143,えんどほーぷ,DIAMOND I,37,8.7,578,50,528,jp
144,εOnOз,DIAMOND I,37,18.8,138,26,112,jp
145,Kuririman,DIAMOND I,31,14.7,265,39,226,jp
146,ぜろななにーいち,DIAMOND I,31,22.1,163,36,127,jp
147,halkeye,DIAMOND I,29,14.2,597,85,512,jp
148,yatsuhashi567,DIAMOND I,28,13.7,248,34,214,jp
149,彼氏の顔ぽっぴー,DIAMOND I,26,13.9,151,21,130,jp
150,orange7premium,DIAMOND I,25,17.1,461,79,382,jp
151,スタフィー,DIAMOND I,25,23.8,172,41,131,jp
152,Endcyclone,DIAMOND I,25,28.0,143,40,103,jp
153,pano,DIAMOND I,24,17.0,442,75,367,jp
154,世界詞のキア,DIAMOND I,24,16.7,126,21,105,jp
155,Shield Samba,DIAMOND I,22,13.3,480,64,416,jp
156,うるるる,DIAMOND I,21,21.2,137,29,108,jp
157,NewmetaTrollking,DIAMOND I,19,12.6,374,47,327,jp
158,IlllIlllIlllI,DIAMOND I,18,20.3,177,36,141,jp
159,キャンディ  猫,DIAMOND I,17,19.8,172,34,138,jp
160,sack dance,DIAMOND I,16,10.6,951,101,850,jp
161,neetneo,DIAMOND I,16,20.9,210,44,166,jp
162,ダンボ君,DIAMOND I,11,17.4,161,28,133,jp
163,shuraha4,DIAMOND I,10,13.6,302,41,261,jp
164,InventusGaming,DIAMOND I,8,10.6,348,37,311,jp
165,ヨンジン,DIAMOND I,6,9.3,355,33,322,jp
166,nasyoter,DIAMOND I,6,15.3,137,21,116,jp
167,福山はさまるNA,DIAMOND I,5,19.7,147,29,118,jp
168,pveman,DIAMOND I,4,17.6,295,52,243,jp
169,マヨヒガ,DIAMOND I,4,11.1,450,50,400,jp
170,yurarara11,DIAMOND I,3,20.8,485,101,384,jp
171,Kaboom,DIAMOND I,3,22.4,85,19,66,jp
172,ジャジャラ,DIAMOND I,2,16.8,184,31,153,jp
173,Sakurakouji Luna,DIAMOND I,2,20.6,126,26,100,jp
174,ばーじん,DIAMOND I,1,15.4,791,122,669,jp
175,エミュー,DIAMOND I,1,14.4,445,64,381,jp
176,ShiitakeForest,DIAMOND I,1,14.0,236,33,203,jp
177,はんえつか,DIAMOND I,1,16.8,185,31,154,jp
178,アイルー卿,DIAMOND I,0,15.1,364,55,309,jp
179,Asdgum,DIAMOND I,0,15.2,349,53,296,jp
180,laser501,DIAMOND I,0,16.4,237,39,198,jp
181,siva fes,DIAMOND I,0,12.5,279,35,244,jp
182,下了88,DIAMOND I,0,27.6,116,32,84,jp
183,toudoriDX2,DIAMOND I,0,9.9,302,30,272,jp
184,Rhino Cider,DIAMOND I,0,12.6,191,24,167,jp
185,Remixi,DIAMOND I,0,12.2,189,23,166,jp
186,7zigeN,DIAMOND II,99,17.6,996,175,821,jp
187,newie,DIAMOND II,94,15.5,328,51,277,jp
188,AHIKJDK,DIAMOND II,92,27.2,103,28,75,jp
189,きゅんきゅん,DIAMOND II,84,14.8,418,62,356,jp
190,キイロイトリ3,DIAMOND II,80,13.3,255,34,221,jp
191,tinko irelia,DIAMOND II,77,16.9,225,38,187,jp
192,korekoreTFT,DIAMOND II,75,14.0,712,100,612,jp
193,えんぢょ,DIAMOND II,75,18.2,422,77,345,jp
194,Y0m02,DIAMOND II,75,14.1,509,72,437,jp
195,所念皆星河,DIAMOND II,75,18.7,315,59,256,jp
196,やんやんこ,DIAMOND II,75,13.1,435,57,378,jp
197,kamiEli,DIAMOND II,75,14.8,337,50,287,jp
198,7Silky7,DIAMOND II,75,13.2,356,47,309,jp
199,Pattol,DIAMOND II,75,18.8,245,46,199,jp
200,HUSSEY8810,DIAMOND II,75,13.1,314,41,273,jp
201,くりちゃんTFT,DIAMOND II,75,19.5,200,39,161,jp
202,檸檬堂,DIAMOND II,75,16.0,244,39,205,jp
203,whiteposs,DIAMOND II,75,10.2,374,38,336,jp
204,ヨダルラーハ,DIAMOND II,75,20.0,170,34,136,jp
205,ウーノ,DIAMOND II,75,14.8,229,34,195,jp
206,涼風あおば,DIAMOND II,75,19.8,96,19,77,jp
207,チャイコフスキー,DIAMOND II,68,14.1,1027,145,882,jp
208,Caplico,DIAMOND II,68,17.5,240,42,198,jp
209,watchhhhhh,DIAMOND II,67,18.1,149,27,122,jp
210,HaRpooN,DIAMOND II,61,15.1,523,79,444,jp
211,おやすみの翁,DIAMOND II,59,16.7,132,22,110,jp
212,center8128,DIAMOND II,58,14.4,167,24,143,jp
213,いけなる,DIAMOND II,56,17.4,714,124,590,jp
214,山下美月,DIAMOND II,54,26.7,105,28,77,jp
215,NAGATSUNE,DIAMOND II,53,14.4,543,78,465,jp
216,hrs,DIAMOND II,53,19.1,303,58,245,jp
217,えりぽよ,DIAMOND II,51,11.5,261,30,231,jp
218,Enter Hallownest,DIAMOND II,50,16.0,231,37,194,jp
219,ciple753,DIAMOND II,50,12.4,297,37,260,jp
220,ポッチャマ,DIAMOND II,50,11.9,310,37,273,jp
221,靴職人,DIAMOND II,48,13.7,511,70,441,jp
222,Makorli,DIAMOND II,45,10.6,226,24,202,jp
223,梧 桐,DIAMOND II,44,14.4,923,133,790,jp
224,Nochita,DIAMOND II,44,12.0,249,30,219,jp
225,yayo84,DIAMOND II,43,21.9,128,28,100,jp
226,嘘柱 誇張しのぶ,DIAMOND II,42,16.2,191,31,160,jp
227,ZEITAKU man,DIAMOND II,42,22.5,111,25,86,jp
228,Cyzo,DIAMOND II,41,12.4,564,70,494,jp
229,Religious丶,DIAMOND II,41,17.9,307,55,252,jp
230,yorolium,DIAMOND II,38,16.2,476,77,399,jp
231,Hirobumi,DIAMOND II,38,20.1,189,38,151,jp
232,うぃぐ,DIAMOND II,36,11.2,232,26,206,jp
233,おふめたであそぼ,DIAMOND II,36,12.5,144,18,126,jp
234,ミュート,DIAMOND II,35,13.8,297,41,256,jp
235,doxxo,DIAMOND II,34,11.5,253,29,224,jp
236,Stea 2,DIAMOND II,33,11.3,124,14,110,jp
237,ぽこた,DIAMOND II,32,18.7,348,65,283,jp
238,axela,DIAMOND II,32,12.4,177,22,155,jp
239,srinm,DIAMOND II,31,16.7,426,71,355,jp
240,snatcher,DIAMOND II,30,14.8,526,78,448,jp
241,oni5roshi,DIAMOND II,29,17.1,210,36,174,jp
242,超天才,DIAMOND II,28,16.7,306,51,255,jp
243,みすどでぶ,DIAMOND II,28,13.0,192,25,167,jp
244,初心者kyo,DIAMOND II,26,11.0,264,29,235,jp
245,西新井,DIAMOND II,26,15.6,167,26,141,jp
246,黑島沙和i,DIAMOND II,25,29.0,324,94,230,jp
247,mcscrubjr,DIAMOND II,25,16.2,277,45,232,jp
248,にんふ,DIAMOND II,25,16.3,252,41,211,jp
249,detteiusyousa,DIAMOND II,25,11.7,205,24,181,jp
250,Premium Malt,DIAMOND II,23,13.2,664,88,576,jp
251,菲桑家大魔王,DIAMOND II,23,21.4,281,60,221,jp
252,thewrongman123,DIAMOND II,23,15.7,319,50,269,jp
253,仕事がきらいです,DIAMOND II,23,14.2,239,34,205,jp
254,ゲレクシス,DIAMOND II,23,19.2,120,23,97,jp
255,biubiu,DIAMOND II,22,18.2,367,67,300,jp
256,TenderBalls,DIAMOND II,22,16.5,218,36,182,jp
257,Hermes0,DIAMOND II,21,16.0,713,114,599,jp
258,度し難い,DIAMOND II,19,14.7,607,89,518,jp
259,墨 眉,DIAMOND II,19,14.6,288,42,246,jp
260,Sungoi,DIAMOND II,19,15.7,217,34,183,jp
261,NT plz,DIAMOND II,18,13.6,339,46,293,jp
262,此方より彼方まで,DIAMOND II,17,16.4,274,45,229,jp
263,xKurosx,DIAMOND II,16,16.5,412,68,344,jp
264,戦ナ占学竜忍詩機,DIAMOND II,15,7.7,718,55,663,jp
265,びっとこ女子,DIAMOND II,13,13.5,519,70,449,jp
266,Giáo Án Top8 TFT,DIAMOND II,13,20.4,275,56,219,jp
267,Rin09,DIAMOND II,13,14.7,184,27,157,jp
268,Syutya,DIAMOND II,12,14.8,650,96,554,jp
269,KICKbach,DIAMOND II,12,12.9,519,67,452,jp
270,ふうニキ,DIAMOND II,12,11.4,510,58,452,jp
271,ーAkiraー,DIAMOND II,9,13.7,364,50,314,jp
272,askrq,DIAMOND II,9,23.4,154,36,118,jp
273,ぽこくま,DIAMOND II,9,18.6,129,24,105,jp
274,メンタルがよわい,DIAMOND II,7,22.1,104,23,81,jp
275,enamel,DIAMOND II,6,9.6,334,32,302,jp
276,UnpokoKenshi,DIAMOND II,4,17.1,228,39,189,jp
277,Jethro Cyrus,DIAMOND II,2,13.9,574,80,494,jp
278,プレデター村上,DIAMOND II,1,12.0,416,50,366,jp
279,とっき,DIAMOND II,0,16.8,793,133,660,jp
280,ZEINIKU man,DIAMOND II,0,15.9,627,100,527,jp
281,acaria,DIAMOND II,0,23.5,298,70,228,jp
282,エトペペ,DIAMOND II,0,21.9,310,68,242,jp
283,ぐくぐくぐく,DIAMOND II,0,13.1,495,65,430,jp
284,理解のある彼くん,DIAMOND II,0,15.6,405,63,342,jp
285,蟹さん,DIAMOND II,0,11.7,437,51,386,jp
286,onamasu,DIAMOND II,0,12.3,348,43,305,jp
287,花園めい,DIAMOND II,0,14.2,296,42,254,jp
288,Eclairr,DIAMOND II,0,16.9,236,40,196,jp
289,ni ma su ra,DIAMOND II,0,16.0,243,39,204,jp
290,whiteliot99,DIAMOND II,0,13.2,287,38,249,jp
291,Drosophila,DIAMOND II,0,16.2,210,34,176,jp
292,imymind,DIAMOND II,0,15.8,215,34,181,jp
293,Hide on the bush,DIAMOND II,0,12.1,281,34,247,jp
294,このばかちんがぁ,DIAMOND II,0,14.7,224,33,191,jp
295,新ふうちゃん,DIAMOND II,0,14.1,234,33,201,jp
296,ironman2,DIAMOND II,0,14.3,217,31,186,jp
297,SanteSante,DIAMOND II,0,12.1,257,31,226,jp
298,Angel di maria,DIAMOND II,0,18.8,149,28,121,jp
299,ARAM専,DIAMOND II,0,16.4,165,27,138,jp
300,きんたマン,DIAMOND II,0,12.5,184,23,161,jp
301,お下劣大百科,DIAMOND II,0,17.2,128,22,106,jp
302,ezmk3,DIAMOND II,0,11.1,171,19,152,jp
303,GUMandDAM,DIAMOND III,98,12.0,566,68,498,jp
304,GrystalVirgin,DIAMOND III,98,23.0,100,23,77,jp
305,MABARIKO,DIAMOND III,97,16.8,489,82,407,jp
306,I DO RAMMUS JUNG,DIAMOND III,96,15.8,316,50,266,jp
307,インターネット,DIAMOND III,93,17.0,147,25,122,jp
308,hahachay,DIAMOND III,90,13.0,575,75,500,jp
309,admin testuser01,DIAMOND III,87,14.7,803,118,685,jp
310,Stea 0,DIAMOND III,81,12.7,456,58,398,jp
311,akitosoya,DIAMOND III,80,13.9,488,68,420,jp
312,RankedBot,DIAMOND III,79,15.0,507,76,431,jp
313,百年後,DIAMOND III,78,11.8,355,42,313,jp
314,エアは空気,DIAMOND III,77,15.0,412,62,350,jp
315,hpppz,DIAMOND III,75,17.5,663,116,547,jp
316,AquaAura,DIAMOND III,75,19.2,365,70,295,jp
317,ふるつぼ,DIAMOND III,75,17.8,332,59,273,jp
318,forever18,DIAMOND III,75,16.2,346,56,290,jp
319,海口江流儿,DIAMOND III,75,22.4,245,55,190,jp
320,Shinj,DIAMOND III,75,13.0,316,41,275,jp
321,nentou,DIAMOND III,75,16.1,242,39,203,jp
322,nO1v1On,DIAMOND III,75,16.2,234,38,196,jp
323,Yelin2,DIAMOND III,75,22.3,139,31,108,jp
324,斬帝少女アカメ,DIAMOND III,75,14.3,217,31,186,jp
325,止まらないオルガ,DIAMOND III,75,44.3,61,27,34,jp
326,zaiga,DIAMOND III,75,23.2,99,23,76,jp
327,約束された終末,DIAMOND III,75,26.9,78,21,57,jp
328,たし蟹ｗ,DIAMOND III,75,16.8,119,20,99,jp
329,yukiguniflower,DIAMOND III,70,16.2,148,24,124,jp
330,aind712,DIAMOND III,69,18.2,181,33,148,jp
331,HibeInBush,DIAMOND III,67,16.1,336,54,282,jp
332,young4u,DIAMOND III,67,16.4,305,50,255,jp
333,giver,DIAMOND III,63,16.2,247,40,207,jp
334,VTAKU77,DIAMOND III,63,11.9,109,13,96,jp
335,huairenzhushou,DIAMOND III,59,17.3,473,82,391,jp
336,しろてぃー,DIAMOND III,59,8.8,692,61,631,jp
337,492601,DIAMOND III,57,18.3,191,35,156,jp
338,GUNKATANAMAN,DIAMOND III,57,14.9,228,34,194,jp
339,彩月のあ,DIAMOND III,56,15.2,627,95,532,jp
340,ravennnnnnnnnnnn,DIAMOND III,56,11.8,510,60,450,jp
341,yayo841,DIAMOND III,56,12.1,273,33,240,jp
342,ymkd,DIAMOND III,56,16.0,200,32,168,jp
343,りいの,DIAMOND III,55,16.6,385,64,321,jp
344,SUPERSALT,DIAMOND III,53,15.8,475,75,400,jp
345,Raitora,DIAMOND III,52,14.8,271,40,231,jp
346,じゃこちゃん,DIAMOND III,51,14.2,261,37,224,jp
347,satohige,DIAMOND III,50,16.8,458,77,381,jp
348,ジーコ,DIAMOND III,49,15.5,277,43,234,jp
349,イキ杉愛苦朗,DIAMOND III,48,16.4,275,45,230,jp
350,Pon2,DIAMOND III,47,15.2,453,69,384,jp
351,AD VietNamese,DIAMOND III,47,13.9,459,64,395,jp
352,Monster Box 20段,DIAMOND III,47,18.5,275,51,224,jp
353,keropu,DIAMOND III,46,11.8,415,49,366,jp
354,新参者X,DIAMOND III,45,21.5,246,53,193,jp
355,roku123,DIAMOND III,44,16.7,402,67,335,jp
356,Best 三毛猫 jp,DIAMOND III,44,11.4,262,30,232,jp
357,iZukama,DIAMOND III,43,12.1,595,72,523,jp
358,Lyth,DIAMOND III,43,17.5,143,25,118,jp
359,kimi1211,DIAMOND III,39,12.3,431,53,378,jp
360,電磁抜刀 禍,DIAMOND III,38,13.8,188,26,162,jp
361,ランダムそうち,DIAMOND III,36,12.5,665,83,582,jp
362,ええんやで,DIAMOND III,36,12.1,265,32,233,jp
363,cøcø,DIAMOND III,34,13.6,631,86,545,jp
364,Beige,DIAMOND III,33,12.5,337,42,295,jp
365,Father Christmas,DIAMOND III,33,17.2,238,41,197,jp
366,Wuju Senshi,DIAMOND III,31,13.8,434,60,374,jp
367,Douglas Bullet,DIAMOND III,31,15.0,260,39,221,jp
368,かろかん,DIAMOND III,31,22.6,62,14,48,jp
369,醤ØuØ油,DIAMOND III,30,14.2,805,114,691,jp
370,Lotus Q,DIAMOND III,30,12.3,316,39,277,jp
371,Calimero,DIAMOND III,30,15.4,208,32,176,jp
372,期間限定公開18禁,DIAMOND III,30,18.8,154,29,125,jp
373,アイス,DIAMOND III,29,28.8,80,23,57,jp
374,れおすぴ,DIAMOND III,28,16.5,406,67,339,jp
375,titekubo,DIAMOND III,28,13.8,400,55,345,jp
376,北条加蓮,DIAMOND III,28,10.9,239,26,213,jp
377,moitapchoi1,DIAMOND III,28,8.0,201,16,185,jp
378,Hiromu3,DIAMOND III,27,11.7,472,55,417,jp
379,ahegaomj,DIAMOND III,27,16.4,183,30,153,jp
380,Best 井上 JP,DIAMOND III,27,12.2,188,23,165,jp
381,mari,DIAMOND III,25,24.7,235,58,177,jp
382,summertimer,DIAMOND III,25,15.8,309,49,260,jp
383,空は高く風は歌え,DIAMOND III,25,23.1,173,40,133,jp
384,理科一類,DIAMOND III,25,21.6,185,40,145,jp
385,kuma81,DIAMOND III,25,11.1,314,35,279,jp
386,Rudel,DIAMOND III,25,23.3,146,34,112,jp
387,Mixiffy,DIAMOND III,25,19.2,99,19,80,jp
388,ウーフ,DIAMOND III,25,23.9,67,16,51,jp
389,Piwxn9,DIAMOND III,25,12.8,125,16,109,jp
390,Leaaaaaaaaaaaaaa,DIAMOND III,24,15.8,303,48,255,jp
391,Rolling,DIAMOND III,24,16.9,183,31,152,jp
392,SteelyRaww,DIAMOND III,23,15.7,464,73,391,jp
393,tikpen,DIAMOND III,22,16.0,412,66,346,jp
394,unenyon,DIAMOND III,22,13.6,324,44,280,jp
395,ばねちゃんねる,DIAMOND III,22,20.1,214,43,171,jp
396,ぐれい,DIAMOND III,21,12.9,643,83,560,jp
397,Veyr Soryr,DIAMOND III,21,16.2,142,23,119,jp
398,ていちん,DIAMOND III,20,15.9,516,82,434,jp
399,setuna,DIAMOND III,18,12.8,374,48,326,jp
400,がいこくじんです,DIAMOND III,18,12.6,350,44,306,jp
401,Furry White,DIAMOND III,18,18.8,96,18,78,jp
402,supelaw,DIAMOND III,16,10.5,638,67,571,jp
403,だいごちゃん,DIAMOND III,16,14.8,330,49,281,jp
404,bonkuraman,DIAMOND III,16,13.4,344,46,298,jp
405,Habibi Top,DIAMOND III,15,17.2,238,41,197,jp
406,SoNor,DIAMOND III,15,10.2,382,39,343,jp
407,TFTgirl,DIAMOND III,15,15.7,223,35,188,jp
408,PogoMix,DIAMOND III,15,13.8,188,26,162,jp
409,ひもさまだぞ,DIAMOND III,14,28.9,76,22,54,jp
410,kasuteraman,DIAMOND III,12,10.7,961,103,858,jp
411,M700LTR,DIAMOND III,12,14.3,230,33,197,jp
412,くうしか,DIAMOND III,11,13.4,701,94,607,jp
413,OHA,DIAMOND III,11,16.1,161,26,135,jp
414,あでみん,DIAMOND III,9,12.0,301,36,265,jp
415,Kimura,DIAMOND III,7,12.0,441,53,388,jp
416,CV斎藤千和,DIAMOND III,7,13.1,382,50,332,jp
417,LegalH1gh,DIAMOND III,5,14.8,432,64,368,jp
418,germger,DIAMOND III,5,18.7,262,49,213,jp
419,yuuchao815,DIAMOND III,5,10.9,238,26,212,jp
420,紅葉Maple,DIAMOND III,5,15.0,140,21,119,jp
421,やりサーのボッチ,DIAMOND III,4,13.7,524,72,452,jp
422,三好と松永,DIAMOND III,4,25.5,102,26,76,jp
423,Shiromine,DIAMOND III,4,19.2,130,25,105,jp
424,森七菜,DIAMOND III,3,18.6,602,112,490,jp
425,ももりんちょ,DIAMOND III,3,18.4,114,21,93,jp
426,robeen,DIAMOND III,2,14.4,543,78,465,jp
427,氷球弾,DIAMOND III,2,22.3,206,46,160,jp
428,shabtyu,DIAMOND III,2,16.7,246,41,205,jp
429,MapleStory2,DIAMOND III,2,12.4,266,33,233,jp
430,Norihiro242,DIAMOND III,1,10.7,798,85,713,jp
431,かどまめかし,DIAMOND III,1,17.7,164,29,135,jp
432,Wazzup チョッピ,DIAMOND III,0,15.1,710,107,603,jp
433,REGRETSHE,DIAMOND III,0,17.4,512,89,423,jp
434,鈴木汚拓,DIAMOND III,0,12.2,600,73,527,jp
435,真島ヒロ,DIAMOND III,0,13.0,501,65,436,jp
436,林檎盛り,DIAMOND III,0,11.3,523,59,464,jp
437,ゼファー,DIAMOND III,0,15.8,367,58,309,jp
438,nossou,DIAMOND III,0,15.6,358,56,302,jp
439,Sknow,DIAMOND III,0,12.9,433,56,377,jp
440,下ネタは嫌いです,DIAMOND III,0,19.1,277,53,224,jp
441,でーもんまみ,DIAMOND III,0,17.7,288,51,237,jp
442,もりぴー,DIAMOND III,0,15.7,293,46,247,jp
443,コグマウ,DIAMOND III,0,15.7,267,42,225,jp
444,五十音ことは,DIAMOND III,0,15.5,238,37,201,jp
445,yanemint,DIAMOND III,0,12.5,295,37,258,jp
446,Lusterbell,DIAMOND III,0,16.2,198,32,166,jp
447,独 尊,DIAMOND III,0,14.2,219,31,188,jp
448,プンプン打つな,DIAMOND III,0,18.5,162,30,132,jp
449,priyome,DIAMOND III,0,13.4,202,27,175,jp
450,kaede614,DIAMOND III,0,11.8,220,26,194,jp
451,わたなべ,DIAMOND III,0,12.4,186,23,163,jp
452,otomo,DIAMOND III,0,17.9,117,21,96,jp
453,Kak4rotto,DIAMOND III,0,18.4,98,18,80,jp
454,tomosuna,DIAMOND IV,99,11.4,201,23,178,jp
455,cnmWDNMD,DIAMOND IV,98,21.1,312,66,246,jp
456,Anernone,DIAMOND IV,96,13.2,371,49,322,jp
457,要糖嘛,DIAMOND IV,96,15.2,223,34,189,jp
458,OffBeat,DIAMOND IV,95,14.7,326,48,278,jp
459,がねたろ,DIAMOND IV,94,12.3,326,40,286,jp
460,bbegg1nnerr,DIAMOND IV,93,16.6,541,90,451,jp
461,oilyoshi,DIAMOND IV,91,18.6,441,82,359,jp
462,tyataro,DIAMOND IV,88,10.8,435,47,388,jp
463,Mintchan,DIAMOND IV,88,16.8,131,22,109,jp
464,もしもボックス,DIAMOND IV,87,15.1,239,36,203,jp
465,Gifted,DIAMOND IV,87,14.5,235,34,201,jp
466,Barotte1,DIAMOND IV,87,15.2,210,32,178,jp
467,Orgap,DIAMOND IV,86,9.3,289,27,262,jp
468,Ashrin,DIAMOND IV,86,13.7,161,22,139,jp
469,七秒の記憶,DIAMOND IV,82,12.0,234,28,206,jp
470,lll LanPa lll,DIAMOND IV,80,12.6,382,48,334,jp
471,天下り常習者,DIAMOND IV,80,16.2,142,23,119,jp
472,Eudemon,DIAMOND IV,79,14.8,176,26,150,jp
473,じぇいわい,DIAMOND IV,77,16.5,297,49,248,jp
474,ふうせんネコ,DIAMOND IV,77,15.5,219,34,185,jp
475,カナヘイのおるか,DIAMOND IV,77,10.4,241,25,216,jp
476,On Your Left,DIAMOND IV,75,14.6,584,85,499,jp
477,我我我能c,DIAMOND IV,75,19.1,329,63,266,jp
478,Ryona,DIAMOND IV,75,11.7,520,61,459,jp
479,RaineSound,DIAMOND IV,75,19.4,283,55,228,jp
480,AZYC,DIAMOND IV,75,21.8,225,49,176,jp
481,銀色赤底の実,DIAMOND IV,75,14.0,350,49,301,jp
482,theend100,DIAMOND IV,75,11.3,388,44,344,jp
483,やなせ TKS,DIAMOND IV,75,16.3,263,43,220,jp
484,ハジラミ,DIAMOND IV,75,14.6,288,42,246,jp
485,チンChinn充電,DIAMOND IV,75,15.9,232,37,195,jp
486,wsb,DIAMOND IV,75,14.1,262,37,225,jp
487,四月は君のウソだ,DIAMOND IV,75,15.1,239,36,203,jp
488,lllIIllIIlllII,DIAMOND IV,75,14.6,246,36,210,jp
489,よてり,DIAMOND IV,75,22.0,159,35,124,jp
490,小太り中年大貫,DIAMOND IV,75,20.6,165,34,131,jp
491,hachi64,DIAMOND IV,75,12.4,274,34,240,jp
492,Inagibukit,DIAMOND IV,75,11.4,299,34,265,jp
493,アングリーチキン,DIAMOND IV,75,17.8,169,30,139,jp
494,hinekura,DIAMOND IV,75,14.8,189,28,161,jp
495,Fraternity,DIAMOND IV,75,14.3,195,28,167,jp
496,horoTFT,DIAMOND IV,75,10.0,269,27,242,jp
497,たまごのこまた,DIAMOND IV,75,14.5,179,26,153,jp
498,6456tft,DIAMOND IV,75,35.7,70,25,45,jp
499,E Z P Zzz,DIAMOND IV,75,19.7,127,25,102,jp
500,leben22,DIAMOND IV,75,18.1,138,25,113,jp
1,AFTV 꼴픽이,CHALLENGER I,1655,19.1,1013,194,819,kr
2,곰과제리2,CHALLENGER I,1627,20.2,312,63,249,kr
3,김린Or남친,CHALLENGER I,1503,18.0,890,160,730,kr
4,정동글2,CHALLENGER I,1452,18.6,327,61,266,kr
5,곰과제리,CHALLENGER I,1420,18.4,794,146,648,kr
6,정동글,CHALLENGER I,1408,17.8,594,106,488,kr
7,노마딕,CHALLENGER I,1341,17.6,636,112,524,kr
8,퐈피는잘못없어,CHALLENGER I,1339,17.5,1164,204,960,kr
9,홀애비2,CHALLENGER I,1259,18.7,991,185,806,kr
10,스트롱뽀송뽀송,CHALLENGER I,1243,15.0,941,141,800,kr
11,펠새로이,CHALLENGER I,1227,18.2,731,133,598,kr
12,AFTV 웃바,CHALLENGER I,1208,17.9,563,101,462,kr
13,My Paradise,CHALLENGER I,1186,23.6,725,171,554,kr
14,galaxy monster,CHALLENGER I,1183,12.8,507,65,442,kr
15,럭키체스777,CHALLENGER I,1142,13.4,673,90,583,kr
16,shungjinsoo2,CHALLENGER I,1141,16.8,457,77,380,kr
17,아기용1,CHALLENGER I,1135,19.9,1615,321,1294,kr
18,shungjinsoo,CHALLENGER I,1134,17.8,881,157,724,kr
19,알레 델리,CHALLENGER I,1125,22.9,279,64,215,kr
20,알맹승지,CHALLENGER I,1120,11.8,593,70,523,kr
21,체주미,CHALLENGER I,1119,17.8,303,54,249,kr
22,머리한입꼬리한입,CHALLENGER I,1108,16.3,1005,164,841,kr
23,난몰라,CHALLENGER I,1105,17.8,410,73,337,kr
24,두니주니,CHALLENGER I,1081,18.3,1294,237,1057,kr
25,포식자원툴,CHALLENGER I,1080,15.5,928,144,784,kr
26,청정민,CHALLENGER I,1077,14.1,1286,181,1105,kr
27,SanChess,CHALLENGER I,1072,16.8,552,93,459,kr
28,바삭한빵,CHALLENGER I,1068,18.4,441,81,360,kr
29,TZ 제리,CHALLENGER I,1050,14.7,605,89,516,kr
30,피노키훈,CHALLENGER I,1045,18.4,815,150,665,kr
31,깽 만,CHALLENGER I,1033,13.2,823,109,714,kr
32,기도메타777,CHALLENGER I,1028,13.7,328,45,283,kr
33,왜 나만 운없냐,CHALLENGER I,1021,18.0,338,61,277,kr
34,곰과제리3,CHALLENGER I,1018,16.1,391,63,328,kr
35,마스터 3,CHALLENGER I,1013,10.5,847,89,758,kr
36,Alle Deli,CHALLENGER I,1003,14.2,478,68,410,kr
37,Fiora TOP,CHALLENGER I,1001,12.4,619,77,542,kr
38,Park Eunbin,CHALLENGER I,993,17.1,462,79,383,kr
39,Gritor,CHALLENGER I,983,16.3,1257,205,1052,kr
40,화살 세례,CHALLENGER I,980,16.8,686,115,571,kr
41,펠 다,CHALLENGER I,976,23.5,391,92,299,kr
42,종자잇,CHALLENGER I,967,16.1,404,65,339,kr
43,Cherryon,CHALLENGER I,938,15.4,887,137,750,kr
44,축 꾸,CHALLENGER I,930,18.1,816,148,668,kr
45,카시장인 삿카시,CHALLENGER I,926,14.8,425,63,362,kr
46,최killing,CHALLENGER I,925,12.5,689,86,603,kr
47,IIIlllIIIlllII,CHALLENGER I,921,11.3,1321,150,1171,kr
48,김유Or,CHALLENGER I,898,16.6,457,76,381,kr
49,패트롤원툴,CHALLENGER I,895,17.2,640,110,530,kr
50,BAAMM,CHALLENGER I,889,18.7,1240,232,1008,kr
51,사랑해꿀아,CHALLENGER I,875,15.2,573,87,486,kr
52,끓인사발면,CHALLENGER I,870,19.5,374,73,301,kr
53,랑조췻,CHALLENGER I,849,11.5,1423,164,1259,kr
54,롤체고오수,CHALLENGER I,846,17.2,232,40,192,kr
55,안산시청,CHALLENGER I,845,17.2,534,92,442,kr
56,hiimg4nmi,CHALLENGER I,844,15.0,802,120,682,kr
57,안 졍,CHALLENGER I,844,16.9,356,60,296,kr
58,꽃피그,CHALLENGER I,842,18.4,282,52,230,kr
59,안지영,CHALLENGER I,841,18.3,339,62,277,kr
60,푸딩턱털낼름낼름,CHALLENGER I,832,19.6,322,63,259,kr
61,lxry,CHALLENGER I,832,14.6,213,31,182,kr
62,킨드레드블루그린,CHALLENGER I,812,17.2,785,135,650,kr
63,천득 Youtube,CHALLENGER I,812,16.3,404,66,338,kr
64,로자이어,CHALLENGER I,809,12.8,682,87,595,kr
65,prexis,CHALLENGER I,807,11.2,1047,117,930,kr
66,끓인사발면2,CHALLENGER I,807,24.2,211,51,160,kr
67,천 득,CHALLENGER I,801,14.5,401,58,343,kr
68,15조현지,CHALLENGER I,800,21.9,296,65,231,kr
69,귀여운나르자나,CHALLENGER I,799,22.6,618,140,478,kr
70,정동기리,CHALLENGER I,799,18.2,286,52,234,kr
71,궁뎅크니,CHALLENGER I,796,14.6,691,101,590,kr
72,시루시루해,CHALLENGER I,791,16.0,674,108,566,kr
73,지하닝2,CHALLENGER I,788,19.6,606,119,487,kr
74,TFT 너밤,CHALLENGER I,774,18.5,476,88,388,kr
75,Younna,CHALLENGER I,772,22.0,177,39,138,kr
76,woiwoer12,CHALLENGER I,771,16.4,934,153,781,kr
77,개 북,CHALLENGER I,771,18.1,414,75,339,kr
78,Eunso,CHALLENGER I,770,14.9,1019,152,867,kr
79,그레이스바라기,CHALLENGER I,769,14.7,300,44,256,kr
80,TFT Xion,CHALLENGER I,764,13.8,1125,155,970,kr
81,바위게줍기장인,CHALLENGER I,763,15.2,874,133,741,kr
82,현이야아아,CHALLENGER I,763,12.9,812,105,707,kr
83,패트롤원툴2,CHALLENGER I,760,14.9,678,101,577,kr
84,원도깨비,CHALLENGER I,757,14.7,504,74,430,kr
85,Everton FAN,CHALLENGER I,748,11.3,355,40,315,kr
86,AFTV 구루루,CHALLENGER I,746,14.9,1271,190,1081,kr
87,미어캣군,CHALLENGER I,744,13.4,417,56,361,kr
88,TZ 제리쌤,CHALLENGER I,744,16.0,293,47,246,kr
89,꼴픽이 Youtube,CHALLENGER I,740,21.5,172,37,135,kr
90,Keane Tft,CHALLENGER I,740,20.0,185,37,148,kr
91,제황산,CHALLENGER I,733,15.3,855,131,724,kr
92,Mongri,CHALLENGER I,732,16.4,1336,219,1117,kr
93,빅머니장사장,CHALLENGER I,731,17.9,441,79,362,kr
94,내가더사기얍,CHALLENGER I,730,15.6,508,79,429,kr
95,90972114del,CHALLENGER I,729,16.0,1008,161,847,kr
96,보이지않는기물,CHALLENGER I,728,18.2,467,85,382,kr
97,초보끼리합시다,CHALLENGER I,725,14.3,756,108,648,kr
98,찬란하고찬란하게,CHALLENGER I,724,12.3,1090,134,956,kr
99,전설의소라고동,CHALLENGER I,724,15.4,746,115,631,kr
100,종범1,CHALLENGER I,723,17.9,245,44,201,kr
101,대위 리정혁,CHALLENGER I,717,14.9,592,88,504,kr
102,Why do I live,CHALLENGER I,714,17.0,575,98,477,kr
103,코스모TV,CHALLENGER I,711,17.2,681,117,564,kr
104,버그활용법,CHALLENGER I,710,25.6,277,71,206,kr
105,AFTV로얄,CHALLENGER I,707,12.2,1066,130,936,kr
106,possible,CHALLENGER I,704,15.7,521,82,439,kr
107,옴팡이,CHALLENGER I,697,19.6,1484,291,1193,kr
108,고유나,CHALLENGER I,695,16.5,418,69,349,kr
109,Pnaz,CHALLENGER I,695,29.7,222,66,156,kr
110,알맹승지2,CHALLENGER I,695,10.3,456,47,409,kr
111,줘 너,CHALLENGER I,692,13.4,1045,140,905,kr
112,사회관,CHALLENGER I,683,12.7,937,119,818,kr
113,노래하는 쭌,CHALLENGER I,680,10.7,783,84,699,kr
114,오면 딴다,CHALLENGER I,679,13.4,781,105,676,kr
115,챌린저라닉변함,CHALLENGER I,676,11.5,866,100,766,kr
116,포포도쓰,CHALLENGER I,673,14.3,813,116,697,kr
117,Blanker,CHALLENGER I,672,17.7,761,135,626,kr
118,TZ 코그멍,CHALLENGER I,671,16.8,423,71,352,kr
119,조치타치,CHALLENGER I,663,10.5,791,83,708,kr
120,Dosu,CHALLENGER I,663,13.8,276,38,238,kr
121,WE CAN WlN,CHALLENGER I,661,17.4,536,93,443,kr
122,김음주,CHALLENGER I,657,14.2,762,108,654,kr
123,k1moddi,CHALLENGER I,653,18.4,212,39,173,kr
124,혹시그거아냐,CHALLENGER I,651,14.0,385,54,331,kr
125,귀여운쫑이자나,CHALLENGER I,646,15.8,808,128,680,kr
126,참새년,CHALLENGER I,645,13.9,546,76,470,kr
127,봄날이갓두,CHALLENGER I,635,11.8,662,78,584,kr
128,곽예림,CHALLENGER I,634,12.3,950,117,833,kr
129,남자는코멧,CHALLENGER I,634,13.1,389,51,338,kr
130,삐진범,CHALLENGER I,634,15.0,240,36,204,kr
131,체스보이민다빈,CHALLENGER I,630,17.3,1296,224,1072,kr
132,엠브로돈까스,CHALLENGER I,628,18.0,1486,267,1219,kr
133,DouYu1958671,CHALLENGER I,627,15.1,357,54,303,kr
134,길막장인,CHALLENGER I,626,18.0,406,73,333,kr
135,유후a,CHALLENGER I,625,17.0,589,100,489,kr
136,탑하겠습니다,CHALLENGER I,624,17.8,359,64,295,kr
137,게므론,CHALLENGER I,620,9.7,910,88,822,kr
138,주나식,CHALLENGER I,619,17.5,240,42,198,kr
139,조치타칫쿵칫타,CHALLENGER I,619,9.7,401,39,362,kr
140,YunHyeonSik,CHALLENGER I,618,12.6,364,46,318,kr
141,똥꼬에펜타킬,CHALLENGER I,618,11.4,404,46,358,kr
142,AFTV 깔창부린,CHALLENGER I,617,16.2,1732,281,1451,kr
143,욕한번채금한번,CHALLENGER I,615,19.4,663,129,534,kr
144,정밍호짱짱걸,CHALLENGER I,614,13.9,980,136,844,kr
145,로또야놀자,CHALLENGER I,613,13.9,953,133,820,kr
146,치약소년,CHALLENGER I,613,15.5,251,39,212,kr
147,우디르디르,CHALLENGER I,609,15.0,648,97,551,kr
148,dexxa,CHALLENGER I,608,11.2,1207,135,1072,kr
149,Trust me only,CHALLENGER I,608,11.1,470,52,418,kr
150,이Or름,CHALLENGER I,607,11.5,973,112,861,kr
151,지니쁘미,CHALLENGER I,607,15.9,271,43,228,kr
152,Art DrucKer,CHALLENGER I,606,14.5,691,100,591,kr
153,불꽃자잇 사생팬,CHALLENGER I,602,14.6,397,58,339,kr
154,멍청아린,CHALLENGER I,601,14.1,580,82,498,kr
155,베가알쓰리짱,CHALLENGER I,598,13.6,660,90,570,kr
156,혹혹훅훅훅,CHALLENGER I,596,13.1,320,42,278,kr
157,개할거없네,CHALLENGER I,593,15.1,601,91,510,kr
158,초식판다,CHALLENGER I,592,13.1,880,115,765,kr
159,정 찰 돼,CHALLENGER I,591,12.2,433,53,380,kr
160,깡 백,CHALLENGER I,590,17.3,573,99,474,kr
161,TFT어캣,CHALLENGER I,590,17.1,274,47,227,kr
162,FateGrand5rder,CHALLENGER I,586,9.3,1117,104,1013,kr
163,뱅 탁,CHALLENGER I,586,12.3,496,61,435,kr
164,Viento 9,CHALLENGER I,584,14.1,469,66,403,kr
165,AF HappyVirus,CHALLENGER I,583,19.1,278,53,225,kr
166,진이애완동물,CHALLENGER I,582,15.2,488,74,414,kr
167,아갈머리를콰악,CHALLENGER I,581,21.9,201,44,157,kr
168,last40ne,CHALLENGER I,578,19.4,139,27,112,kr
169,팬더랑놀자,CHALLENGER I,577,14.2,564,80,484,kr
170,멀보노자슥아,CHALLENGER I,576,13.3,730,97,633,kr
171,크 우,CHALLENGER I,576,16.4,377,62,315,kr
172,깔딱깔딱,CHALLENGER I,575,18.0,784,141,643,kr
173,소브로,CHALLENGER I,573,15.9,371,59,312,kr
174,르제스키,CHALLENGER I,571,17.3,578,100,478,kr
175,달삼이빡빡라이즈,CHALLENGER I,571,14.3,620,89,531,kr
176,요들시너지 룰루,CHALLENGER I,569,13.9,223,31,192,kr
177,s3unguk,CHALLENGER I,566,14.7,545,80,465,kr
178,꽝 백,CHALLENGER I,565,15.7,497,78,419,kr
179,똥줄타노스,CHALLENGER I,565,17.4,270,47,223,kr
180,코리안조커테드창,CHALLENGER I,563,17.6,279,49,230,kr
181,진 형,CHALLENGER I,563,15.4,220,34,186,kr
182,proooa,CHALLENGER I,561,16.2,512,83,429,kr
183,AFTV 오대,CHALLENGER I,560,16.1,1417,228,1189,kr
184,미래지향사나이,CHALLENGER I,559,15.8,634,100,534,kr
185,미소왕,CHALLENGER I,558,13.8,629,87,542,kr
186,호랑이찌찌젖짜기,CHALLENGER I,557,15.5,522,81,441,kr
187,2000 11 12,CHALLENGER I,556,18.0,278,50,228,kr
188,초콜렛공장,CHALLENGER I,555,12.6,348,44,304,kr
189,V 6 6 V,CHALLENGER I,554,12.4,660,82,578,kr
190,최 석,CHALLENGER I,553,22.3,193,43,150,kr
191,Teufelhaft,CHALLENGER I,553,13.9,303,42,261,kr
192,The 진감,CHALLENGER I,552,13.1,1258,165,1093,kr
193,오지마요제발,CHALLENGER I,552,11.4,990,113,877,kr
194,yunhyunsik,CHALLENGER I,550,17.9,347,62,285,kr
195,Daeju imp,CHALLENGER I,550,9.8,429,42,387,kr
196,비비고김치,CHALLENGER I,550,8.9,459,41,418,kr
197,쥬상이,CHALLENGER I,546,14.3,300,43,257,kr
198,I Go Challenger,CHALLENGER I,545,14.7,367,54,313,kr
199,롤토체스 강의,CHALLENGER I,543,17.5,251,44,207,kr
200,물 배,CHALLENGER I,542,13.1,602,79,523,kr
201,Dpr live A,CHALLENGER I,542,14.3,175,25,150,kr
202,Roik,CHALLENGER I,539,28.6,126,36,90,kr
203,잉꾸잉꾸잉꾸,CHALLENGER I,538,15.2,662,101,561,kr
204,놀릴준비 끝,CHALLENGER I,538,17.3,243,42,201,kr
205,뚱인라구여,CHALLENGER I,537,14.9,699,104,595,kr
206,땅콩달콤,CHALLENGER I,537,15.0,499,75,424,kr
207,Danny 선생님,CHALLENGER I,530,13.2,637,84,553,kr
208,LlMITED,CHALLENGER I,530,12.4,169,21,148,kr
209,신낫상우,CHALLENGER I,529,16.6,477,79,398,kr
210,고고브라덜,CHALLENGER I,528,15.1,636,96,540,kr
211,대깨포식자,CHALLENGER I,528,13.7,437,60,377,kr
212,전 짝 시,CHALLENGER I,528,12.8,428,55,373,kr
213,백석대학교,CHALLENGER I,525,16.7,335,56,279,kr
214,항상던지지마라,CHALLENGER I,523,15.8,328,52,276,kr
215,바닐라공장,CHALLENGER I,523,13.4,239,32,207,kr
216,TFT Sloth,CHALLENGER I,521,15.4,855,132,723,kr
217,칼바람 할아버지,CHALLENGER I,520,18.8,250,47,203,kr
218,나혼산,CHALLENGER I,520,15.3,301,46,255,kr
219,02Mania,CHALLENGER I,519,17.4,321,56,265,kr
220,세번째차인달삼,CHALLENGER I,518,17.2,899,155,744,kr
221,검은비,CHALLENGER I,518,17.2,343,59,284,kr
222,sunken,CHALLENGER I,514,16.6,728,121,607,kr
223,육류만,CHALLENGER I,514,16.3,590,96,494,kr
224,왕 자,CHALLENGER I,514,12.7,584,74,510,kr
225,부스커,CHALLENGER I,513,11.4,734,84,650,kr
226,오에리,CHALLENGER I,513,13.6,369,50,319,kr
227,23세 홍삼길,CHALLENGER I,512,13.6,689,94,595,kr
228,샐러리라면,CHALLENGER I,512,15.4,494,76,418,kr
229,안하기로했자나,CHALLENGER I,512,16.4,305,50,255,kr
230,TFT홍스타,CHALLENGER I,511,25.5,149,38,111,kr
231,설화산 티모,CHALLENGER I,510,13.0,324,42,282,kr
232,배틀그라운드좋아,CHALLENGER I,509,12.5,1216,152,1064,kr
233,스펨선비,CHALLENGER I,509,12.3,562,69,493,kr
234,콩콩이는,CHALLENGER I,509,19.0,274,52,222,kr
235,귀여운피즈자나,CHALLENGER I,508,13.3,699,93,606,kr
236,발신짱,CHALLENGER I,508,11.8,696,82,614,kr
237,빠꾸 없이 빠끄,CHALLENGER I,508,9.7,710,69,641,kr
238,백시니,CHALLENGER I,508,13.4,463,62,401,kr
239,눈부신 날,CHALLENGER I,508,15.9,340,54,286,kr
240,더 비상한다,CHALLENGER I,508,13.0,362,47,315,kr
241,내가 미안훼,CHALLENGER I,508,16.9,189,32,157,kr
242,익 명 아 재,CHALLENGER I,507,19.4,614,119,495,kr
243,지하닝여자친구,CHALLENGER I,507,18.1,293,53,240,kr
244,illilililli1,CHALLENGER I,507,15.5,239,37,202,kr
245,스킬 효과,CHALLENGER I,506,18.3,989,181,808,kr
246,사뢍해2,CHALLENGER I,506,15.0,481,72,409,kr
247,개인랭버스기사,CHALLENGER I,505,14.7,586,86,500,kr
248,터틀 킴,CHALLENGER I,505,12.6,549,69,480,kr
249,설레는마음,CHALLENGER I,505,16.6,386,64,322,kr
250,TFT뚝배기수집가,CHALLENGER I,503,13.1,643,84,559,kr
251,팹시만 콜라,CHALLENGER I,503,15.7,313,49,264,kr
252,노블마인드,CHALLENGER I,502,12.4,450,56,394,kr
253,체스장인 렝가,CHALLENGER I,502,15.2,316,48,268,kr
254,재 온,CHALLENGER I,501,16.1,279,45,234,kr
255,Dosu0,CHALLENGER I,501,18.2,203,37,166,kr
256,AFTV 신부형,CHALLENGER I,500,10.3,1108,114,994,kr
257,System2,CHALLENGER I,500,22.8,359,82,277,kr
258,당 언,CHALLENGER I,499,14.8,1094,162,932,kr
259,하와와 아담,CHALLENGER I,499,18.6,636,118,518,kr
260,illililillili,CHALLENGER I,496,21.2,137,29,108,kr
261,오우거 돌주먹,CHALLENGER I,494,15.7,560,88,472,kr
262,지하닝youtube,CHALLENGER I,494,15.0,433,65,368,kr
263,모델한당,CHALLENGER I,494,25.0,188,47,141,kr
264,총잡이그립다,CHALLENGER I,494,19.3,212,41,171,kr
265,EMP 모구,CHALLENGER I,490,15.8,425,67,358,kr
266,원딜 좀 키워주자,CHALLENGER I,490,19.9,261,52,209,kr
267,프리맥,CHALLENGER I,489,14.2,1019,145,874,kr
268,모지리궁상,CHALLENGER I,489,15.4,382,59,323,kr
269,갱뱅후,CHALLENGER I,488,14.6,520,76,444,kr
270,LAD 1,CHALLENGER I,488,13.1,527,69,458,kr
271,검은눈썹,CHALLENGER I,488,12.5,361,45,316,kr
272,정말사랑해요,CHALLENGER I,485,9.3,568,53,515,kr
273,그랜드킴,CHALLENGER I,484,15.3,753,115,638,kr
274,콘쓰탄쯔,CHALLENGER I,484,13.8,412,57,355,kr
275,TR Zombi,CHALLENGER I,484,24.5,163,40,123,kr
276,Ignited,CHALLENGER I,483,12.4,508,63,445,kr
277,나랑랑이,CHALLENGER I,483,13.6,405,55,350,kr
278,꼐 속,CHALLENGER I,482,14.6,658,96,562,kr
279,heals,CHALLENGER I,482,16.7,454,76,378,kr
280,Arsenal92,CHALLENGER I,482,11.6,620,72,548,kr
281,이집트신화,CHALLENGER I,481,12.8,701,90,611,kr
282,TZ 근영,CHALLENGER I,481,18.9,312,59,253,kr
283,정말싫어해요,CHALLENGER I,481,9.3,365,34,331,kr
284,TFT 시리,CHALLENGER I,480,14.5,821,119,702,kr
285,금빵갓,CHALLENGER I,480,12.7,495,63,432,kr
286,A Prosecutor,CHALLENGER I,480,19.0,289,55,234,kr
287,춘드레드,CHALLENGER I,480,35.5,152,54,98,kr
288,장난감병정z,CHALLENGER I,479,15.9,832,132,700,kr
289,이딴겜해주지마,CHALLENGER I,479,40.2,112,45,67,kr
290,AFTV 빠바박,CHALLENGER I,476,13.8,1548,213,1335,kr
291,카리조마,CHALLENGER I,473,17.7,508,90,418,kr
292,neverf0rgOt,CHALLENGER I,472,12.3,658,81,577,kr
293,홀애비따까리,CHALLENGER I,471,21.1,166,35,131,kr
294,지하닝팬,CHALLENGER I,470,16.8,304,51,253,kr
295,설로재,CHALLENGER I,470,17.7,141,25,116,kr
296,현이야아,CHALLENGER I,460,15.4,207,32,175,kr
297,이렇게 좋은 날,CHALLENGER I,446,14.1,546,77,469,kr
298,AFTV 백기사,CHALLENGER I,418,22.1,263,58,205,kr
299,hyuk1,CHALLENGER I,412,16.7,330,55,275,kr
300,FT아일랜드,CHALLENGER I,374,15.2,630,96,534,kr
301,아 갓 씨,"GRANDMASTER I
G",515,14.2,492,70,422,kr
302,시즌2대한민국1등,"GRANDMASTER I
G",513,15.7,517,81,436,kr
303,앗 추워,"GRANDMASTER I
G",505,14.6,717,105,612,kr
304,쓰레쉬핵초고수,"GRANDMASTER I
G",489,14.3,784,112,672,kr
305,TFT HAGWAN,"GRANDMASTER I
G",478,12.0,474,57,417,kr
306,나카모리 아키나,"GRANDMASTER I
G",473,12.7,545,69,476,kr
307,지르반4살,"GRANDMASTER I
G",470,17.1,549,94,455,kr
308,콩대congdae,"GRANDMASTER I
G",470,17.3,335,58,277,kr
309,Schakal,"GRANDMASTER I
G",467,13.1,689,90,599,kr
310,hyuk2,"GRANDMASTER I
G",464,12.9,559,72,487,kr
311,귀 찬,"GRANDMASTER I
G",461,15.6,449,70,379,kr
312,without some,"GRANDMASTER I
G",461,15.2,211,32,179,kr
313,싱글벙글얍,"GRANDMASTER I
G",452,13.4,926,124,802,kr
314,칸체스TV,"GRANDMASTER I
G",451,13.3,413,55,358,kr
315,준디네,"GRANDMASTER I
G",447,11.2,1179,132,1047,kr
316,ComeBack,"GRANDMASTER I
G",447,13.8,333,46,287,kr
317,장주현,"GRANDMASTER I
G",444,19.6,224,44,180,kr
318,문재앙조국임종석,"GRANDMASTER I
G",440,13.4,269,36,233,kr
319,롤체하러왓어요,"GRANDMASTER I
G",435,15.4,511,79,432,kr
320,대께빛,"GRANDMASTER I
G",433,14.5,942,137,805,kr
321,용국이꼬츄,"GRANDMASTER I
G",430,11.0,574,63,511,kr
322,가면 따냐,"GRANDMASTER I
G",430,15.2,343,52,291,kr
323,토토로11,"GRANDMASTER I
G",427,11.7,734,86,648,kr
324,홍시띠,"GRANDMASTER I
G",427,17.8,411,73,338,kr
325,멧돼지,"GRANDMASTER I
G",426,13.9,886,123,763,kr
326,Jun Club,"GRANDMASTER I
G",425,25.6,156,40,116,kr
327,AFTV 제로겟,"GRANDMASTER I
G",423,9.2,1714,158,1556,kr
328,하낫 둘 숨었다,"GRANDMASTER I
G",422,20.6,160,33,127,kr
329,마법공학소라고동,"GRANDMASTER I
G",419,19.7,579,114,465,kr
330,그냥시로,"GRANDMASTER I
G",418,17.5,594,104,490,kr
331,히릿싸이마세,"GRANDMASTER I
G",416,14.8,284,42,242,kr
332,오늘도좋고,"GRANDMASTER I
G",415,11.9,513,61,452,kr
333,롤접으면여친생김,"GRANDMASTER I
G",414,17.9,312,56,256,kr
334,미리리미리3,"GRANDMASTER I
G",414,18.9,180,34,146,kr
335,나만강아지없어힝,"GRANDMASTER I
G",412,14.5,392,57,335,kr
336,AFTV 빠따,"GRANDMASTER I
G",410,16.9,409,69,340,kr
337,데굴데굴,"GRANDMASTER I
G",410,21.1,242,51,191,kr
338,성록썬더,"GRANDMASTER I
G",409,16.5,334,55,279,kr
339,도리찡,"GRANDMASTER I
G",408,16.0,524,84,440,kr
340,선대군,"GRANDMASTER I
G",408,13.1,458,60,398,kr
341,TFT ELLE,"GRANDMASTER I
G",408,16.2,365,59,306,kr
342,불타는당근,"GRANDMASTER I
G",406,13.1,429,56,373,kr
343,LADLAB,"GRANDMASTER I
G",401,13.2,555,73,482,kr
344,X Videos 방금봄,"GRANDMASTER I
G",400,14.3,998,143,855,kr
345,90980619del,"GRANDMASTER I
G",400,16.8,653,110,543,kr
346,모리가와,"GRANDMASTER I
G",399,11.8,508,60,448,kr
347,인생을사는조진재,"GRANDMASTER I
G",398,14.5,317,46,271,kr
348,울집냥이양아치,"GRANDMASTER I
G",397,14.3,489,70,419,kr
349,어런이222,"GRANDMASTER I
G",396,13.6,645,88,557,kr
350,그저피할뿐,"GRANDMASTER I
G",395,18.6,280,52,228,kr
351,쿨한토니,"GRANDMASTER I
G",393,15.6,315,49,266,kr
352,이라로랑,"GRANDMASTER I
G",392,11.4,971,111,860,kr
353,불빠따쩝쩝이,"GRANDMASTER I
G",392,16.1,461,74,387,kr
354,DelisJin,"GRANDMASTER I
G",389,17.4,264,46,218,kr
355,임육뎍,"GRANDMASTER I
G",388,14.8,546,81,465,kr
356,검눈이,"GRANDMASTER I
G",388,20.1,149,30,119,kr
357,TOP하겠습니다,"GRANDMASTER I
G",386,17.1,526,90,436,kr
358,이순방,"GRANDMASTER I
G",383,11.5,870,100,770,kr
359,갱구찡,"GRANDMASTER I
G",381,14.5,660,96,564,kr
360,SsGoi,"GRANDMASTER I
G",380,16.7,186,31,155,kr
361,빠 꿈,"GRANDMASTER I
G",377,16.2,321,52,269,kr
362,한겜하고말사이에,"GRANDMASTER I
G",375,14.2,762,108,654,kr
363,볼베3성주셈,"GRANDMASTER I
G",374,14.9,853,127,726,kr
364,Lalisa Manobal,"GRANDMASTER I
G",374,20.3,207,42,165,kr
365,WAF부케,"GRANDMASTER I
G",374,22.5,142,32,110,kr
366,너말이야너1,"GRANDMASTER I
G",372,13.1,521,68,453,kr
367,김준용1,"GRANDMASTER I
G",371,16.3,387,63,324,kr
368,WAF,"GRANDMASTER I
G",371,26.1,188,49,139,kr
369,종 구 팔,"GRANDMASTER I
G",370,17.4,1038,181,857,kr
370,고추니 Tv,"GRANDMASTER I
G",370,13.0,886,115,771,kr
371,미리리미리2,"GRANDMASTER I
G",369,13.3,270,36,234,kr
372,JJ오렌지ll,"GRANDMASTER I
G",367,15.0,755,113,642,kr
373,초급자우대,"GRANDMASTER I
G",367,13.9,180,25,155,kr
374,기생벌레,"GRANDMASTER I
G",366,18.8,234,44,190,kr
375,서우깡,"GRANDMASTER I
G",361,17.8,353,63,290,kr
376,협 착,"GRANDMASTER I
G",361,17.1,240,41,199,kr
377,20세기배추,"GRANDMASTER I
G",357,14.9,572,85,487,kr
378,KIMSEONIL,"GRANDMASTER I
G",357,16.5,254,42,212,kr
379,용욱아 물좀,"GRANDMASTER I
G",357,21.3,122,26,96,kr
380,진스턴,"GRANDMASTER I
G",356,12.2,806,98,708,kr
381,정글뭐라하면던짐,"GRANDMASTER I
G",354,13.1,837,110,727,kr
382,TZ 홀리,"GRANDMASTER I
G",354,19.9,317,63,254,kr
383,트위치 yuuubin,"GRANDMASTER I
G",353,13.6,295,40,255,kr
384,병만이네꽃등심살,"GRANDMASTER I
G",352,17.7,355,63,292,kr
385,두가지,"GRANDMASTER I
G",351,11.5,678,78,600,kr
386,롤토체스asdf,"GRANDMASTER I
G",350,23.7,118,28,90,kr
387,고양이무한리필,"GRANDMASTER I
G",342,15.3,267,41,226,kr
388,이류환,"GRANDMASTER I
G",342,13.4,232,31,201,kr
389,범 원,"GRANDMASTER I
G",335,20.3,138,28,110,kr
390,돼지꼬리원숭이,"GRANDMASTER I
G",333,20.6,228,47,181,kr
391,빛보다빠른빤스런,"GRANDMASTER I
G",331,14.7,238,35,203,kr
392,밀턴프리드먼,"GRANDMASTER I
G",330,13.3,563,75,488,kr
393,홈런볼리베어,"GRANDMASTER I
G",330,18.8,314,59,255,kr
394,말파 3성,"GRANDMASTER I
G",329,13.1,540,71,469,kr
395,제토체스,"GRANDMASTER I
G",329,19.4,258,50,208,kr
396,야쿨르트,"GRANDMASTER I
G",328,13.5,438,59,379,kr
397,Teukhan,"GRANDMASTER I
G",326,14.0,1058,148,910,kr
398,bin physical,"GRANDMASTER I
G",325,13.1,685,90,595,kr
399,지하닝,"GRANDMASTER I
G",325,33.6,122,41,81,kr
400,뀽탱이,"GRANDMASTER I
G",324,16.0,708,113,595,kr
401,자니자니lol,"GRANDMASTER I
G",324,15.1,536,81,455,kr
402,Khanchess,"GRANDMASTER I
G",324,18.0,305,55,250,kr
403,Mid Hernia,"GRANDMASTER I
G",322,15.2,343,52,291,kr
404,4px,"GRANDMASTER I
G",322,23.1,208,48,160,kr
405,AFTV 진혼곡2,"GRANDMASTER I
G",319,17.0,300,51,249,kr
406,고릴라머리,"GRANDMASTER I
G",318,13.9,541,75,466,kr
407,secondMVP,"GRANDMASTER I
G",317,17.9,479,86,393,kr
408,경진이,"GRANDMASTER I
G",317,16.3,412,67,345,kr
409,허른이,"GRANDMASTER I
G",317,12.8,501,64,437,kr
410,hide on bupyeong,"GRANDMASTER I
G",316,16.0,438,70,368,kr
411,족발당수,"GRANDMASTER I
G",313,18.9,159,30,129,kr
412,전기시너지,"GRANDMASTER I
G",311,15.5,543,84,459,kr
413,AFTV빙이,"GRANDMASTER I
G",311,13.7,606,83,523,kr
414,입벌려갱들어간다,"GRANDMASTER I
G",310,13.6,609,83,526,kr
415,탈맹은지능순이져,"GRANDMASTER I
G",310,12.8,273,35,238,kr
416,언더파치고싶엉,"GRANDMASTER I
G",308,16.6,290,48,242,kr
417,질판감정소모안함,"GRANDMASTER I
G",307,18.7,844,158,686,kr
418,덛니마스터,"GRANDMASTER I
G",307,12.2,574,70,504,kr
419,참새년2,"GRANDMASTER I
G",307,21.7,166,36,130,kr
420,롱지호,"GRANDMASTER I
G",306,16.0,556,89,467,kr
421,TFT 1436,"GRANDMASTER I
G",306,15.0,266,40,226,kr
422,따대남,"GRANDMASTER I
G",305,16.9,543,92,451,kr
423,Bongo Bong,"GRANDMASTER I
G",305,14.5,289,42,247,kr
424,AffogaT0,"GRANDMASTER I
G",304,16.1,446,72,374,kr
425,수원 나무늘보,"GRANDMASTER I
G",304,17.1,275,47,228,kr
426,한남 이달룬,"GRANDMASTER I
G",303,15.9,497,79,418,kr
427,한가윤,"GRANDMASTER I
G",300,18.5,151,28,123,kr
428,빵상신,"GRANDMASTER I
G",299,17.0,453,77,376,kr
429,옛 섬,"GRANDMASTER I
G",298,14.1,561,79,482,kr
430,롤체실력겜,"GRANDMASTER I
G",298,15.3,444,68,376,kr
431,공주만의깃털기사,"GRANDMASTER I
G",297,13.2,408,54,354,kr
432,리스망,"GRANDMASTER I
G",295,12.2,713,87,626,kr
433,연변 소연수,"GRANDMASTER I
G",292,14.9,1521,227,1294,kr
434,밥똥롤체,"GRANDMASTER I
G",291,17.5,691,121,570,kr
435,OHCLADDAB,"GRANDMASTER I
G",291,14.6,213,31,182,kr
436,하룽룽이,"GRANDMASTER I
G",290,14.6,676,99,577,kr
437,심해는누누해,"GRANDMASTER I
G",290,19.3,378,73,305,kr
438,소크라테스v,"GRANDMASTER I
G",290,17.9,323,58,265,kr
439,miguk,"GRANDMASTER I
G",289,19.1,194,37,157,kr
440,궁디파,"GRANDMASTER I
G",289,15.5,238,37,201,kr
441,루 윈,"GRANDMASTER I
G",288,23.0,174,40,134,kr
442,프로젝트마스타이,"GRANDMASTER I
G",286,11.7,588,69,519,kr
443,흑to the형,"GRANDMASTER I
G",284,13.5,304,41,263,kr
444,헤카림버스,"GRANDMASTER I
G",283,12.8,296,38,258,kr
445,4픽얼굴벨코즈,"GRANDMASTER I
G",281,15.8,494,78,416,kr
446,시나몬 국어,"GRANDMASTER I
G",279,13.6,603,82,521,kr
447,야바토코,"GRANDMASTER I
G",278,13.4,566,76,490,kr
448,벤치110키로,"GRANDMASTER I
G",277,19.6,281,55,226,kr
449,야 연,"GRANDMASTER I
G",275,12.2,775,95,680,kr
450,정신이있니없니,"GRANDMASTER I
G",275,14.6,158,23,135,kr
451,냥냥권 고수,"GRANDMASTER I
G",273,14.6,1012,148,864,kr
452,tV motolora,"GRANDMASTER I
G",270,7.8,1303,101,1202,kr
453,흐엉눈물나,"GRANDMASTER I
G",268,15.7,325,51,274,kr
454,c cup,"GRANDMASTER I
G",267,14.5,392,57,335,kr
455,퓨시아,"GRANDMASTER I
G",267,13.2,136,18,118,kr
456,싸ECo,"GRANDMASTER I
G",266,14.3,530,76,454,kr
457,저주받은 캐리어,"GRANDMASTER I
G",265,12.3,593,73,520,kr
458,꿀항아리,"GRANDMASTER I
G",265,14.5,366,53,313,kr
459,호라파동,"GRANDMASTER I
G",265,19.0,200,38,162,kr
460,AFTV빙이저격수,"GRANDMASTER I
G",265,12.3,284,35,249,kr
461,오공 손,"GRANDMASTER I
G",262,16.2,814,132,682,kr
462,DearMemory,"GRANDMASTER I
G",261,15.6,551,86,465,kr
463,ChoRok,"GRANDMASTER I
G",261,15.6,257,40,217,kr
464,버버니,"GRANDMASTER I
G",261,24.3,140,34,106,kr
465,Autochesser,"GRANDMASTER I
G",260,13.8,442,61,381,kr
466,RICOH,"GRANDMASTER I
G",260,21.2,207,44,163,kr
467,무질량,"GRANDMASTER I
G",257,15.1,405,61,344,kr
468,지하닝3,"GRANDMASTER I
G",257,14.7,381,56,325,kr
469,닭가슴살먹고싶어,"GRANDMASTER I
G",257,17.0,324,55,269,kr
470,입털면찾아서죽임,"GRANDMASTER I
G",257,13.2,227,30,197,kr
471,Arky,"GRANDMASTER I
G",255,13.3,1093,145,948,kr
472,피리 부는 누누,"GRANDMASTER I
G",255,19.3,331,64,267,kr
473,why do i live2,"GRANDMASTER I
G",255,17.1,170,29,141,kr
474,saw and see,"GRANDMASTER I
G",254,14.0,534,75,459,kr
475,호감형스킬샷,"GRANDMASTER I
G",254,21.6,134,29,105,kr
476,제이삽,"GRANDMASTER I
G",253,11.2,837,94,743,kr
477,롤토체스 BOT 1,"GRANDMASTER I
G",251,16.7,389,65,324,kr
478,집사야 나 츄르줘,"GRANDMASTER I
G",250,14.4,570,82,488,kr
479,eunje0ng,"GRANDMASTER I
G",250,12.4,613,76,537,kr
480,Ayaka,"GRANDMASTER I
G",250,15.3,477,73,404,kr
481,뭉미오,"GRANDMASTER I
G",250,9.7,690,67,623,kr
482,로리고수,"GRANDMASTER I
G",248,14.6,473,69,404,kr
483,귀족찡,"GRANDMASTER I
G",245,22.6,164,37,127,kr
484,김도진이,"GRANDMASTER I
G",245,19.0,137,26,111,kr
485,Javacity Coffee,"GRANDMASTER I
G",244,17.5,228,40,188,kr
486,WF graybibimbap,"GRANDMASTER I
G",242,12.6,501,63,438,kr
487,2라2성,"GRANDMASTER I
G",240,16.8,381,64,317,kr
488,ITHERAEL,"GRANDMASTER I
G",238,13.9,684,95,589,kr
489,TFT 빠코,"GRANDMASTER I
G",238,16.6,403,67,336,kr
490,Spider,"GRANDMASTER I
G",238,13.6,428,58,370,kr
491,부산대 신의주,"GRANDMASTER I
G",238,12.4,420,52,368,kr
492,AP Innovaticn,"GRANDMASTER I
G",235,15.4,272,42,230,kr
493,고수민이,"GRANDMASTER I
G",234,17.3,365,63,302,kr
494,카포포카,"GRANDMASTER I
G",234,13.8,392,54,338,kr
495,Seonghun96,"GRANDMASTER I
G",233,12.6,507,64,443,kr
496,메로나공장,"GRANDMASTER I
G",233,13.9,202,28,174,kr
497,다솜찡,"GRANDMASTER I
G",231,13.8,260,36,224,kr
498,벽 선마 애니비아,"GRANDMASTER I
G",230,16.2,475,77,398,kr
499,TZ제리2,"GRANDMASTER I
G",230,16.2,160,26,134,kr
500,파괴의신노틸러스,"GRANDMASTER I
G",229,11.5,817,94,723,kr
1,Tewesineitor,CHALLENGER I,1498,29.1,306,89,217,lan
2,akalyzer,CHALLENGER I,1271,26.8,687,184,503,lan
3,Rayio,CHALLENGER I,1200,23.0,923,212,711,lan
4,Líon,CHALLENGER I,1144,20.5,552,113,439,lan
5,SákuraHana,CHALLENGER I,934,32.9,219,72,147,lan
6,CarryMe Akashi,CHALLENGER I,931,20.4,481,98,383,lan
7,Crycer,CHALLENGER I,911,29.9,301,90,211,lan
8,Yami Laicus,CHALLENGER I,896,27.7,303,84,219,lan
9,Quantum8,CHALLENGER I,896,23.4,282,66,216,lan
10,bite of destiny,CHALLENGER I,884,21.4,519,111,408,lan
11,GhoStorm,CHALLENGER I,865,21.0,404,85,319,lan
12,NVS Bowen,CHALLENGER I,859,20.1,329,66,263,lan
13,xBjaker,CHALLENGER I,750,20.8,307,64,243,lan
14,Cerealito,CHALLENGER I,707,18.3,405,74,331,lan
15,NVS Bowi,CHALLENGER I,685,23.1,242,56,186,lan
16,Dal,CHALLENGER I,672,19.3,362,70,292,lan
17,Ch1wy,CHALLENGER I,651,14.1,733,103,630,lan
18,KilljoyMex,CHALLENGER I,645,22.9,240,55,185,lan
19,Redmoonwolf,CHALLENGER I,610,12.1,346,42,304,lan
20,lmlWarCrY,CHALLENGER I,609,21.3,296,63,233,lan
21,MyzteryAlex,CHALLENGER I,582,12.5,943,118,825,lan
22,Dlanor,CHALLENGER I,550,21.0,442,93,349,lan
23,PipoMaster,CHALLENGER I,538,22.4,303,68,235,lan
24,KiraDessu,CHALLENGER I,509,23.0,400,92,308,lan
25,No soy exoor,CHALLENGER I,508,25.0,172,43,129,lan
26,itken,CHALLENGER I,504,16.5,997,165,832,lan
27,MaRiO bRoS,CHALLENGER I,499,17.8,766,136,630,lan
28,Exus,CHALLENGER I,491,21.7,276,60,216,lan
29,AztecMx,CHALLENGER I,475,13.4,238,32,206,lan
30,2D Jaro,CHALLENGER I,471,23.8,755,180,575,lan
31,QuiMi,CHALLENGER I,467,20.6,359,74,285,lan
32,7DS HyperSpace,CHALLENGER I,466,21.7,1045,227,818,lan
33,Quántum,CHALLENGER I,462,23.4,158,37,121,lan
34,ianakin7,CHALLENGER I,457,18.2,779,142,637,lan
35,RiftHerald,CHALLENGER I,456,17.9,207,37,170,lan
36,Garto Ward,CHALLENGER I,436,17.3,318,55,263,lan
37,Mr Mugui,CHALLENGER I,423,17.2,1015,175,840,lan
38,andmont,CHALLENGER I,418,19.7,264,52,212,lan
39,TftAcademy,CHALLENGER I,413,12.9,548,71,477,lan
40,melizaX,CHALLENGER I,412,17.6,336,59,277,lan
41,Soul 1,CHALLENGER I,407,23.4,256,60,196,lan
42,Lysıthea,CHALLENGER I,400,23.2,371,86,285,lan
43,shiry,CHALLENGER I,394,19.8,273,54,219,lan
44,Hi im Clark,CHALLENGER I,389,22.4,285,64,221,lan
45,elchicolinux,CHALLENGER I,379,16.7,233,39,194,lan
46,JOnnyLR,CHALLENGER I,376,17.1,357,61,296,lan
47,KllK EditZ,CHALLENGER I,362,18.1,287,52,235,lan
48,Im not villo,CHALLENGER I,353,20.8,365,76,289,lan
49,Frondavil,CHALLENGER I,346,15.7,432,68,364,lan
50,Sealcune Mbappé,CHALLENGER I,334,19.0,558,106,452,lan
51,Kurokoba,"GRANDMASTER I
G",335,19.2,177,34,143,lan
52,Vampiro Playero,"GRANDMASTER I
G",321,19.3,306,59,247,lan
53,Putint,"GRANDMASTER I
G",305,19.7,264,52,212,lan
54,oliver10,"GRANDMASTER I
G",305,19.2,271,52,219,lan
55,Siempremuerto,"GRANDMASTER I
G",302,15.3,339,52,287,lan
56,thewghost,"GRANDMASTER I
G",302,24.4,197,48,149,lan
57,Slix,"GRANDMASTER I
G",302,23.8,168,40,128,lan
58,Main Q,"GRANDMASTER I
G",297,19.4,273,53,220,lan
59,warlocksky,"GRANDMASTER I
G",296,14.3,251,36,215,lan
60,TheBadMF,"GRANDMASTER I
G",280,17.0,336,57,279,lan
61,Power,"GRANDMASTER I
G",256,14.5,380,55,325,lan
62,CrisT1an,"GRANDMASTER I
G",249,23.0,161,37,124,lan
63,Gargota,"GRANDMASTER I
G",243,21.8,294,64,230,lan
64,Revengp,"GRANDMASTER I
G",242,21.3,211,45,166,lan
65,G2 Josar,"GRANDMASTER I
G",241,19.3,332,64,268,lan
66,PoronghaNegra,"GRANDMASTER I
G",234,17.1,397,68,329,lan
67,AntonyGamingTFT,"GRANDMASTER I
G",233,15.3,471,72,399,lan
68,xHeroskillx,"GRANDMASTER I
G",222,15.7,235,37,198,lan
69,Garchomp,"GRANDMASTER I
G",219,26.7,180,48,132,lan
70,Dondenuncias,"GRANDMASTER I
G",218,28.6,161,46,115,lan
71,TFT Cadix,"GRANDMASTER I
G",215,16.7,402,67,335,lan
72,ransabia,"GRANDMASTER I
G",212,14.4,619,89,530,lan
73,EN1GMA,"GRANDMASTER I
G",210,18.1,777,141,636,lan
74,Marenn,"GRANDMASTER I
G",207,13.6,287,39,248,lan
75,NAOS911,"GRANDMASTER I
G",206,11.6,614,71,543,lan
76,Maguita,"GRANDMASTER I
G",206,18.3,328,60,268,lan
77,WJ Rem,"GRANDMASTER I
G",203,15.2,296,45,251,lan
78,Cleopatro,"GRANDMASTER I
G",201,34.3,105,36,69,lan
79,Need more skins,"GRANDMASTER I
G",195,15.4,376,58,318,lan
80,Psend,"GRANDMASTER I
G",190,19.7,198,39,159,lan
81,FordHealer,"GRANDMASTER I
G",181,29.0,69,20,49,lan
82,LiL Exoor,"GRANDMASTER I
G",176,23.9,201,48,153,lan
83,Warblo,"GRANDMASTER I
G",174,24.4,405,99,306,lan
84,javia316,"GRANDMASTER I
G",171,14.7,476,70,406,lan
85,XiaoPo06,"GRANDMASTER I
G",170,12.9,565,73,492,lan
86,Twistä,"GRANDMASTER I
G",168,10.8,353,38,315,lan
87,Seìyu,"GRANDMASTER I
G",166,15.2,283,43,240,lan
88,Xkorzo YT,"GRANDMASTER I
G",162,29.0,93,27,66,lan
89,No Mercy,"GRANDMASTER I
G",160,16.7,582,97,485,lan
90,Cjddd,"GRANDMASTER I
G",156,16.1,217,35,182,lan
91,Khorge,"GRANDMASTER I
G",156,19.7,132,26,106,lan
92,Fherpaz,"GRANDMASTER I
G",154,13.3,429,57,372,lan
93,panchoAngüis,"GRANDMASTER I
G",153,23.5,306,72,234,lan
94,Khorge PN,"GRANDMASTER I
G",145,19.0,210,40,170,lan
95,Pompo,"GRANDMASTER I
G",142,18.0,345,62,283,lan
96,Rodo TFT,"GRANDMASTER I
G",141,15.7,235,37,198,lan
97,DenisLuluch,"GRANDMASTER I
G",140,16.7,324,54,270,lan
98,zeiik,"GRANDMASTER I
G",138,16.9,267,45,222,lan
99,MidGod,"GRANDMASTER I
G",138,15.5,142,22,120,lan
100,Too Sweet,"GRANDMASTER I
G",137,25.0,128,32,96,lan
101,TFT Lelouch,"GRANDMASTER I
G",133,13.7,256,35,221,lan
102,TheOnlyTeddy,"GRANDMASTER I
G",130,17.3,249,43,206,lan
103,DragoFenix2,"GRANDMASTER I
G",124,16.3,289,47,242,lan
104,Apödaca,"GRANDMASTER I
G",123,26.2,259,68,191,lan
105,Stupefy,"GRANDMASTER I
G",123,13.2,440,58,382,lan
106,socio2k,"GRANDMASTER I
G",118,18.1,310,56,254,lan
107,Jir0,"GRANDMASTER I
G",117,15.5,502,78,424,lan
108,Pushesz,"GRANDMASTER I
G",117,18.7,348,65,283,lan
109,lkokito,"GRANDMASTER I
G",116,18.4,418,77,341,lan
110,ExtraWuiller,"GRANDMASTER I
G",116,14.3,245,35,210,lan
111,Pedro Bae,"GRANDMASTER I
G",113,24.6,349,86,263,lan
112,llArthzll,"GRANDMASTER I
G",109,23.6,330,78,252,lan
113,lyonew,"GRANDMASTER I
G",109,13.6,494,67,427,lan
114,Phobosss,"GRANDMASTER I
G",105,14.4,348,50,298,lan
115,Dan Nassor,"GRANDMASTER I
G",104,18.0,484,87,397,lan
116,soli hdz,"GRANDMASTER I
G",104,17.8,411,73,338,lan
117,Vork,"GRANDMASTER I
G",104,14.9,442,66,376,lan
118,Pauleandro,"GRANDMASTER I
G",102,8.4,574,48,526,lan
119,Metapod69 3,"GRANDMASTER I
G",101,17.8,411,73,338,lan
120,TOMATOFARMER535,"GRANDMASTER I
G",100,9.5,600,57,543,lan
121,lx Rayhad xl,"GRANDMASTER I
G",100,21.4,159,34,125,lan
122,rambo12345678,"GRANDMASTER I
G",99,14.7,523,77,446,lan
123,Chesspants,"GRANDMASTER I
G",97,18.8,197,37,160,lan
124,Don Stban,"GRANDMASTER I
G",97,22.2,126,28,98,lan
125,Dizzy DestroyLAN,"GRANDMASTER I
G",96,20.9,91,19,72,lan
126,Anivio,"GRANDMASTER I
G",95,16.7,288,48,240,lan
127,Rambotehamatado,"GRANDMASTER I
G",94,16.5,418,69,349,lan
128,TFT Ares,"GRANDMASTER I
G",93,11.0,546,60,486,lan
129,bEiMáR,"GRANDMASTER I
G",91,13.6,797,108,689,lan
130,Ardén,"GRANDMASTER I
G",91,11.6,509,59,450,lan
131,TFTJefe,"GRANDMASTER I
G",89,14.8,283,42,241,lan
132,Orange,"GRANDMASTER I
G",85,12.1,481,58,423,lan
133,Gatito Cósmıco,"GRANDMASTER I
G",85,17.6,239,42,197,lan
134,Cloud strife,"GRANDMASTER I
G",85,16.8,155,26,129,lan
135,RedsKnight,"GRANDMASTER I
G",84,18.4,331,61,270,lan
136,Skan011,"GRANDMASTER I
G",81,14.0,235,33,202,lan
137,chërlyn,"GRANDMASTER I
G",80,23.5,319,75,244,lan
138,GøldLyon,"GRANDMASTER I
G",78,16.3,301,49,252,lan
139,aeal99,"GRANDMASTER I
G",77,12.6,198,25,173,lan
140,Gio9811,"GRANDMASTER I
G",75,15.3,229,35,194,lan
141,AbrahamBM,"GRANDMASTER I
G",75,16.3,190,31,159,lan
142,Nightlover,"GRANDMASTER I
G",73,17.3,318,55,263,lan
143,Ucr,"GRANDMASTER I
G",73,14.2,359,51,308,lan
144,Vey,"GRANDMASTER I
G",73,16.9,219,37,182,lan
145,BarbeQ,"GRANDMASTER I
G",72,15.5,560,87,473,lan
146,SKY Trafalgar,"GRANDMASTER I
G",70,15.8,488,77,411,lan
147,Desü,"GRANDMASTER I
G",69,14.7,477,70,407,lan
148,ILY Elena Rubí,"GRANDMASTER I
G",69,24.8,109,27,82,lan
149,Sorrento0,"GRANDMASTER I
G",5,16.6,392,65,327,lan
150,ICostDRE,"GRANDMASTER I
G",0,16.3,540,88,452,lan
151,Aletsis,MASTER I,100,23.2,129,30,99,lan
152,papusmaximus,MASTER I,95,6.5,324,21,303,lan
153,McGregorr,MASTER I,92,18.6,419,78,341,lan
154,BarbieQ,MASTER I,81,27.9,104,29,75,lan
155,WilvySmile,MASTER I,80,15.5,741,115,626,lan
156,25356,MASTER I,77,16.8,291,49,242,lan
157,Wamuu,MASTER I,72,17.4,374,65,309,lan
158,liou,MASTER I,71,18.2,121,22,99,lan
159,l Moe l,MASTER I,68,12.6,310,39,271,lan
160,GS Lancelot,MASTER I,67,18.1,259,47,212,lan
161,JoseM29,MASTER I,66,16.0,350,56,294,lan
162,Nebura,MASTER I,65,19.5,205,40,165,lan
163,96Cronus05,MASTER I,63,21.2,203,43,160,lan
164,DLT Macloud,MASTER I,60,17.6,472,83,389,lan
165,Skaaarl,MASTER I,57,16.5,255,42,213,lan
166,Moncho,MASTER I,57,12.9,155,20,135,lan
167,God JdGa,MASTER I,55,23.2,353,82,271,lan
168,TFT Kalo,MASTER I,54,10.6,708,75,633,lan
169,JulesMont,MASTER I,50,21.2,231,49,182,lan
170,TheGearZ,MASTER I,50,11.7,180,21,159,lan
171,Frozte,MASTER I,48,17.9,223,40,183,lan
172,NKG Madness,MASTER I,46,22.1,195,43,152,lan
173,Homencoming,MASTER I,46,7.4,377,28,349,lan
174,Arcaanine,MASTER I,45,10.7,590,63,527,lan
175,Mahito,MASTER I,44,23.7,114,27,87,lan
176,donberli,MASTER I,42,15.6,537,84,453,lan
177,Wild Octupus,MASTER I,41,23.9,180,43,137,lan
178,NTS Dr Edwin,MASTER I,40,14.4,167,24,143,lan
179,Espemss,MASTER I,39,14.9,222,33,189,lan
180,Lą Mąscotą,MASTER I,38,15.2,151,23,128,lan
181,Druu TFT,MASTER I,36,18.7,401,75,326,lan
182,Dirmund,MASTER I,36,10.0,261,26,235,lan
183,Roy Mustang XD,MASTER I,35,12.9,325,42,283,lan
184,PAPILFOELREY,MASTER I,34,14.5,351,51,300,lan
185,D4nyle,MASTER I,33,14.1,1515,214,1301,lan
186,TeversomuchT,MASTER I,33,12.8,413,53,360,lan
187,Venonmanzer,MASTER I,32,10.3,263,27,236,lan
188,TheFenixx,MASTER I,29,30.7,202,62,140,lan
189,Danté,MASTER I,29,18.8,329,62,267,lan
190,Gizu,MASTER I,29,13.2,416,55,361,lan
191,BoscoBramblefoot,MASTER I,29,18.9,233,44,189,lan
192,MXG JonhWonka,MASTER I,29,24.1,116,28,88,lan
193,Devilx500,MASTER I,28,13.7,497,68,429,lan
194,Enryu The Red,MASTER I,26,18.7,305,57,248,lan
195,Souł,MASTER I,26,15.3,293,45,248,lan
196,Camipson,MASTER I,24,15.0,233,35,198,lan
197,ZyppoTFT,MASTER I,21,17.2,395,68,327,lan
198,Šęcręt Aurôrą,MASTER I,21,14.2,288,41,247,lan
199,Archi,MASTER I,20,12.7,236,30,206,lan
200,DiiimiTRY,MASTER I,19,19.1,188,36,152,lan
201,SotoOZoto,MASTER I,17,24.3,107,26,81,lan
202,boli é corozo,MASTER I,16,22.4,98,22,76,lan
203,persian rugs,MASTER I,15,19.8,182,36,146,lan
204,DedosLocos7u7,MASTER I,15,14.2,247,35,212,lan
205,Tengen Uzui,MASTER I,14,22.9,196,45,151,lan
206,Ezcanør,MASTER I,14,13.4,299,40,259,lan
207,Stuff,MASTER I,13,14.0,379,53,326,lan
208,Lechuga Húmeda,MASTER I,13,16.3,251,41,210,lan
209,Epic Arrow,MASTER I,12,7.6,1075,82,993,lan
210,very cute girl,MASTER I,12,20.1,308,62,246,lan
211,Wínter,MASTER I,12,17.6,204,36,168,lan
212,ChinoRobin,MASTER I,11,23.4,222,52,170,lan
213,Sr Frito,MASTER I,9,15.5,426,66,360,lan
214,Akua,MASTER I,9,17.4,201,35,166,lan
215,TaquitoAIPastor,MASTER I,9,18.1,149,27,122,lan
216,JONN93,MASTER I,8,12.8,584,75,509,lan
217,Lą Sultąną,MASTER I,8,27.9,93,26,67,lan
218,AlXDXD,MASTER I,6,17.7,209,37,172,lan
219,MAlDEN,MASTER I,5,11.8,561,66,495,lan
220,Flexus,MASTER I,5,17.5,206,36,170,lan
221,juandotft,MASTER I,5,16.3,178,29,149,lan
222,darksiders9,MASTER I,5,14.1,205,29,176,lan
223,Porygon,MASTER I,5,23.4,111,26,85,lan
224,xXReyXx,MASTER I,4,16.5,260,43,217,lan
225,Scrum1233,MASTER I,3,17.5,309,54,255,lan
226,A K A DeckeR GNR,MASTER I,3,15.5,284,44,240,lan
227,VarelaG4M3R,MASTER I,3,9.2,467,43,424,lan
228,Rcadillo,MASTER I,2,15.4,841,130,711,lan
229,4manu4,MASTER I,2,15.1,291,44,247,lan
230,thor0077,MASTER I,2,14.1,198,28,170,lan
231,CeldriKingleSs,MASTER I,1,15.5,1572,244,1328,lan
232,HaganeNoren,MASTER I,1,20.1,214,43,171,lan
233,j41746943J,MASTER I,1,15.8,265,42,223,lan
234,V Draeko,MASTER I,1,10.0,299,30,269,lan
235,LaGoorda,MASTER I,1,18.2,154,28,126,lan
236,JottaEle,MASTER I,1,13.0,208,27,181,lan
237,GREIVIN,MASTER I,1,9.8,275,27,248,lan
238,F Ë N R I R Wølf,MASTER I,1,16.4,152,25,127,lan
239,Farek,MASTER I,0,12.8,654,84,570,lan
240,ºªº,MASTER I,0,19.0,369,70,299,lan
241,scarmg,MASTER I,0,19.8,349,69,280,lan
242,Drefaz,MASTER I,0,16.3,417,68,349,lan
243,JIDEG,MASTER I,0,16.1,391,63,328,lan
244,BLACKCAMON,MASTER I,0,19.9,302,60,242,lan
245,Kyokenn,MASTER I,0,15.1,398,60,338,lan
246,EvilAgeent,MASTER I,0,17.0,336,57,279,lan
247,HoIIow Knight,MASTER I,0,14.2,351,50,301,lan
248,ahsodan,MASTER I,0,14.8,332,49,283,lan
249,Volk13,MASTER I,0,12.8,350,45,305,lan
250,fciencias,MASTER I,0,16.5,255,42,213,lan
251,Utephh,MASTER I,0,16.3,257,42,215,lan
252,marcitox,MASTER I,0,16.0,250,40,210,lan
253,DL DIAMOND DL,MASTER I,0,13.2,281,37,244,lan
254,Farlicious,MASTER I,0,24.8,145,36,109,lan
255,JhonWonka,MASTER I,0,20.5,171,35,136,lan
256,0 Torment,MASTER I,0,16.1,205,33,172,lan
257,Aguri Onishi,MASTER I,0,18.9,169,32,137,lan
258,marduko,MASTER I,0,11.2,258,29,229,lan
259,BlitzDance,MASTER I,0,18.4,147,27,120,lan
260,ABjomies,DIAMOND I,87,18.5,562,104,458,lan
261,DHA Arslan,DIAMOND I,87,7.7,534,41,493,lan
262,FjBlanco,DIAMOND I,80,17.6,358,63,295,lan
263,itai yamete papa,DIAMOND I,80,17.8,241,43,198,lan
264,spymomkiller,DIAMOND I,79,15.7,236,37,199,lan
265,Crs Pursuit,DIAMOND I,78,14.6,287,42,245,lan
266,SabritasOriginal,DIAMOND I,77,19.9,282,56,226,lan
267,Sigma the black,DIAMOND I,76,10.4,298,31,267,lan
268,Hide øn bušh,DIAMOND I,75,18.3,923,169,754,lan
269,DreigonzxD,DIAMOND I,75,19.8,445,88,357,lan
270,TierDany,DIAMOND I,75,21.3,338,72,266,lan
271,Apolden,DIAMOND I,75,14.0,506,71,435,lan
272,OblivionDrake,DIAMOND I,75,12.8,516,66,450,lan
273,Rafoski,DIAMOND I,75,10.7,561,60,501,lan
274,xXSenshouXx,DIAMOND I,75,21.1,266,56,210,lan
275,Karlosd6,DIAMOND I,75,19.6,265,52,213,lan
276,NVS Mlchael,DIAMOND I,75,23.7,207,49,158,lan
277,Luisillo senpai,DIAMOND I,75,16.1,304,49,255,lan
278,Tamarhindo,DIAMOND I,75,15.8,240,38,202,lan
279,Danith,DIAMOND I,75,20.0,165,33,132,lan
280,Freakiest show,DIAMOND I,75,21.1,142,30,112,lan
281,TFT ransabia,DIAMOND I,75,27.2,103,28,75,lan
282,alberth321,DIAMOND I,75,9.8,275,27,248,lan
283,V Fénix,DIAMOND I,75,10.7,196,21,175,lan
284,XxsummaruuxX,DIAMOND I,75,12.5,120,15,105,lan
285,Gallher,DIAMOND I,74,18.4,479,88,391,lan
286,EternalWarriorXD,DIAMOND I,74,21.8,206,45,161,lan
287,Zaxxkk,DIAMOND I,74,21.2,137,29,108,lan
288,Dont Lose Aru,DIAMOND I,73,13.8,327,45,282,lan
289,Ovejomaru,DIAMOND I,72,18.9,307,58,249,lan
290,El Cholo Ivan 25,DIAMOND I,68,18.1,310,56,254,lan
291,El Rolox,DIAMOND I,67,25.4,114,29,85,lan
292,Compa Kiki,DIAMOND I,66,16.4,140,23,117,lan
293,El HuachicoIero,DIAMOND I,65,15.7,83,13,70,lan
294,Marrochet,DIAMOND I,61,11.6,310,36,274,lan
295,Emili4n,DIAMOND I,59,27.9,305,85,220,lan
296,Sleepfer,DIAMOND I,57,13.6,789,107,682,lan
297,rakids,DIAMOND I,57,8.3,515,43,472,lan
298,Wukong Radiante,DIAMOND I,57,16.0,262,42,220,lan
299,Play,DIAMOND I,55,11.6,319,37,282,lan
300,Sr Escanor,DIAMOND I,54,15.7,325,51,274,lan
301,Llámame Minizyzz,DIAMOND I,53,17.0,194,33,161,lan
302,Rkman,DIAMOND I,52,19.1,194,37,157,lan
303,gujet,DIAMOND I,52,16.7,209,35,174,lan
304,Secco,DIAMOND I,50,16.9,533,90,443,lan
305,ChrisVinsmoke,DIAMOND I,50,23.8,290,69,221,lan
306,DarkSpoiled,DIAMOND I,50,16.7,390,65,325,lan
307,Nikyu,DIAMOND I,50,22.0,273,60,213,lan
308,Agonys Embrace,DIAMOND I,50,16.5,346,57,289,lan
309,ALXNIGHT,DIAMOND I,50,15.9,359,57,302,lan
310,ElGuasoNPerú,DIAMOND I,50,14.3,399,57,342,lan
311,ccrixalis,DIAMOND I,50,17.6,295,52,243,lan
312,Pao Wang 595,DIAMOND I,50,17.4,299,52,247,lan
313,Konohá,DIAMOND I,50,17.7,271,48,223,lan
314,Frank,DIAMOND I,50,20.1,229,46,183,lan
315,Osorongo GG,DIAMOND I,50,19.6,230,45,185,lan
316,VGIA Manute,DIAMOND I,50,14.0,314,44,270,lan
317,Gral Torin,DIAMOND I,50,18.2,231,42,189,lan
318,edwardp00,DIAMOND I,50,17.1,239,41,198,lan
319,Sakuno,DIAMOND I,50,20.4,186,38,148,lan
320,OGT Sergio,DIAMOND I,50,19.7,183,36,147,lan
321,swarosky,DIAMOND I,50,14.3,252,36,216,lan
322,General Rou,DIAMOND I,50,24.6,142,35,107,lan
323,Níetzsche,DIAMOND I,50,27.7,119,33,86,lan
324,Entei,DIAMOND I,50,21.1,147,31,116,lan
325,Senna Palmer,DIAMOND I,50,22.1,131,29,102,lan
326,Hi im Zeuus,DIAMOND I,50,15.4,136,21,115,lan
327,wolfteamx5,DIAMOND I,49,15.0,640,96,544,lan
328,YAYADC,DIAMOND I,48,12.6,175,22,153,lan
329,Bebessiitaaaa,DIAMOND I,46,15.6,385,60,325,lan
330,The Fhack23,DIAMOND I,45,15.8,840,133,707,lan
331,rubiinskey,DIAMOND I,45,20.9,235,49,186,lan
332,Funtreng,DIAMOND I,44,14.6,485,71,414,lan
333,Mr chane,DIAMOND I,44,17.1,362,62,300,lan
334,AriChan,DIAMOND I,43,10.7,270,29,241,lan
335,Spianda,DIAMOND I,42,20.8,279,58,221,lan
336,YokedWar,DIAMOND I,42,17.5,228,40,188,lan
337,Pelososo,DIAMOND I,42,15.7,230,36,194,lan
338,Riflorez,DIAMOND I,41,11.6,912,106,806,lan
339,SayGGpls,DIAMOND I,41,15.0,525,79,446,lan
340,Crackie,DIAMOND I,41,12.2,583,71,512,lan
341,eldrit,DIAMOND I,41,16.6,295,49,246,lan
342,nikolaz9393,DIAMOND I,41,16.3,288,47,241,lan
343,Dancho,DIAMOND I,41,16.3,245,40,205,lan
344,Betomofcydonia,DIAMOND I,41,12.1,305,37,268,lan
345,JustAdc,DIAMOND I,40,15.5,646,100,546,lan
346,moonify,DIAMOND I,38,15.0,480,72,408,lan
347,XMozart,DIAMOND I,38,13.1,236,31,205,lan
348,Kommless,DIAMOND I,38,17.1,175,30,145,lan
349,Dani Di Twitch,DIAMOND I,38,14.7,204,30,174,lan
350,Firelx,DIAMOND I,38,17.5,160,28,132,lan
351,Jei7,DIAMOND I,36,18.3,262,48,214,lan
352,jimmypagesoler,DIAMOND I,35,13.9,273,38,235,lan
353,WMG Vi,DIAMOND I,34,19.4,360,70,290,lan
354,HuevoCrudo,DIAMOND I,34,14.4,458,66,392,lan
355,merrymaker,DIAMOND I,34,20.6,184,38,146,lan
356,Mitchaellkd,DIAMOND I,34,18.0,183,33,150,lan
357,Odinbel,DIAMOND I,33,8.8,557,49,508,lan
358,GerrySaiyan15,DIAMOND I,32,15.0,280,42,238,lan
359,javordavor,DIAMOND I,32,18.8,186,35,151,lan
360,Happy brownnie,DIAMOND I,31,13.9,288,40,248,lan
361,SsyaelAporro,DIAMOND I,31,16.2,235,38,197,lan
362,God avenged,DIAMOND I,31,18.6,167,31,136,lan
363,Chowy,DIAMOND I,30,17.4,321,56,265,lan
364,ShonWick,DIAMOND I,30,16.7,227,38,189,lan
365,MIROLINDO,DIAMOND I,29,18.9,233,44,189,lan
366,Gyró Zeppeli,DIAMOND I,29,18.5,151,28,123,lan
367,Sopa e Mondongo,DIAMOND I,29,21.1,104,22,82,lan
368,Pan the bono,DIAMOND I,28,16.1,366,59,307,lan
369,Fêderico,DIAMOND I,28,17.0,305,52,253,lan
370,Tyranarius,DIAMOND I,28,20.1,144,29,115,lan
371,III    MÅC   III,DIAMOND I,27,10.7,588,63,525,lan
372,LFT Zero,DIAMOND I,27,16.1,143,23,120,lan
373,Dark Room,DIAMOND I,26,13.8,448,62,386,lan
374,Dark Ceniza,DIAMOND I,26,15.0,266,40,226,lan
375,KO iRushx,DIAMOND I,25,16.6,283,47,236,lan
376,Nettlesome,DIAMOND I,25,11.1,333,37,296,lan
377,Tucus,DIAMOND I,25,10.5,267,28,239,lan
378,TFT Legend,DIAMOND I,25,36.8,68,25,43,lan
379,Ron Whiskey,DIAMOND I,25,16.7,120,20,100,lan
380,LlámameBruce Lee,DIAMOND I,24,17.4,484,84,400,lan
381,xMiguelOx,DIAMOND I,24,13.4,516,69,447,lan
382,Canbun,DIAMOND I,24,19.2,317,61,256,lan
383,VenezueLAN TFT,DIAMOND I,24,10.1,506,51,455,lan
384,YaphetS Karma,DIAMOND I,24,21.5,158,34,124,lan
385,looljavier,DIAMOND I,24,14.8,209,31,178,lan
386,Deleth,DIAMOND I,24,18.8,112,21,91,lan
387,Blach,DIAMOND I,24,17.8,90,16,74,lan
388,F por Hiroshima,DIAMOND I,23,21.4,275,59,216,lan
389,Hittler Sama UwU,DIAMOND I,22,21.0,372,78,294,lan
390,Tactics,DIAMOND I,22,7.1,912,65,847,lan
391,Melec,DIAMOND I,22,21.6,227,49,178,lan
392,Marvelous,DIAMOND I,21,16.7,252,42,210,lan
393,TrafalgarL4w,DIAMOND I,20,20.0,404,81,323,lan
394,McNov4ec,DIAMOND I,20,19.4,139,27,112,lan
395,XmagodiosX,DIAMOND I,19,16.4,201,33,168,lan
396,Mr 139610051704,DIAMOND I,19,15.2,145,22,123,lan
397,JotaJota507,DIAMOND I,18,10.7,915,98,817,lan
398,Adele,DIAMOND I,18,21.2,226,48,178,lan
399,HDKA02,DIAMOND I,18,17.5,171,30,141,lan
400,captainfifi,DIAMOND I,18,20.2,94,19,75,lan
401,DhannielUchiha,DIAMOND I,17,17.2,233,40,193,lan
402,Planeta,DIAMOND I,16,15.8,1426,225,1201,lan
403,Rak Hollow,DIAMOND I,16,13.5,178,24,154,lan
404,Tocino,DIAMOND I,13,23.1,173,40,133,lan
405,JOSETFT,DIAMOND I,13,8.4,439,37,402,lan
406,danilo00,DIAMOND I,13,14.1,206,29,177,lan
407,Best Amumu Korea,DIAMOND I,12,18.6,258,48,210,lan
408,INF Rohclem,DIAMOND I,12,12.8,188,24,164,lan
409,Acho,DIAMOND I,11,14.5,688,100,588,lan
410,zBoanerGes,DIAMOND I,11,15.5,187,29,158,lan
411,FV oglam,DIAMOND I,10,17.9,207,37,170,lan
412,PATRlA,DIAMOND I,10,15.4,110,17,93,lan
413,Hasta siempre,DIAMOND I,9,16.9,248,42,206,lan
414,Unique Stylish,DIAMOND I,8,20.2,347,70,277,lan
415,Hugalaoruga,DIAMOND I,8,19.4,227,44,183,lan
416,Kestoc,DIAMOND I,8,16.7,221,37,184,lan
417,Churritoo,DIAMOND I,7,17.2,402,69,333,lan
418,WindUp Boy,DIAMOND I,7,20.1,314,63,251,lan
419,Fireyix,DIAMOND I,7,22.6,177,40,137,lan
420,Hide on Petare,DIAMOND I,7,27.4,117,32,85,lan
421,xPuxi Nike,DIAMOND I,7,11.9,251,30,221,lan
422,OTP Rumble,DIAMOND I,7,16.3,153,25,128,lan
423,NedS3,DIAMOND I,6,16.4,378,62,316,lan
424,JeremyHax,DIAMOND I,6,16.6,343,57,286,lan
425,cefor,DIAMOND I,6,11.5,365,42,323,lan
426,maykol06,DIAMOND I,6,17.2,226,39,187,lan
427,Sëkker,DIAMOND I,5,21.2,207,44,163,lan
428,Gedo Yoch,DIAMOND I,5,16.9,154,26,128,lan
429,l Bipolar l,DIAMOND I,4,20.6,194,40,154,lan
430,JULK37,DIAMOND I,4,15.4,149,23,126,lan
431,Loptyr,DIAMOND I,4,15.3,144,22,122,lan
432,Tømmy Wiseau,DIAMOND I,3,14.4,457,66,391,lan
433,Zoh Rain Munda,DIAMOND I,3,15.6,250,39,211,lan
434,Epic Diozgor,DIAMOND I,2,15.9,282,45,237,lan
435,PupusaDeQueso7u7,DIAMOND I,1,16.7,450,75,375,lan
436,SugarSon69,DIAMOND I,1,18.1,360,65,295,lan
437,Seikap,DIAMOND I,1,11.8,364,43,321,lan
438,Miguel Aleman,DIAMOND I,1,16.7,192,32,160,lan
439,Sonagi,DIAMOND I,1,17.6,148,26,122,lan
440,TSM Hiro,DIAMOND I,1,16.1,137,22,115,lan
441,caifas1995,DIAMOND I,0,18.9,572,108,464,lan
442,WorstHierbaMala,DIAMOND I,0,21.2,433,92,341,lan
443,Bréak,DIAMOND I,0,26.1,306,80,226,lan
444,TheKinginelNorth,DIAMOND I,0,12.7,567,72,495,lan
445,Cristhianhusk,DIAMOND I,0,17.4,409,71,338,lan
446,Right Cłick,DIAMOND I,0,16.4,428,70,358,lan
447,Da Fuking Rengar,DIAMOND I,0,19.5,303,59,244,lan
448,caguilarg96,DIAMOND I,0,20.5,273,56,217,lan
449,Yuuru,DIAMOND I,0,20.4,270,55,215,lan
450,Soy el Alemán,DIAMOND I,0,12.3,447,55,392,lan
451,Independent Cat,DIAMOND I,0,15.9,340,54,286,lan
452,FrogZero,DIAMOND I,0,23.7,224,53,171,lan
453,XXxDarkkingxXX,DIAMOND I,0,13.3,384,51,333,lan
454,Byaku Desu,DIAMOND I,0,21.7,230,50,180,lan
455,0 Horus,DIAMOND I,0,16.3,307,50,257,lan
456,Radita bb,DIAMOND I,0,17.7,277,49,228,lan
457,Noob Daniel,DIAMOND I,0,17.8,269,48,221,lan
458,ATG LEINHEART,DIAMOND I,0,15.2,315,48,267,lan
459,NoctisCaelum1,DIAMOND I,0,12.5,375,47,328,lan
460,7thLegion,DIAMOND I,0,21.6,204,44,160,lan
461,Neär,DIAMOND I,0,13.3,331,44,287,lan
462,Des Lichts,DIAMOND I,0,16.4,262,43,219,lan
463,Diego Abraham SP,DIAMOND I,0,21.8,188,41,147,lan
464,RomaTroyano,DIAMOND I,0,20.5,195,40,155,lan
465,Leonidasfed,DIAMOND I,0,14.1,284,40,244,lan
466,El Dque,DIAMOND I,0,22.1,172,38,134,lan
467,javierpe,DIAMOND I,0,19.8,187,37,150,lan
468,S 3 K K I,DIAMOND I,0,16.7,222,37,185,lan
469,xDuke ł,DIAMOND I,0,19.9,176,35,141,lan
470,MG Japo,DIAMOND I,0,19.4,180,35,145,lan
471,matazorros,DIAMOND I,0,18.5,189,35,154,lan
472,RNG Ktr0,DIAMOND I,0,28.1,121,34,87,lan
473,llRyougiShiki,DIAMOND I,0,16.6,181,30,151,lan
474,lSorol,DIAMOND I,0,19.7,147,29,118,lan
475,Chibs TFT,DIAMOND I,0,15.4,182,28,154,lan
476,All for Øne,DIAMOND I,0,15.4,169,26,143,lan
477,NeWTRoLL,DIAMOND I,0,13.0,192,25,167,lan
478,OTP Vladimir,DIAMOND I,0,16.8,143,24,119,lan
479,Frani,DIAMOND I,0,14.9,154,23,131,lan
480,ZOLE,DIAMOND I,0,12.2,188,23,165,lan
481,Tomcat,DIAMOND I,0,18.3,109,20,89,lan
482,edhson19,DIAMOND I,0,16.1,124,20,104,lan
483,Lelauch,DIAMOND II,99,21.9,164,36,128,lan
484,CLK1,DIAMOND II,99,21.3,122,26,96,lan
485,Beerwish,DIAMOND II,97,15.0,646,97,549,lan
486,Eneas,DIAMOND II,96,12.8,345,44,301,lan
487,R2FarwolD2,DIAMOND II,96,20.0,130,26,104,lan
488,Rey Menelao,DIAMOND II,94,15.4,436,67,369,lan
489,Topoyiyo100,DIAMOND II,94,16.0,162,26,136,lan
490,Zhørieg,DIAMOND II,93,17.6,199,35,164,lan
491,Xero Mad,DIAMOND II,93,9.4,181,17,164,lan
492,Brazen,DIAMOND II,92,15.3,209,32,177,lan
493,TFT WhiteChapel,DIAMOND II,92,26.1,119,31,88,lan
494,LuXoRvk,DIAMOND II,88,19.3,379,73,306,lan
495,Michael007st,DIAMOND II,87,14.4,430,62,368,lan
496,Surprise lm Back,DIAMOND II,85,15.9,276,44,232,lan
497,Sigvaldi,DIAMOND II,85,19.7,132,26,106,lan
498,Enr1que,DIAMOND II,84,11.5,633,73,560,lan
499,Haryed,DIAMOND II,84,15.8,133,21,112,lan
500,Genesis IV,DIAMOND II,80,16.7,150,25,125,lan
1,FaryaAndWoIyo,CHALLENGER I,1768,29.5,349,103,246,las
2,Kłaytøn,CHALLENGER I,1763,25.8,391,101,290,las
3,Shireen4,CHALLENGER I,1721,27.3,501,137,364,las
4,S de Sencillo,CHALLENGER I,1210,18.8,1332,250,1082,las
5,Tolengo73,CHALLENGER I,1193,27.1,517,140,377,las
6,JustDream,CHALLENGER I,1049,17.7,909,161,748,las
7,DarksBit,CHALLENGER I,993,24.0,254,61,193,las
8,UCH TheLiNe,CHALLENGER I,939,30.9,259,80,179,las
9,Highroll,CHALLENGER I,882,20.3,631,128,503,las
10,Samenix,CHALLENGER I,855,27.5,284,78,206,las
11,No Quarter,CHALLENGER I,844,21.5,386,83,303,las
12,Altenahue,CHALLENGER I,833,22.9,488,112,376,las
13,Priend,CHALLENGER I,771,18.0,617,111,506,las
14,FuryTank,CHALLENGER I,768,21.7,327,71,256,las
15,Fourloko RX,CHALLENGER I,684,21.6,273,59,214,las
16,Fan de la Linea,CHALLENGER I,620,24.9,189,47,142,las
17,Christus,CHALLENGER I,599,29.9,147,44,103,las
18,CooLDownJJ,CHALLENGER I,584,24.2,293,71,222,las
19,shuuumpy,CHALLENGER I,568,19.9,413,82,331,las
20,LifesBadTFT,CHALLENGER I,568,21.6,250,54,196,las
21,New Stage,CHALLENGER I,523,19.1,324,62,262,las
22,Girlfromnoxuss,CHALLENGER I,522,20.1,623,125,498,las
23,UCH Morfer,CHALLENGER I,522,17.6,289,51,238,las
24,Dukie,CHALLENGER I,510,20.1,184,37,147,las
25,MorteMTW,CHALLENGER I,493,17.1,595,102,493,las
26,Jesus,CHALLENGER I,483,22.9,140,32,108,las
27,Bugame,CHALLENGER I,466,23.0,217,50,167,las
28,RoSweL TacTicS,CHALLENGER I,440,14.8,888,131,757,las
29,Greyd0n,CHALLENGER I,440,13.6,413,56,357,las
30,Óxidos Basicos,CHALLENGER I,440,16.4,287,47,240,las
31,Åzok,CHALLENGER I,438,15.9,433,69,364,las
32,InvadersMD,CHALLENGER I,425,16.1,715,115,600,las
33,404NameeNotFound,CHALLENGER I,424,16.5,502,83,419,las
34,TFT MMR Perfect,CHALLENGER I,409,17.4,529,92,437,las
35,Wazapper,CHALLENGER I,393,16.2,320,52,268,las
36,Changuito 10,CHALLENGER I,393,20.4,176,36,140,las
37,Cupiditas,CHALLENGER I,385,20.3,300,61,239,las
38,sendohrai,CHALLENGER I,365,18.1,309,56,253,las
39,Karnal,CHALLENGER I,363,14.9,518,77,441,las
40,xiomax,CHALLENGER I,362,16.5,327,54,273,las
41,AUGUSTOMARCO,CHALLENGER I,357,14.7,326,48,278,las
42,Lyked,CHALLENGER I,356,25.7,261,67,194,las
43,100cityfico,CHALLENGER I,351,11.3,470,53,417,las
44,Rubik,CHALLENGER I,350,17.2,268,46,222,las
45,Gara Arg,CHALLENGER I,348,18.5,395,73,322,las
46,Gei Ye Si,CHALLENGER I,344,19.4,464,90,374,las
47,Nico Del Baño,CHALLENGER I,338,25.6,152,39,113,las
48,Fradox22,CHALLENGER I,332,21.3,188,40,148,las
49,ChakoPopoco,CHALLENGER I,315,15.3,465,71,394,las
50,Kozukî Oden,CHALLENGER I,304,12.5,232,29,203,las
51,SouLXisT,"GRANDMASTER I
G",312,19.6,224,44,180,las
52,ACÁ MANDO YO,"GRANDMASTER I
G",307,21.0,419,88,331,las
53,Don Galli,"GRANDMASTER I
G",301,19.9,156,31,125,las
54,Desgr4cia,"GRANDMASTER I
G",300,10.6,992,105,887,las
55,ElbalmoR,"GRANDMASTER I
G",295,17.3,289,50,239,las
56,Emad Joestar,"GRANDMASTER I
G",292,17.8,202,36,166,las
57,ssbita,"GRANDMASTER I
G",285,18.6,306,57,249,las
58,Cvictoria Bryant,"GRANDMASTER I
G",283,16.4,464,76,388,las
59,iudex Jevic,"GRANDMASTER I
G",279,17.4,711,124,587,las
60,Raruto,"GRANDMASTER I
G",274,13.9,258,36,222,las
61,Mapachee,"GRANDMASTER I
G",255,20.9,378,79,299,las
62,MättZ,"GRANDMASTER I
G",250,11.1,497,55,442,las
63,Tr1ckster,"GRANDMASTER I
G",237,29.6,108,32,76,las
64,RetoSuperado,"GRANDMASTER I
G",222,15.5,349,54,295,las
65,HeRz BenT,"GRANDMASTER I
G",213,19.6,327,64,263,las
66,TwitchTVLifesBad,"GRANDMASTER I
G",203,26.5,151,40,111,las
67,ANIMEWEEBLORD420,"GRANDMASTER I
G",201,23.8,122,29,93,las
68,geoffroy123,"GRANDMASTER I
G",201,14.6,144,21,123,las
69,Mr GFS Reaper,"GRANDMASTER I
G",199,21.4,466,100,366,las
70,JueguenNormal,"GRANDMASTER I
G",187,14.9,469,70,399,las
71,TWOEASY,"GRANDMASTER I
G",187,13.8,261,36,225,las
72,BC Thoryn,"GRANDMASTER I
G",179,21.4,206,44,162,las
73,CriXaLis,"GRANDMASTER I
G",178,17.8,421,75,346,las
74,RNGPDD,"GRANDMASTER I
G",178,25.2,103,26,77,las
75,Elsa Nito,"GRANDMASTER I
G",158,14.2,429,61,368,las
76,Ryuuk Kyuu,"GRANDMASTER I
G",158,15.8,158,25,133,las
77,Rekatria,"GRANDMASTER I
G",157,17.9,218,39,179,las
78,Óxidos Ácidos,"GRANDMASTER I
G",155,18.5,162,30,132,las
79,QT FD,"GRANDMASTER I
G",152,17.7,576,102,474,las
80,el ayuwóki,"GRANDMASTER I
G",151,14.9,475,71,404,las
81,Zionooooo,"GRANDMASTER I
G",146,16.2,234,38,196,las
82,KenMasters7,"GRANDMASTER I
G",146,23.1,143,33,110,las
83,Ghosty321,"GRANDMASTER I
G",144,14.6,405,59,346,las
84,StuPot,"GRANDMASTER I
G",144,16.7,288,48,240,las
85,DONBOMBASTIC,"GRANDMASTER I
G",143,16.9,267,45,222,las
86,Dogor,"GRANDMASTER I
G",140,16.5,278,46,232,las
87,henryqez,"GRANDMASTER I
G",135,16.2,327,53,274,las
88,ravenoneforeva,"GRANDMASTER I
G",133,20.6,310,64,246,las
89,Danielove,"GRANDMASTER I
G",125,14.2,360,51,309,las
90,Hardcorito Facho,"GRANDMASTER I
G",125,17.7,226,40,186,las
91,ACD Doomleg,"GRANDMASTER I
G",122,15.0,600,90,510,las
92,Wolf Bak,"GRANDMASTER I
G",121,15.6,449,70,379,las
93,CodMeiro,"GRANDMASTER I
G",121,15.1,311,47,264,las
94,TOXIAS,"GRANDMASTER I
G",118,17.2,186,32,154,las
95,YourGod22,"GRANDMASTER I
G",116,12.5,248,31,217,las
96,xaimmer,"GRANDMASTER I
G",115,16.8,507,85,422,las
97,NOSABIAQUEPONE,"GRANDMASTER I
G",111,16.8,191,32,159,las
98,Masul,"GRANDMASTER I
G",110,18.5,308,57,251,las
99,animesenpai2,"GRANDMASTER I
G",109,14.3,245,35,210,las
100,NachoG95,"GRANDMASTER I
G",106,16.9,492,83,409,las
101,zaqlev,"GRANDMASTER I
G",101,18.0,266,48,218,las
102,Dtoke Freestyler,"GRANDMASTER I
G",99,13.9,452,63,389,las
103,Lyrion Tannister,"GRANDMASTER I
G",98,20.1,244,49,195,las
104,Zeikana,"GRANDMASTER I
G",95,17.4,345,60,285,las
105,Peronism,"GRANDMASTER I
G",94,14.8,283,42,241,las
106,EMiguel,"GRANDMASTER I
G",94,20.8,168,35,133,las
107,CuriousChameIeon,"GRANDMASTER I
G",88,20.5,415,85,330,las
108,Necroshine77,"GRANDMASTER I
G",88,19.5,369,72,297,las
109,toy chikita,"GRANDMASTER I
G",88,21.2,207,44,163,las
110,Daelon TFT,"GRANDMASTER I
G",85,12.9,409,53,356,las
111,VortexN,"GRANDMASTER I
G",82,14.7,394,58,336,las
112,Luchiiitoo,"GRANDMASTER I
G",82,14.0,342,48,294,las
113,Dungeon,"GRANDMASTER I
G",79,16.2,383,62,321,las
114,Haise,"GRANDMASTER I
G",78,16.5,164,27,137,las
115,TU WAIFU ME AMA,"GRANDMASTER I
G",77,17.9,173,31,142,las
116,Shadow Ares,"GRANDMASTER I
G",77,16.0,156,25,131,las
117,LuckyDuit,"GRANDMASTER I
G",74,16.1,280,45,235,las
118,iPurge1,"GRANDMASTER I
G",73,13.7,386,53,333,las
119,Cv 366,"GRANDMASTER I
G",72,17.5,206,36,170,las
120,WWWWWWW,"GRANDMASTER I
G",68,14.9,368,55,313,las
121,ElnicoMata,"GRANDMASTER I
G",67,12.2,672,82,590,las
122,UCH StartNoob,"GRANDMASTER I
G",67,12.4,217,27,190,las
123,TheClasman,"GRANDMASTER I
G",66,14.6,412,60,352,las
124,Sáyron,"GRANDMASTER I
G",65,13.2,433,57,376,las
125,Sirzechsl,"GRANDMASTER I
G",64,13.3,414,55,359,las
126,KeRikoWisKi,"GRANDMASTER I
G",64,15.0,266,40,226,las
127,ElDryzler,"GRANDMASTER I
G",60,11.8,373,44,329,las
128,El Gørdo J,"GRANDMASTER I
G",59,15.9,548,87,461,las
129,BTS TFT Player,"GRANDMASTER I
G",58,21.6,306,66,240,las
130,Arizona Zervas,"GRANDMASTER I
G",57,16.8,333,56,277,las
131,ROH inSec t0,"GRANDMASTER I
G",57,13.4,409,55,354,las
132,TheDanieTFT,"GRANDMASTER I
G",57,13.2,182,24,158,las
133,WaIter White Jr,"GRANDMASTER I
G",56,13.1,413,54,359,las
134,KravenPa,"GRANDMASTER I
G",55,17.1,427,73,354,las
135,psyque,"GRANDMASTER I
G",55,19.5,195,38,157,las
136,Tactics iBaggy,"GRANDMASTER I
G",54,14.8,230,34,196,las
137,Ola soi Smurf,"GRANDMASTER I
G",53,32.9,82,27,55,las
138,SlashFullMuteAll,"GRANDMASTER I
G",52,15.8,336,53,283,las
139,LOLEROPERONOPACO,"GRANDMASTER I
G",51,18.8,304,57,247,las
140,Kellu Afen,"GRANDMASTER I
G",51,16.4,269,44,225,las
141,Keru,"GRANDMASTER I
G",50,16.0,331,53,278,las
142,Penzio,"GRANDMASTER I
G",50,13.2,273,36,237,las
143,HuNnnTeR,"GRANDMASTER I
G",49,16.3,791,129,662,las
144,carkrod,"GRANDMASTER I
G",46,14.6,676,99,577,las
145,64 Bits,"GRANDMASTER I
G",43,13.9,230,32,198,las
146,LeoPalac10,"GRANDMASTER I
G",39,20.1,174,35,139,las
147,Naron Bashor,"GRANDMASTER I
G",8,13.0,408,53,355,las
148,Gaattsu,MASTER I,116,12.9,535,69,466,las
149,BolaDeLomo,MASTER I,80,15.0,293,44,249,las
150,Daian21,MASTER I,79,8.5,399,34,365,las
151,iForeverBronze,MASTER I,75,16.7,783,131,652,las
152,hartung,MASTER I,75,15.8,336,53,283,las
153,Twitch Jaypi9,MASTER I,64,16.2,711,115,596,las
154,Crux,MASTER I,61,15.5,348,54,294,las
155,Stoned Bulbasaur,MASTER I,58,13.5,192,26,166,las
156,Lean Live,MASTER I,56,14.2,331,47,284,las
157,TiagoAbner,MASTER I,51,13.3,294,39,255,las
158,Viangrele,MASTER I,50,24.9,297,74,223,las
159,Orco13,MASTER I,50,17.2,261,45,216,las
160,Pastero en Bici,MASTER I,48,16.7,383,64,319,las
161,dimeloneri,MASTER I,48,12.5,319,40,279,las
162,OrangeMoon,MASTER I,46,19.0,891,169,722,las
163,xZaMaSx,MASTER I,45,16.5,358,59,299,las
164,LoLiLoV3r,MASTER I,43,22.4,147,33,114,las
165,Kamajuchi77,MASTER I,42,16.1,572,92,480,las
166,El Palo Me Mama,MASTER I,41,19.8,182,36,146,las
167,Xork,MASTER I,39,19.9,436,87,349,las
168,nymph666,MASTER I,38,12.7,363,46,317,las
169,Pinsto,MASTER I,37,20.0,205,41,164,las
170,LIEUTENANT DAN,MASTER I,36,17.6,273,48,225,las
171,tft main lol,MASTER I,36,21.8,101,22,79,las
172,LioCR7,MASTER I,35,14.6,500,73,427,las
173,KTP Yoshi,MASTER I,35,13.8,441,61,380,las
174,LL Jhin,MASTER I,35,16.4,171,28,143,las
175,Mid Ghost,MASTER I,31,13.7,968,133,835,las
176,Heisnb3rg,MASTER I,30,19.0,205,39,166,las
177,Riften,MASTER I,29,16.8,179,30,149,las
178,Spaark  TFT,MASTER I,29,15.9,189,30,159,las
179,xikhario,MASTER I,23,16.1,322,52,270,las
180,HUAWEI AFeng,MASTER I,23,31.0,71,22,49,las
181,FacuBenedetti,MASTER I,22,13.1,398,52,346,las
182,guitardead,MASTER I,22,18.2,209,38,171,las
183,GALLig,MASTER I,21,33.8,77,26,51,las
184,Error 402,MASTER I,20,14.2,204,29,175,las
185,Belfreath,MASTER I,19,12.2,294,36,258,las
186,UruSativaCarryJr,MASTER I,17,20.5,215,44,171,las
187,Niño Sad,MASTER I,16,18.6,242,45,197,las
188,Blasgare,MASTER I,16,8.9,336,30,306,las
189,UCH Koro,MASTER I,15,17.4,340,59,281,las
190,SOY AGNÓSTICO,MASTER I,15,12.9,303,39,264,las
191,Zoa,MASTER I,14,16.3,208,34,174,las
192,Hao,MASTER I,14,9.9,202,20,182,las
193,God DMZ,MASTER I,12,16.3,331,54,277,las
194,Kiroichy,MASTER I,12,21.3,230,49,181,las
195,Seminare,MASTER I,11,16.4,310,51,259,las
196,T2W DOGORwashere,MASTER I,10,19.7,249,49,200,las
197,Quantum Cobalt,MASTER I,10,17.1,275,47,228,las
198,LeBlanc Uchiha,MASTER I,9,14.1,1081,152,929,las
199,Hukka,MASTER I,9,17.0,235,40,195,las
200,1nstant Karma,MASTER I,7,15.5,368,57,311,las
201,Deku611,MASTER I,7,12.6,420,53,367,las
202,CisTHD,MASTER I,6,15.8,467,74,393,las
203,SubLimE QQ,MASTER I,6,20.6,253,52,201,las
204,Down Powers,MASTER I,6,20.9,187,39,148,las
205,IICelesteII,MASTER I,5,15.7,597,94,503,las
206,Pochocles,MASTER I,5,18.8,261,49,212,las
207,Pandiwe2K,MASTER I,5,18.8,160,30,130,las
208,Gramitaa,MASTER I,4,15.9,351,56,295,las
209,Trimsk,MASTER I,4,14.7,245,36,209,las
210,Sikolio,MASTER I,3,18.4,396,73,323,las
211,Berzedker,MASTER I,3,17.6,272,48,224,las
212,Best Teemo LAS,MASTER I,2,15.9,478,76,402,las
213,spiirati,MASTER I,2,15.0,400,60,340,las
214,Perekkles,MASTER I,2,17.9,307,55,252,las
215,TFT daddy,MASTER I,2,19.9,186,37,149,las
216,Serteck,MASTER I,2,17.2,209,36,173,las
217,xXWelintonQuiwXx,MASTER I,2,11.9,210,25,185,las
218,Gasté 13900 IP,MASTER I,1,16.8,368,62,306,las
219,OgilvyRaboLoko,MASTER I,1,15.2,276,42,234,las
220,Preshelec,MASTER I,1,15.7,178,28,150,las
221,Termo Stan Lee,MASTER I,1,23.0,100,23,77,las
222,n50,MASTER I,0,17.8,546,97,449,las
223,Random Plâyer,MASTER I,0,17.1,507,87,420,las
224,Chino Rios,MASTER I,0,18.0,438,79,359,las
225,Josecristo,MASTER I,0,15.3,516,79,437,las
226,MamàEstaPresa,MASTER I,0,21.5,302,65,237,las
227,Ingeld,MASTER I,0,14.9,396,59,337,las
228,Ivanovich TFT,MASTER I,0,10.8,537,58,479,las
229,SIMPH,MASTER I,0,20.4,280,57,223,las
230,xXhermaniguiXx,MASTER I,0,19.9,276,55,221,las
231,El Magias TFT,MASTER I,0,18.4,298,55,243,las
232,Xavhi,MASTER I,0,20.6,257,53,204,las
233,khotax,MASTER I,0,15.0,340,51,289,las
234,spartanoperez,MASTER I,0,15.1,317,48,269,las
235,Beldum,MASTER I,0,16.4,280,46,234,las
236,Piash,MASTER I,0,16.5,249,41,208,las
237,Brooklyn Baby,MASTER I,0,24.7,154,38,116,las
238,skeeve,MASTER I,0,17.5,211,37,174,las
239,Darkscreem,MASTER I,0,10.8,279,30,249,las
240,iEgoist,MASTER I,0,13.9,209,29,180,las
241,xTato,MASTER I,0,14.8,183,27,156,las
242,LionLAN,MASTER I,0,28.0,75,21,54,las
243,ikarosdesu,MASTER I,0,16.0,106,17,89,las
244,Fugazi,MASTER I,0,22.9,70,16,54,las
245,Te Xuan Ze,MASTER I,0,10.4,154,16,138,las
246,xFlogger,DIAMOND I,99,15.9,435,69,366,las
247,Im not Frisco,DIAMOND I,99,14.5,214,31,183,las
248,Asolea Tela No,DIAMOND I,93,20.7,300,62,238,las
249,Tob9,DIAMOND I,91,21.7,267,58,209,las
250,FullTimeKiller,DIAMOND I,89,16.2,210,34,176,las
251,manuaj97,DIAMOND I,88,17.2,192,33,159,las
252,Zpeed,DIAMOND I,88,12.7,204,26,178,las
253,Celtiwi,DIAMOND I,87,17.6,278,49,229,las
254,Broncelotee,DIAMOND I,79,14.7,443,65,378,las
255,Cueervoo,DIAMOND I,79,14.8,426,63,363,las
256,sakuraU,DIAMOND I,79,17.7,164,29,135,las
257,Ye Feng,DIAMOND I,78,19.8,374,74,300,las
258,Fuji,DIAMOND I,78,14.5,235,34,201,las
259,GoldenKid,DIAMOND I,77,18.4,820,151,669,las
260,saitosan1,DIAMOND I,75,12.8,870,111,759,las
261,Fifiii,DIAMOND I,75,17.3,370,64,306,las
262,CZ Furudo Nate,DIAMOND I,75,16.8,382,64,318,las
263,miami115,DIAMOND I,75,17.4,345,60,285,las
264,ElPantuGG,DIAMOND I,75,20.4,255,52,203,las
265,Little Rookiee,DIAMOND I,75,20.8,245,51,194,las
266,Yruke,DIAMOND I,75,16.0,300,48,252,las
267,xiduoduo,DIAMOND I,75,21.8,170,37,133,las
268,Gressu,DIAMOND I,75,13.5,259,35,224,las
269,Nicops1231,DIAMOND I,75,16.9,189,32,157,las
270,Doni,DIAMOND I,75,17.0,182,31,151,las
271,dimebag14king,DIAMOND I,74,11.5,452,52,400,las
272,MateDeCoco,DIAMOND I,73,17.0,206,35,171,las
273,Tortuga Inmortal,DIAMOND I,71,13.8,479,66,413,las
274,Areee,DIAMOND I,70,16.5,243,40,203,las
275,Efesum,DIAMOND I,69,17.1,228,39,189,las
276,TuTuRu,DIAMOND I,69,30.4,115,35,80,las
277,TonnyD,DIAMOND I,66,23.3,451,105,346,las
278,AnimalBlanco,DIAMOND I,62,10.7,430,46,384,las
279,Kraft Tilted,DIAMOND I,59,20.5,283,58,225,las
280,pnc123,DIAMOND I,59,18.1,215,39,176,las
281,SargentoFoley,DIAMOND I,59,23.4,107,25,82,las
282,DogeSenpai,DIAMOND I,58,12.1,406,49,357,las
283,V9 Priax,DIAMOND I,56,23.8,143,34,109,las
284,Carlinhoxs,DIAMOND I,56,14.4,167,24,143,las
285,xPaula,DIAMOND I,55,16.9,362,61,301,las
286,AlonsOcean,DIAMOND I,55,12.0,342,41,301,las
287,QuiTaEsMalTe,DIAMOND I,54,18.3,317,58,259,las
288,moisesinho1,DIAMOND I,54,22.1,140,31,109,las
289,67 iq player,DIAMOND I,54,20.8,120,25,95,las
290,Facuu RP,DIAMOND I,53,16.1,454,73,381,las
291,PapáDeNelson,DIAMOND I,53,12.2,376,46,330,las
292,Sirìus,DIAMOND I,53,14.6,233,34,199,las
293,Pinnche,DIAMOND I,52,28.2,223,63,160,las
294,Echex,DIAMOND I,52,21.9,96,21,75,las
295,Sandsword,DIAMOND I,51,18.3,311,57,254,las
296,Kinimaru,DIAMOND I,51,13.9,238,33,205,las
297,Sopere,DIAMOND I,51,15.6,199,31,168,las
298,Zeon06,DIAMOND I,50,14.3,608,87,521,las
299,JoseFill,DIAMOND I,50,16.8,482,81,401,las
300,DEPREDATORXXXX,DIAMOND I,50,13.3,548,73,475,las
301,pancitodemoldee,DIAMOND I,50,13.6,440,60,380,las
302,Elba Ginaso,DIAMOND I,50,20.4,289,59,230,las
303,VEJ,DIAMOND I,50,14.4,409,59,350,las
304,El Chipa,DIAMOND I,50,24.0,221,53,168,las
305,Veni a jugar,DIAMOND I,50,17.3,301,52,249,las
306,TuKoX,DIAMOND I,50,14.7,354,52,302,las
307,ShiroBanee,DIAMOND I,50,11.6,431,50,381,las
308,El Dorainiken,DIAMOND I,50,17.3,277,48,229,las
309,pickleegar,DIAMOND I,50,20.5,219,45,174,las
310,EdsondoSaantos,DIAMOND I,50,16.6,265,44,221,las
311,BelZeButh,DIAMOND I,50,17.8,241,43,198,las
312,Jordan R Belfort,DIAMOND I,50,23.2,181,42,139,las
313,Yogursito,DIAMOND I,50,15.3,275,42,233,las
314,ßunkow,DIAMOND I,50,21.8,170,37,133,las
315,StarPlzTFT,DIAMOND I,50,17.7,209,37,172,las
316,Gatito Grrrrr,DIAMOND I,50,17.2,215,37,178,las
317,QUIEROmitft,DIAMOND I,50,14.8,243,36,207,las
318,RestlesSSouL,DIAMOND I,50,11.6,303,35,268,las
319,tomm1g,DIAMOND I,50,15.7,210,33,177,las
320,Jhisus14,DIAMOND I,50,11.4,288,33,255,las
321,Sadness Xiu,DIAMOND I,50,11.3,283,32,251,las
322,Dim4s,DIAMOND I,50,21.6,139,30,109,las
323,ManuelAIcayaga,DIAMOND I,50,15.5,193,30,163,las
324,Ba5 Menethor,DIAMOND I,50,26.9,104,28,76,las
325,DacerOne,DIAMOND I,50,16.5,170,28,142,las
326,Krayziql,DIAMOND I,50,16.4,158,26,132,las
327,Alapar,DIAMOND I,50,17.9,140,25,115,las
328,Flaco Friky,DIAMOND I,50,14.7,163,24,139,las
329,Super Carlitos,DIAMOND I,46,12.2,532,65,467,las
330,xLuxray729,DIAMOND I,46,22.3,278,62,216,las
331,Barrioneta,DIAMOND I,46,17.8,309,55,254,las
332,PulpoTiernizado,DIAMOND I,46,11.1,413,46,367,las
333,AlexKin,DIAMOND I,45,16.4,434,71,363,las
334,miguelDarkGhot,DIAMOND I,43,11.8,348,41,307,las
335,Sebamegaa,DIAMOND I,42,18.2,556,101,455,las
336,Chedragon,DIAMOND I,42,12.0,358,43,315,las
337,DTW,DIAMOND I,41,14.0,371,52,319,las
338,Braay,DIAMOND I,41,22.1,208,46,162,las
339,Mefistófelez,DIAMOND I,39,16.9,580,98,482,las
340,Shinji Ikarii,DIAMOND I,39,9.8,519,51,468,las
341,Nitrens,DIAMOND I,38,14.8,304,45,259,las
342,DTW 2,DIAMOND I,38,16.7,227,38,189,las
343,Pilinvert,DIAMOND I,38,18.5,162,30,132,las
344,Casi te gano,DIAMOND I,37,8.2,842,69,773,las
345,Ledasor,DIAMOND I,37,20.2,203,41,162,las
346,nicoffir,DIAMOND I,37,17.5,143,25,118,las
347,ProyectD,DIAMOND I,36,14.8,310,46,264,las
348,xllBorquezzz,DIAMOND I,36,19.2,177,34,143,las
349,Evil Puppy,DIAMOND I,35,20.9,699,146,553,las
350,Vorg Zangief,DIAMOND I,35,14.6,343,50,293,las
351,MaurooCARP,DIAMOND I,35,17.9,229,41,188,las
352,Le Suc,DIAMOND I,35,26.1,92,24,68,las
353,Mr Storm,DIAMOND I,34,19.1,622,119,503,las
354,Waiflin,DIAMOND I,34,9.7,391,38,353,las
355,GGetafe,DIAMOND I,32,18.6,539,100,439,las
356,Bladeking107,DIAMOND I,32,14.5,400,58,342,las
357,Leyton0,DIAMOND I,32,20.7,261,54,207,las
358,sebamarosses24,DIAMOND I,32,18.3,251,46,205,las
359,Glitz,DIAMOND I,32,17.4,115,20,95,las
360,SilverChains,DIAMOND I,31,25.2,135,34,101,las
361,Im Tulancelot,DIAMOND I,30,21.3,202,43,159,las
362,Mitsuri Kanroji,DIAMOND I,29,14.9,562,84,478,las
363,9MPRFCT,DIAMOND I,29,13.9,353,49,304,las
364,relax bro,DIAMOND I,29,13.9,344,48,296,las
365,NOT A MONKEY,DIAMOND I,29,13.0,207,27,180,las
366,Dycoop,DIAMOND I,28,18.4,185,34,151,las
367,Khezitho,DIAMOND I,27,19.9,316,63,253,las
368,Cronoz,DIAMOND I,27,21.9,233,51,182,las
369,Gearth,DIAMOND I,27,16.7,156,26,130,las
370,SoyPis,DIAMOND I,26,15.7,567,89,478,las
371,Cheche tft,DIAMOND I,26,17.5,383,67,316,las
372,LionFlashVoice,DIAMOND I,26,13.1,236,31,205,las
373,Ac Comprar Am,DIAMOND I,26,14.5,179,26,153,las
374,thereisnourflvl,DIAMOND I,25,26.8,250,67,183,las
375,elgodi,DIAMOND I,25,22.0,264,58,206,las
376,YinSaori,DIAMOND I,25,21.3,253,54,199,las
377,Øbi,DIAMOND I,25,23.2,211,49,162,las
378,The Unƒørgiven,DIAMOND I,25,15.9,283,45,238,las
379,thepappo,DIAMOND I,25,17.5,234,41,193,las
380,Nerhuk,DIAMOND I,25,13.9,274,38,236,las
381,Farnese,DIAMOND I,23,15.2,481,73,408,las
382,Evasor07,DIAMOND I,23,19.9,201,40,161,las
383,LK Kuty,DIAMOND I,22,15.3,241,37,204,las
384,Shako,DIAMOND I,22,14.3,217,31,186,las
385,Rodd26,DIAMOND I,22,14.0,186,26,160,las
386,The Katarina,DIAMOND I,21,14.3,238,34,204,las
387,Kimarus,DIAMOND I,20,19.9,291,58,233,las
388,AlcaTeD,DIAMOND I,20,13.4,381,51,330,las
389,Mitsukurina,DIAMOND I,20,18.4,217,40,177,las
390,LenzU,DIAMOND I,19,20.8,168,35,133,las
391,No es mi dia bro,DIAMOND I,19,15.6,205,32,173,las
392,kraxs,DIAMOND I,18,14.2,472,67,405,las
393,Kog Mawrley,DIAMOND I,18,19.1,178,34,144,las
394,OzoneX,DIAMOND I,18,20.0,165,33,132,las
395,Bandalians,DIAMOND I,17,14.8,996,147,849,las
396,p Ø L i,DIAMOND I,17,14.3,483,69,414,las
397,Xerwell,DIAMOND I,17,15.5,388,60,328,las
398,thunderboy4000,DIAMOND I,17,11.4,297,34,263,las
399,NovaChron0,DIAMOND I,16,14.1,545,77,468,las
400,Jupeson,DIAMOND I,16,14.0,549,77,472,las
401,Agustin4521,DIAMOND I,16,18.9,359,68,291,las
402,Bersérker 1,DIAMOND I,16,17.4,304,53,251,las
403,Dorre912,DIAMOND I,15,14.2,431,61,370,las
404,RevëntXz,DIAMOND I,15,19.8,177,35,142,las
405,143,DIAMOND I,15,15.2,164,25,139,las
406,Sparks,DIAMOND I,15,17.1,117,20,97,las
407,DAM Cacu,DIAMOND I,14,16.7,209,35,174,las
408,Im Tatan,DIAMOND I,14,17.0,153,26,127,las
409,deBlois,DIAMOND I,13,16.8,321,54,267,las
410,Caver,DIAMOND I,12,14.8,244,36,208,las
411,YvesMad,DIAMOND I,12,22.0,141,31,110,las
412,Teoo01,DIAMOND I,11,18.6,333,62,271,las
413,REPORT PIÑERA BG,DIAMOND I,11,14.6,192,28,164,las
414,EL Empijjado,DIAMOND I,10,13.0,1217,158,1059,las
415,QQPanda,DIAMOND I,10,24.5,159,39,120,las
416,Zelk,DIAMOND I,9,15.6,199,31,168,las
417,Aizer,DIAMOND I,9,15.4,169,26,143,las
418,JacKp0t,DIAMOND I,9,12.5,176,22,154,las
419,SKT Toddy,DIAMOND I,8,12.1,282,34,248,las
420,Howling Abyss,DIAMOND I,8,9.0,200,18,182,las
421,Raceka,DIAMOND I,7,19.0,337,64,273,las
422,YUATI,DIAMOND I,7,17.5,297,52,245,las
423,The SkyDrill,DIAMOND I,7,21.1,104,22,82,las
424,Asterister,DIAMOND I,6,18.6,263,49,214,las
425,ShakeITx,DIAMOND I,6,22.2,203,45,158,las
426,Asteriox,DIAMOND I,6,12.1,224,27,197,las
427,yuukikei,DIAMOND I,5,20.1,339,68,271,las
428,Demiurgø,DIAMOND I,5,15.0,206,31,175,las
429,fenrir1,DIAMOND I,5,23.4,124,29,95,las
430,JHlN TONIC,DIAMOND I,5,11.9,227,27,200,las
431,lManno,DIAMOND I,4,21.6,283,61,222,las
432,elchicolinux,DIAMOND I,4,17.0,324,55,269,las
433,SanteOtero,DIAMOND I,3,15.9,358,57,301,las
434,TFT Skills,DIAMOND I,3,10.5,522,55,467,las
435,Raulvasf,DIAMOND I,2,14.2,331,47,284,las
436,shxpeetheee,DIAMOND I,2,12.6,349,44,305,las
437,Tuche,DIAMOND I,2,10.6,386,41,345,las
438,AKA Mudo,DIAMOND I,2,7.7,481,37,444,las
439,xllBorquezzzz,DIAMOND I,2,19.8,162,32,130,las
440,Athyna,DIAMOND I,1,14.3,461,66,395,las
441,LaPalomaMasSeca,DIAMOND I,1,12.1,547,66,481,las
442,vergilcat,DIAMOND I,1,16.7,216,36,180,las
443,Treshyy,DIAMOND I,1,21.9,114,25,89,las
444,NoobPlayerOfTFT,DIAMOND I,0,10.9,644,70,574,las
445,Lonkiwi,DIAMOND I,0,16.1,422,68,354,las
446,Correator,DIAMOND I,0,17.4,384,67,317,las
447,Fùry,DIAMOND I,0,23.7,274,65,209,las
448,MisterYougi,DIAMOND I,0,18.0,345,62,283,las
449,marm4,DIAMOND I,0,15.6,392,61,331,las
450,sku da cranium,DIAMOND I,0,11.8,517,61,456,las
451,flavve,DIAMOND I,0,18.8,313,59,254,las
452,Sickfiend,DIAMOND I,0,21.6,264,57,207,las
453,ZaKK wyldEee,DIAMOND I,0,20.4,279,57,222,las
454,disgraÇeh,DIAMOND I,0,19.8,288,57,231,las
455,God of Zed,DIAMOND I,0,12.6,406,51,355,las
456,RDX,DIAMOND I,0,22.6,217,49,168,las
457,IFrenchBaguette,DIAMOND I,0,18.8,256,48,208,las
458,Empanadadeatun,DIAMOND I,0,17.6,272,48,224,las
459,GeLoOx,DIAMOND I,0,16.7,287,48,239,las
460,maxiiq,DIAMOND I,0,18.1,259,47,212,las
461,Pal Lobbyt,DIAMOND I,0,12.8,366,47,319,las
462,Warra,DIAMOND I,0,16.1,286,46,240,las
463,STG Elproljm,DIAMOND I,0,11.2,411,46,365,las
464,Fiora y Fauna,DIAMOND I,0,15.4,286,44,242,las
465,Dr Cooper,DIAMOND I,0,18.9,228,43,185,las
466,Zoeciety,DIAMOND I,0,10.2,412,42,370,las
467,Dime Kephrii,DIAMOND I,0,10.1,415,42,373,las
468,CentinelaRosado,DIAMOND I,0,12.0,342,41,301,las
469,Romicop,DIAMOND I,0,18.8,213,40,173,las
470,Tazzadar,DIAMOND I,0,16.3,245,40,205,las
471,Kenshi0,DIAMOND I,0,15.7,248,39,209,las
472,Racsøø,DIAMOND I,0,14.9,262,39,223,las
473,gasegoo1,DIAMOND I,0,17.0,224,38,186,las
474,Alberto Canto,DIAMOND I,0,22.3,166,37,129,las
475,Pablinucu5,DIAMOND I,0,17.4,212,37,175,las
476,ÞŸËKRÖÖŠ TFT,DIAMOND I,0,12.2,304,37,267,las
477,PyschoCabra,DIAMOND I,0,24.6,146,36,110,las
478,Ted,DIAMOND I,0,22.9,157,36,121,las
479,AgusMarco,DIAMOND I,0,14.1,255,36,219,las
480,generaldark,DIAMOND I,0,23.2,151,35,116,las
481,Fearl3ss,DIAMOND I,0,26.4,129,34,95,las
482,leoShiShi,DIAMOND I,0,19.5,174,34,140,las
483,TsubasOSO,DIAMOND I,0,17.5,194,34,160,las
484,uwu,DIAMOND I,0,20.1,164,33,131,las
485,DeathRøw,DIAMOND I,0,16.7,198,33,165,las
486,Alamvre,DIAMOND I,0,16.8,191,32,159,las
487,Luh,DIAMOND I,0,15.9,195,31,164,las
488,WolfsenpaiAwA,DIAMOND I,0,10.7,289,31,258,las
489,LIl Scioli,DIAMOND I,0,13.8,210,29,181,las
490,lotusex,DIAMOND I,0,13.7,212,29,183,las
491,væRge,DIAMOND I,0,16.3,166,27,139,las
492,Cløn,DIAMOND I,0,15.2,177,27,150,las
493,Zelowan,DIAMOND I,0,13.8,189,26,163,las
494,zash9503,DIAMOND I,0,21.6,116,25,91,las
495,KosKeD10S,DIAMOND I,0,17.4,144,25,119,las
496,Dont Ban Lee,DIAMOND I,0,14.5,172,25,147,las
497,elPepi,DIAMOND I,0,13.8,174,24,150,las
498,MichiPulpo,DIAMOND I,0,12.6,190,24,166,las
499,Te Apoyo,DIAMOND I,0,17.7,130,23,107,las
500,NazGúl OP,DIAMOND I,0,12.0,183,22,161,las
1,vx s5683169,CHALLENGER I,1089,24.5,404,99,305,oce
2,Angora,CHALLENGER I,995,26.2,351,92,259,oce
3,KirinSupreme,CHALLENGER I,883,19.6,470,92,378,oce
4,CombatEZ,CHALLENGER I,861,26.1,157,41,116,oce
5,Steve Lau,CHALLENGER I,621,21.6,892,193,699,oce
6,I Want You,CHALLENGER I,574,18.8,576,108,468,oce
7,JimJaam,CHALLENGER I,523,19.6,465,91,374,oce
8,Jacky Xie,CHALLENGER I,465,22.7,401,91,310,oce
9,dz2,CHALLENGER I,459,13.9,452,63,389,oce
10,humperdink,CHALLENGER I,441,17.1,433,74,359,oce
11,Blender Main,CHALLENGER I,440,21.2,179,38,141,oce
12,HatsuneMik,CHALLENGER I,434,25.8,163,42,121,oce
13,Rng28002200,CHALLENGER I,425,21.5,158,34,124,oce
14,ˇPhoenix,CHALLENGER I,403,23.9,314,75,239,oce
15,ilikeud,CHALLENGER I,399,21.8,238,52,186,oce
16,jiaonizuodog,CHALLENGER I,373,18.4,656,121,535,oce
17,chinaLZH,CHALLENGER I,370,22.7,247,56,191,oce
18,thedashuaibi,CHALLENGER I,363,19.7,370,73,297,oce
19,QWERXF,CHALLENGER I,355,21.2,293,62,231,oce
20,Bruceissss,CHALLENGER I,354,18.4,499,92,407,oce
21,yundingle,CHALLENGER I,351,24.1,170,41,129,oce
22,m2att,CHALLENGER I,340,14.9,1012,151,861,oce
23,Son Chae Young,CHALLENGER I,340,19.4,227,44,183,oce
24,MYdi,CHALLENGER I,327,17.5,349,61,288,oce
25,NayiGOJi,CHALLENGER I,324,19.5,277,54,223,oce
26,xg1998,CHALLENGER I,323,16.9,195,33,162,oce
27,ggds4y,CHALLENGER I,320,16.9,361,61,300,oce
28,Jack Griffin,CHALLENGER I,318,13.9,302,42,260,oce
29,BeaBear,CHALLENGER I,317,17.1,334,57,277,oce
30,WIld Sins Main,CHALLENGER I,314,15.2,322,49,273,oce
31,Last Wh1sper,CHALLENGER I,313,22.5,160,36,124,oce
32,Cwute Panda,CHALLENGER I,311,16.9,450,76,374,oce
33,Chatskiiees,CHALLENGER I,308,17.9,525,94,431,oce
34,6324ii,CHALLENGER I,308,28.2,131,37,94,oce
35,smsqs,CHALLENGER I,306,22.7,317,72,245,oce
36,lloydeee,CHALLENGER I,304,20.4,357,73,284,oce
37,Just Mango,CHALLENGER I,303,21.6,314,68,246,oce
38,yuzhibo777,CHALLENGER I,296,19.1,351,67,284,oce
39,3uphonium,CHALLENGER I,295,20.8,288,60,228,oce
40,lovestarrysky,CHALLENGER I,291,17.2,517,89,428,oce
41,Heart1ess,CHALLENGER I,286,20.1,264,53,211,oce
42,fengyingzhong,CHALLENGER I,286,24.4,119,29,90,oce
43,LongYu66,CHALLENGER I,285,17.7,328,58,270,oce
44,sorryimlikethis,CHALLENGER I,281,24.6,264,65,199,oce
45,dodododododododo,CHALLENGER I,278,20.4,1258,257,1001,oce
46,Damon989,CHALLENGER I,276,19.2,198,38,160,oce
47,samesame,CHALLENGER I,274,13.5,466,63,403,oce
48,Jukelord,CHALLENGER I,255,14.8,311,46,265,oce
49,zhangtao666,CHALLENGER I,253,23.3,150,35,115,oce
50,Fallangle,CHALLENGER I,162,19.6,189,37,152,oce
51,Kïng Tryndamere,"GRANDMASTER I
G",350,18.0,427,77,350,oce
52,qp9,"GRANDMASTER I
G",254,15.0,346,52,294,oce
53,Age of Empires 3,"GRANDMASTER I
G",252,13.8,436,60,376,oce
54,Law of the few,"GRANDMASTER I
G",250,13.7,663,91,572,oce
55,Maxilees,"GRANDMASTER I
G",242,16.6,199,33,166,oce
56,hjhukbt,"GRANDMASTER I
G",239,16.7,318,53,265,oce
57,Madnsss,"GRANDMASTER I
G",238,18.5,222,41,181,oce
58,PPAP,"GRANDMASTER I
G",229,13.3,330,44,286,oce
59,Fischball,"GRANDMASTER I
G",229,19.8,172,34,138,oce
60,VNLunar,"GRANDMASTER I
G",223,13.6,323,44,279,oce
61,Reborn Myth,"GRANDMASTER I
G",222,12.5,449,56,393,oce
62,zofou,"GRANDMASTER I
G",211,17.1,409,70,339,oce
63,zyoona,"GRANDMASTER I
G",203,15.1,370,56,314,oce
64,Cyphos,"GRANDMASTER I
G",202,18.1,382,69,313,oce
65,Dunk xiaolu,"GRANDMASTER I
G",200,17.0,447,76,371,oce
66,YILINHHH,"GRANDMASTER I
G",200,15.6,346,54,292,oce
67,Laotie Letsgo,"GRANDMASTER I
G",198,25.2,147,37,110,oce
68,1234mutouren,"GRANDMASTER I
G",198,21.3,94,20,74,oce
69,CampBishop,"GRANDMASTER I
G",194,21.0,252,53,199,oce
70,TheExpIosiveTaco,"GRANDMASTER I
G",193,15.6,225,35,190,oce
71,1ydia233,"GRANDMASTER I
G",189,24.3,111,27,84,oce
72,plplplpp,"GRANDMASTER I
G",185,23.2,250,58,192,oce
73,yyg980422,"GRANDMASTER I
G",184,16.0,306,49,257,oce
74,Fwuffy Panda,"GRANDMASTER I
G",181,24.0,196,47,149,oce
75,txtx233,"GRANDMASTER I
G",181,16.7,252,42,210,oce
76,dxapple,"GRANDMASTER I
G",177,15.2,230,35,195,oce
77,3sansansan,"GRANDMASTER I
G",174,18.4,418,77,341,oce
78,CLMEpapa,"GRANDMASTER I
G",169,18.0,316,57,259,oce
79,Cuttl3fish,"GRANDMASTER I
G",169,11.7,273,32,241,oce
80,MakinSomeBacon,"GRANDMASTER I
G",164,14.2,374,53,321,oce
81,Jinsang,"GRANDMASTER I
G",163,16.9,254,43,211,oce
82,ihjkljg,"GRANDMASTER I
G",155,16.1,229,37,192,oce
83,821,"GRANDMASTER I
G",154,14.6,309,45,264,oce
84,faketuoni,"GRANDMASTER I
G",153,15.0,207,31,176,oce
85,Slayer Bo,"GRANDMASTER I
G",151,17.7,299,53,246,oce
86,klowly,"GRANDMASTER I
G",149,16.9,361,61,300,oce
87,CterMinh,"GRANDMASTER I
G",142,12.7,417,53,364,oce
88,Whisper9897,"GRANDMASTER I
G",140,16.5,139,23,116,oce
89,TonystarkIRON,"GRANDMASTER I
G",135,24.8,125,31,94,oce
90,mxcjs123,"GRANDMASTER I
G",134,17.6,238,42,196,oce
91,kuaileyouxi,"GRANDMASTER I
G",133,23.9,163,39,124,oce
92,king0247,"GRANDMASTER I
G",132,19.3,264,51,213,oce
93,Escha,"GRANDMASTER I
G",129,13.8,581,80,501,oce
94,RedHawk101,"GRANDMASTER I
G",129,22.2,342,76,266,oce
95,Yuki0720,"GRANDMASTER I
G",128,12.2,411,50,361,oce
96,HanDaY,"GRANDMASTER I
G",123,21.6,217,47,170,oce
97,Rainbow Baby huh,"GRANDMASTER I
G",121,14.0,236,33,203,oce
98,cococake,"GRANDMASTER I
G",120,14.4,353,51,302,oce
99,WO DongDongDong,"GRANDMASTER I
G",120,13.0,392,51,341,oce
100,Lethal Zedstarr,"GRANDMASTER I
G",119,11.5,494,57,437,oce
101,VainF,"GRANDMASTER I
G",117,14.2,302,43,259,oce
102,dilisiad,"GRANDMASTER I
G",117,23.3,176,41,135,oce
103,why zyh and pipi,"GRANDMASTER I
G",117,14.3,287,41,246,oce
104,GiveMeGunS,"GRANDMASTER I
G",117,16.6,187,31,156,oce
105,WayneToDieeeeeee,"GRANDMASTER I
G",110,26.3,152,40,112,oce
106,ROKA1713,"GRANDMASTER I
G",109,15.5,534,83,451,oce
107,ImaginaryDragons,"GRANDMASTER I
G",108,11.7,163,19,144,oce
108,AngelMuzi,"GRANDMASTER I
G",106,21.6,153,33,120,oce
109,DarthRoshan,"GRANDMASTER I
G",105,14.2,353,50,303,oce
110,fanfanbaby,"GRANDMASTER I
G",105,30.1,93,28,65,oce
111,huozhigaoxin,"GRANDMASTER I
G",102,16.8,238,40,198,oce
112,jieshao211,"GRANDMASTER I
G",99,18.8,176,33,143,oce
113,WU YAN ZZU,"GRANDMASTER I
G",98,13.9,317,44,273,oce
114,aksidhhdid,"GRANDMASTER I
G",96,17.2,488,84,404,oce
115,zhuodaye,"GRANDMASTER I
G",95,16.3,338,55,283,oce
116,PVC Cai,"GRANDMASTER I
G",95,11.7,420,49,371,oce
117,Jum,"GRANDMASTER I
G",95,17.5,206,36,170,oce
118,vx1123913246,"GRANDMASTER I
G",91,15.7,496,78,418,oce
119,01 04 1999,"GRANDMASTER I
G",88,19.6,189,37,152,oce
120,uilkk925,"GRANDMASTER I
G",84,20.2,173,35,138,oce
121,Side Character,"GRANDMASTER I
G",81,13.0,362,47,315,oce
122,SilencedbymySins,"GRANDMASTER I
G",81,17.4,144,25,119,oce
123,ANTIQUE HEALBOT,"GRANDMASTER I
G",80,15.7,344,54,290,oce
124,Mascot,"GRANDMASTER I
G",78,12.1,265,32,233,oce
125,Mikkey,"GRANDMASTER I
G",74,14.5,276,40,236,oce
126,aicmg11111,"GRANDMASTER I
G",74,26.4,91,24,67,oce
127,Mounty,"GRANDMASTER I
G",73,12.0,568,68,500,oce
128,yastin,"GRANDMASTER I
G",72,17.1,170,29,141,oce
129,Whitelight,"GRANDMASTER I
G",72,22.8,101,23,78,oce
130,11111dingk,"GRANDMASTER I
G",69,14.9,228,34,194,oce
131,CLUBCANTHANDLEME,"GRANDMASTER I
G",68,16.9,308,52,256,oce
132,IllIIIll,"GRANDMASTER I
G",66,16.1,149,24,125,oce
133,WnLyKingKK,"GRANDMASTER I
G",64,16.0,661,106,555,oce
134,Wo Tai Nan Le,"GRANDMASTER I
G",64,14.5,606,88,518,oce
135,free57,"GRANDMASTER I
G",64,35.7,84,30,54,oce
136,Yeddie,"GRANDMASTER I
G",63,10.8,1309,142,1167,oce
137,dier306,"GRANDMASTER I
G",63,18.5,119,22,97,oce
138,ding1978,"GRANDMASTER I
G",62,16.3,233,38,195,oce
139,DegenRolling,"GRANDMASTER I
G",62,34.3,70,24,46,oce
140,jisos,"GRANDMASTER I
G",61,20.9,431,90,341,oce
141,bankaiteam,"GRANDMASTER I
G",60,17.1,280,48,232,oce
142,peppa demon,"GRANDMASTER I
G",60,20.4,147,30,117,oce
143,xiyuluochen,"GRANDMASTER I
G",60,16.8,179,30,149,oce
144,Ni Bie ZouWei le,"GRANDMASTER I
G",59,18.4,653,120,533,oce
145,Mssi1988,"GRANDMASTER I
G",57,20.9,196,41,155,oce
146,BIGBiG12138,"GRANDMASTER I
G",35,18.1,243,44,199,oce
147,When,"GRANDMASTER I
G",31,15.0,300,45,255,oce
148,TFT Yurik,"GRANDMASTER I
G",0,14.8,440,65,375,oce
149,the munter,"GRANDMASTER I
G",0,12.2,238,29,209,oce
150,xiaozhiZP,MASTER I,166,17.8,388,69,319,oce
151,weigaosheng,MASTER I,149,14.0,378,53,325,oce
152,yolonamelyandy,MASTER I,76,19.0,242,46,196,oce
153,yanjiezhenshuai,MASTER I,63,19.4,129,25,104,oce
154,Toby,MASTER I,62,11.6,251,29,222,oce
155,fapaiyuanwm,MASTER I,57,19.0,116,22,94,oce
156,SoccerSupaStar,MASTER I,56,20.2,173,35,138,oce
157,phyre49,MASTER I,54,15.9,372,59,313,oce
158,guooug,MASTER I,52,14.2,197,28,169,oce
159,zhuweiran,MASTER I,51,15.2,375,57,318,oce
160,ASJD957,MASTER I,50,19.7,233,46,187,oce
161,chenshaqi,MASTER I,50,17.0,165,28,137,oce
162,Jenry,MASTER I,49,13.4,186,25,161,oce
163,aa1816,MASTER I,48,15.0,260,39,221,oce
164,dyx0105,MASTER I,47,18.4,196,36,160,oce
165,sexoo1,MASTER I,46,19.2,156,30,126,oce
166,sunshinellll,MASTER I,44,20.7,111,23,88,oce
167,qwsxggo,MASTER I,43,18.0,305,55,250,oce
168,xianqishenjiangl,MASTER I,41,17.3,365,63,302,oce
169,YUKINO013,MASTER I,41,14.1,327,46,281,oce
170,gggyou,MASTER I,40,18.7,171,32,139,oce
171,eeadea,MASTER I,40,17.5,183,32,151,oce
172,jaming,MASTER I,40,16.7,126,21,105,oce
173,qkkaannuu,MASTER I,39,13.9,375,52,323,oce
174,shinlove311,MASTER I,39,18.1,149,27,122,oce
175,Lógic,MASTER I,38,18.2,253,46,207,oce
176,baboda,MASTER I,36,11.5,504,58,446,oce
177,RKGG,MASTER I,36,15.5,232,36,196,oce
178,Maraudaur,MASTER I,35,16.2,544,88,456,oce
179,OldYellow3,MASTER I,35,14.5,304,44,260,oce
180,Zhiend,MASTER I,30,24.8,214,53,161,oce
181,Member,MASTER I,30,13.9,238,33,205,oce
182,tatami,MASTER I,29,16.8,190,32,158,oce
183,ELECENG100SU,MASTER I,29,32.5,86,28,58,oce
184,Grayswandir,MASTER I,28,21.1,152,32,120,oce
185,babyuer,MASTER I,27,22.9,157,36,121,oce
186,Petra,MASTER I,27,22.9,153,35,118,oce
187,aozhourenmeimama,MASTER I,27,26.0,100,26,74,oce
188,gaowei111,MASTER I,26,22.2,171,38,133,oce
189,524510785,MASTER I,26,17.5,154,27,127,oce
190,Mo poisoness,MASTER I,25,18.5,395,73,322,oce
191,I am Fzzf,MASTER I,25,18.9,302,57,245,oce
192,WKY Zui Mei,MASTER I,25,16.1,347,56,291,oce
193,Gilgameshann,MASTER I,25,23.6,144,34,110,oce
194,xiaocaibiiiii,MASTER I,24,17.2,244,42,202,oce
195,mahui521,MASTER I,23,16.6,296,49,247,oce
196,assqbqqq,MASTER I,23,14.5,337,49,288,oce
197,livebored,MASTER I,23,12.8,296,38,258,oce
198,cccccp,MASTER I,22,19.7,233,46,187,oce
199,WYYZQQ,MASTER I,22,15.4,299,46,253,oce
200,Dankk,MASTER I,21,16.0,237,38,199,oce
201,tanhuanjue,MASTER I,21,33.8,80,27,53,oce
202,GGstay,MASTER I,20,14.6,295,43,252,oce
203,haoxintai,MASTER I,19,18.4,174,32,142,oce
204,huya21063703,MASTER I,19,17.5,154,27,127,oce
205,morningPonyo,MASTER I,19,18.2,132,24,108,oce
206,dnn,MASTER I,18,17.1,584,100,484,oce
207,bbllff,MASTER I,18,16.6,290,48,242,oce
208,FPYNMSL,MASTER I,18,23.7,114,27,87,oce
209,Dwyan3 Wade,MASTER I,17,14.6,417,61,356,oce
210,Jando,MASTER I,17,14.3,335,48,287,oce
211,doindog1,MASTER I,16,20.6,287,59,228,oce
212,BiscottiSwarls,MASTER I,16,13.7,344,47,297,oce
213,Nekkiiiii,MASTER I,16,11.5,356,41,315,oce
214,ciwei920,MASTER I,16,19.2,146,28,118,oce
215,cui086,MASTER I,16,23.7,114,27,87,oce
216,dashufangkaiwo,MASTER I,16,10.1,207,21,186,oce
217,uwggwuwhll,MASTER I,15,17.3,289,50,239,oce
218,zhongguoqd,MASTER I,15,15.9,220,35,185,oce
219,KeyaTFT,MASTER I,15,26.6,128,34,94,oce
220,callbobo,MASTER I,15,31.0,71,22,49,oce
221,cgnb,MASTER I,14,20.2,238,48,190,oce
222,jffhjjir,MASTER I,13,22.2,135,30,105,oce
223,DonAlternate,MASTER I,12,20.5,302,62,240,oce
224,Esseker,MASTER I,12,29.8,121,36,85,oce
225,xiaosi2020,MASTER I,11,13.7,364,50,314,oce
226,LollyMan,MASTER I,11,17.6,193,34,159,oce
227,wo5172,MASTER I,11,12.0,191,23,168,oce
228,DD2601,MASTER I,9,16.5,206,34,172,oce
229,weiningyuan,MASTER I,9,19.7,147,29,118,oce
230,MirMing,MASTER I,8,16.2,573,93,480,oce
231,sanxingcaixukun,MASTER I,8,13.3,662,88,574,oce
232,hanlu4522,MASTER I,8,14.1,426,60,366,oce
233,Simon The Miner,MASTER I,8,11.1,352,39,313,oce
234,Zoothefuker,MASTER I,8,25.0,100,25,75,oce
235,King Røck,MASTER I,8,17.9,134,24,110,oce
236,agzmybz,MASTER I,8,18.8,117,22,95,oce
237,JesterFred,MASTER I,7,16.3,301,49,252,oce
238,wudichiji,MASTER I,7,19.3,171,33,138,oce
239,Sephyli,MASTER I,6,16.3,270,44,226,oce
240,251kaikai,MASTER I,6,23.7,156,37,119,oce
241,keljiw,MASTER I,5,19.0,147,28,119,oce
242,muasxy,MASTER I,5,28.9,83,24,59,oce
243,chanllenger4xuxu,MASTER I,5,15.5,155,24,131,oce
244,wuhandage,MASTER I,4,13.7,402,55,347,oce
245,lmllml,MASTER I,4,20.3,192,39,153,oce
246,Focus More,MASTER I,4,37.7,69,26,43,oce
247,superzjq6,MASTER I,4,24.5,94,23,71,oce
248,MrTianD,MASTER I,3,14.5,401,58,343,oce
249,vhugggg,MASTER I,3,10.4,366,38,328,oce
250,Joothefuker,MASTER I,3,25.9,116,30,86,oce
251,dearxiang,MASTER I,3,17.4,92,16,76,oce
252,Stop bite me,MASTER I,2,14.9,726,108,618,oce
253,RNGtlang,MASTER I,2,16.4,281,46,235,oce
254,pokerdd,MASTER I,2,15.2,264,40,224,oce
255,yangduck,MASTER I,1,16.1,461,74,387,oce
256,Tkk and A1in,MASTER I,1,15.7,389,61,328,oce
257,betkhoc,MASTER I,1,21.1,171,36,135,oce
258,bingmoyan,MASTER I,0,16.4,385,63,322,oce
259,Yyangyonglin,MASTER I,0,21.5,288,62,226,oce
260,Becomingme,MASTER I,0,12.8,454,58,396,oce
261,Captaîn Teemo,MASTER I,0,32.0,175,56,119,oce
262,Natural01,MASTER I,0,22.9,245,56,189,oce
263,Silon77,MASTER I,0,15.7,338,53,285,oce
264,eatjin,MASTER I,0,12.9,381,49,332,oce
265,JackAnt,MASTER I,0,24.6,191,47,144,oce
266,annida,MASTER I,0,23.1,195,45,150,oce
267,Letme11,MASTER I,0,14.1,313,44,269,oce
268,Rudolftv,MASTER I,0,14.6,294,43,251,oce
269,Tactics GOD,MASTER I,0,19.8,212,42,170,oce
270,Stanton96,MASTER I,0,18.9,217,41,176,oce
271,dangkeai,MASTER I,0,15.4,259,40,219,oce
272,Notle,MASTER I,0,12.7,315,40,275,oce
273,LovexixizzZ,MASTER I,0,24.4,156,38,118,oce
274,k9night,MASTER I,0,18.2,209,38,171,oce
275,JMJ12138,MASTER I,0,21.4,154,33,121,oce
276,jxxyx007,MASTER I,0,18.8,176,33,143,oce
277,styllll,MASTER I,0,15.5,213,33,180,oce
278,1224,MASTER I,0,19.6,153,30,123,oce
279,knippdghu,MASTER I,0,20.3,138,28,110,oce
280,wljbddmz,MASTER I,0,16.4,171,28,143,oce
281,amazingccc,MASTER I,0,20.0,135,27,108,oce
282,Moon1,MASTER I,0,17.2,157,27,130,oce
283,d0ttY,MASTER I,0,14.1,192,27,165,oce
284,sRongLun,MASTER I,0,18.1,144,26,118,oce
285,frisco,MASTER I,0,11.2,232,26,206,oce
286,TooBreezy,MASTER I,0,13.3,180,24,156,oce
287,iiiiiiuuuuuu,MASTER I,0,15.4,149,23,126,oce
288,TheRealDirtyDan,DIAMOND I,98,11.1,442,49,393,oce
289,wangmiss,DIAMOND I,98,19.9,216,43,173,oce
290,liuyu333,DIAMOND I,98,20.9,167,35,132,oce
291,Thi3ugia98,DIAMOND I,94,14.6,308,45,263,oce
292,ZhuoKing,DIAMOND I,92,15.4,331,51,280,oce
293,OwO Ke Ai Duooo,DIAMOND I,89,14.9,248,37,211,oce
294,wuzyu123,DIAMOND I,89,30.9,68,21,47,oce
295,RONSWANSON,DIAMOND I,88,12.6,151,19,132,oce
296,hemoumouya,DIAMOND I,87,29.4,119,35,84,oce
297,HeartWept,DIAMOND I,85,20.0,260,52,208,oce
298,Bachh,DIAMOND I,85,18.1,237,43,194,oce
299,ssjfirzen,DIAMOND I,83,11.6,1541,179,1362,oce
300,tinyninja,DIAMOND I,82,15.4,553,85,468,oce
301,An arurf player,DIAMOND I,80,10.2,372,38,334,oce
302,2Yunerya,DIAMOND I,78,15.0,401,60,341,oce
303,midtesty,DIAMOND I,78,10.9,412,45,367,oce
304,oubo,DIAMOND I,77,17.9,307,55,252,oce
305,killeen69,DIAMOND I,77,16.4,220,36,184,oce
306,jsqs666,DIAMOND I,76,15.6,186,29,157,oce
307,Soucouyant,DIAMOND I,75,19.2,1133,218,915,oce
308,GooGieMonA,DIAMOND I,75,21.1,603,127,476,oce
309,fatbug gg,DIAMOND I,75,16.3,673,110,563,oce
310,xxxPeter200xxx,DIAMOND I,75,15.0,586,88,498,oce
311,lolamar05,DIAMOND I,75,14.9,557,83,474,oce
312,IInevitable,DIAMOND I,75,16.5,399,66,333,oce
313,cao ni ma 69,DIAMOND I,75,14.4,459,66,393,oce
314,TacticalKorean,DIAMOND I,75,12.4,531,66,465,oce
315,Ethilamwen,DIAMOND I,75,16.7,390,65,325,oce
316,Dosedtns,DIAMOND I,75,20.4,313,64,249,oce
317,Saint Seiya,DIAMOND I,75,13.8,413,57,356,oce
318,janet11corners,DIAMOND I,75,22.5,249,56,193,oce
319,Thoppie,DIAMOND I,75,23.5,187,44,143,oce
320,babadeba,DIAMOND I,75,26.6,154,41,113,oce
321,sivirxin,DIAMOND I,75,17.4,235,41,194,oce
322,Way Too Suave,DIAMOND I,75,17.3,237,41,196,oce
323,overwater,DIAMOND I,75,19.7,188,37,151,oce
324,Nidedad,DIAMOND I,75,22.2,144,32,112,oce
325,Mcteamster,DIAMOND I,75,20.8,149,31,118,oce
326,ncpchina,DIAMOND I,75,25.6,117,30,87,oce
327,Kappa Khameleon,DIAMOND I,75,15.1,185,28,157,oce
328,woodsie093,DIAMOND I,75,16.4,159,26,133,oce
329,Fxxk YOU,DIAMOND I,75,20.5,122,25,97,oce
330,ztddc1,DIAMOND I,75,23.5,102,24,78,oce
331,DoubleShun,DIAMOND I,75,25.0,92,23,69,oce
332,Usefulmoose,DIAMOND I,74,13.6,257,35,222,oce
333,stynb666,DIAMOND I,73,17.7,130,23,107,oce
334,Legolas,DIAMOND I,72,17.3,307,53,254,oce
335,why1221,DIAMOND I,72,24.0,183,44,139,oce
336,fleabag520,DIAMOND I,72,20.0,145,29,116,oce
337,you122,DIAMOND I,71,17.4,403,70,333,oce
338,trunks 4,DIAMOND I,71,12.1,372,45,327,oce
339,yansuixin,DIAMOND I,70,11.4,245,28,217,oce
340,THEbulll,DIAMOND I,69,18.7,214,40,174,oce
341,Tsunemori Akane,DIAMOND I,69,12.7,189,24,165,oce
342,VVVVincent,DIAMOND I,67,15.1,299,45,254,oce
343,Luckyplanck,DIAMOND I,66,21.1,209,44,165,oce
344,buzhiming1111,DIAMOND I,66,20.6,141,29,112,oce
345,jmjQAQ,DIAMOND I,66,24.8,101,25,76,oce
346,asha7454088,DIAMOND I,66,16.3,129,21,108,oce
347,okhaige,DIAMOND I,65,12.9,311,40,271,oce
348,wah fong pei ah,DIAMOND I,64,19.1,383,73,310,oce
349,MaeIstrom,DIAMOND I,64,15.9,132,21,111,oce
350,xinya45,DIAMOND I,63,18.1,421,76,345,oce
351,Quwrof,DIAMOND I,63,15.9,377,60,317,oce
352,MarioShu,DIAMOND I,63,14.8,379,56,323,oce
353,Featherknights,DIAMOND I,63,17.8,213,38,175,oce
354,Michael Draven,DIAMOND I,62,17.7,203,36,167,oce
355,onlydance,DIAMOND I,62,12.9,193,25,168,oce
356,guangdongfoshan,DIAMOND I,61,19.2,146,28,118,oce
357,wggrggt,DIAMOND I,59,23.2,99,23,76,oce
358,Renais,DIAMOND I,57,19.4,247,48,199,oce
359,knlght999,DIAMOND I,57,18.7,182,34,148,oce
360,Do youu know me,DIAMOND I,56,13.0,362,47,315,oce
361,Raichiu,DIAMOND I,56,16.4,183,30,153,oce
362,xiaosuan,DIAMOND I,56,16.2,179,29,150,oce
363,1363082396l,DIAMOND I,55,12.5,487,61,426,oce
364,ffgy655,DIAMOND I,54,11.8,449,53,396,oce
365,zhangxiangxiang,DIAMOND I,54,18.1,248,45,203,oce
366,SeaBoss,DIAMOND I,52,13.5,355,48,307,oce
367,boosdad,DIAMOND I,51,19.5,164,32,132,oce
368,lubenweinib,DIAMOND I,51,17.3,185,32,153,oce
369,Meme Addiction,DIAMOND I,50,18.6,366,68,298,oce
370,xuqwer,DIAMOND I,50,14.5,461,67,394,oce
371,Hér MANGOˇ,DIAMOND I,50,15.4,427,66,361,oce
372,widepeepoGlad,DIAMOND I,50,19.3,327,63,264,oce
373,AZHONG00,DIAMOND I,50,16.1,391,63,328,oce
374,huya008,DIAMOND I,50,24.6,211,52,159,oce
375,orymdzz,DIAMOND I,50,18.0,244,44,200,oce
376,xxxxyg,DIAMOND I,50,15.8,259,41,218,oce
377,qq13277,DIAMOND I,50,23.1,173,40,133,oce
378,ShadowMing,DIAMOND I,50,18.9,212,40,172,oce
379,ccxxcc,DIAMOND I,50,19.3,197,38,159,oce
380,QiWeiL,DIAMOND I,50,17.3,220,38,182,oce
381,herdey,DIAMOND I,50,15.0,240,36,204,oce
382,Whoopss,DIAMOND I,50,13.3,263,35,228,oce
383,sj9527,DIAMOND I,50,13.7,233,32,201,oce
384,aoligeiiiiiii,DIAMOND I,50,17.4,172,30,142,oce
385,s1y2f3,DIAMOND I,50,14.0,171,24,147,oce
386,Arend,DIAMOND I,50,16.0,106,17,89,oce
387,yuxuhui666,DIAMOND I,50,12.1,141,17,124,oce
388,ggoalpick,DIAMOND I,49,19.6,92,18,74,oce
389,zhengdejiaoqi,DIAMOND I,47,16.8,131,22,109,oce
390,P pEacH QoO,DIAMOND I,46,15.1,555,84,471,oce
391,AiryLaMenteuse,DIAMOND I,46,13.9,202,28,174,oce
392,Abusteif,DIAMOND I,46,15.7,153,24,129,oce
393,fxyammm,DIAMOND I,46,22.6,93,21,72,oce
394,Cngoodman,DIAMOND I,46,18.9,111,21,90,oce
395,Omnî,DIAMOND I,45,26.5,894,237,657,oce
396,P goon,DIAMOND I,45,16.4,908,149,759,oce
397,Camm,DIAMOND I,45,17.1,650,111,539,oce
398,lionqq,DIAMOND I,45,15.2,428,65,363,oce
399,liranxin,DIAMOND I,45,10.9,275,30,245,oce
400,coolzt,DIAMOND I,45,17.0,159,27,132,oce
401,Donaldin0,DIAMOND I,44,13.2,440,58,382,oce
402,Its Cupcake,DIAMOND I,44,14.6,253,37,216,oce
403,1943,DIAMOND I,44,24.5,94,23,71,oce
404,liontiger,DIAMOND I,43,24.0,121,29,92,oce
405,Prowlore,DIAMOND I,43,12.3,236,29,207,oce
406,youngAny,DIAMOND I,43,16.3,147,24,123,oce
407,lovelykog,DIAMOND I,43,16.4,128,21,107,oce
408,IFEEDNREPORTEAM,DIAMOND I,41,16.6,283,47,236,oce
409,huanyingjiw,DIAMOND I,41,13.0,246,32,214,oce
410,Lssxxs,DIAMOND I,41,15.6,167,26,141,oce
411,wanfan1999,DIAMOND I,40,14.1,341,48,293,oce
412,huhehe666,DIAMOND I,40,17.5,200,35,165,oce
413,xiaohanggege,DIAMOND I,39,17.3,231,40,191,oce
414,tw Kevin,DIAMOND I,39,17.5,223,39,184,oce
415,jiushishen,DIAMOND I,38,18.7,155,29,126,oce
416,gggggggggggggsl,DIAMOND I,38,14.3,196,28,168,oce
417,MagicalBlond,DIAMOND I,37,17.4,207,36,171,oce
418,zuan4fangguowo,DIAMOND I,37,17.2,197,34,163,oce
419,111iidj,DIAMOND I,37,24.7,89,22,67,oce
420,Naix WifeSlayer,DIAMOND I,36,17.4,270,47,223,oce
421,Cai Xu Kun,DIAMOND I,36,14.3,182,26,156,oce
422,Shriic,DIAMOND I,36,10.2,196,20,176,oce
423,roadk8ller,DIAMOND I,35,19.4,217,42,175,oce
424,stillaliveuzi,DIAMOND I,35,15.9,233,37,196,oce
425,LiSTang,DIAMOND I,34,14.9,416,62,354,oce
426,PSimmashoot,DIAMOND I,34,13.5,282,38,244,oce
427,JinGuGuGu,DIAMOND I,33,19.1,199,38,161,oce
428,xr0000,DIAMOND I,32,17.6,295,52,243,oce
429,drfsd61,DIAMOND I,32,16.3,251,41,210,oce
430,Haober,DIAMOND I,32,26.2,145,38,107,oce
431,ioiioiioi3,DIAMOND I,32,21.4,126,27,99,oce
432,TFBOYSBb,DIAMOND I,32,19.8,101,20,81,oce
433,zzaffffff,DIAMOND I,31,20.2,272,55,217,oce
434,S2mple1,DIAMOND I,31,17.5,234,41,193,oce
435,roflwhatever,DIAMOND I,31,26.9,93,25,68,oce
436,WhatULooking4,DIAMOND I,31,15.0,160,24,136,oce
437,Daechang92,DIAMOND I,30,6.8,603,41,562,oce
438,Janná,DIAMOND I,30,17.4,219,38,181,oce
439,peace2020,DIAMOND I,29,20.9,201,42,159,oce
440,camcamca,DIAMOND I,29,24.7,97,24,73,oce
441,Gmmm77,DIAMOND I,28,17.5,240,42,198,oce
442,Razza,DIAMOND I,28,14.6,178,26,152,oce
443,EffortIess,DIAMOND I,27,23.8,105,25,80,oce
444,Young Fizz,DIAMOND I,26,19.4,578,112,466,oce
445,99997w,DIAMOND I,26,24.2,194,47,147,oce
446,VX   wwp997521,DIAMOND I,25,19.3,280,54,226,oce
447,Mads Mikkelsen,DIAMOND I,25,12.7,401,51,350,oce
448,kiyomirl,DIAMOND I,25,14.4,264,38,226,oce
449,ZacharyC,DIAMOND I,25,16.2,185,30,155,oce
450,MakeNoSence,DIAMOND I,25,10.4,278,29,249,oce
451,BeegChonker,DIAMOND I,24,17.6,119,21,98,oce
452,heishelifu,DIAMOND I,23,24.2,186,45,141,oce
453,Zheng8,DIAMOND I,23,14.2,310,44,266,oce
454,Lexzy,DIAMOND I,23,11.1,371,41,330,oce
455,xw2000,DIAMOND I,23,17.0,176,30,146,oce
456,CLAER7,DIAMOND I,22,16.5,188,31,157,oce
457,XiYangYang CN,DIAMOND I,21,17.8,208,37,171,oce
458,QuInD,DIAMOND I,21,13.4,239,32,207,oce
459,TiananomenSquare,DIAMOND I,20,17.1,164,28,136,oce
460,FapaiyuanDemon,DIAMOND I,20,24.2,91,22,69,oce
461,wanmgc,DIAMOND I,19,11.2,312,35,277,oce
462,ROG NO1 Chairman,DIAMOND I,19,18.0,111,20,91,oce
463,mengmeng95,DIAMOND I,18,15.5,303,47,256,oce
464,ImNotBen,DIAMOND I,18,13.9,309,43,266,oce
465,Kazsaix,DIAMOND I,18,17.8,214,38,176,oce
466,huangtian123,DIAMOND I,18,19.6,138,27,111,oce
467,boomandbewm,DIAMOND I,17,15.8,525,83,442,oce
468,wlzcyx,DIAMOND I,17,17.5,378,66,312,oce
469,sudoowoodo,DIAMOND I,17,18.1,299,54,245,oce
470,Kaze Meiji,DIAMOND I,17,15.1,265,40,225,oce
471,kingswenxa,DIAMOND I,17,9.7,413,40,373,oce
472,dhl666,DIAMOND I,17,22.9,144,33,111,oce
473,11233a,DIAMOND I,17,13.4,247,33,214,oce
474,newcpdown,DIAMOND I,17,16.1,193,31,162,oce
475,Energy,DIAMOND I,16,14.4,201,29,172,oce
476,Jie1217,DIAMOND I,16,22.2,81,18,63,oce
477,QQloveddme,DIAMOND I,15,15.8,423,67,356,oce
478,Erić,DIAMOND I,15,12.3,348,43,305,oce
479,IG HuShen,DIAMOND I,15,20.1,204,41,163,oce
480,LLL016432,DIAMOND I,15,10.1,247,25,222,oce
481,Mo Maek xx,DIAMOND I,14,15.3,288,44,244,oce
482,wawkwakw,DIAMOND I,14,21.1,123,26,97,oce
483,InfestorTerran,DIAMOND I,13,17.8,258,46,212,oce
484,NamiAndChips,DIAMOND I,13,14.6,302,44,258,oce
485,Luwiio,DIAMOND I,12,17.8,349,62,287,oce
486,tenseigannn,DIAMOND I,11,13.0,292,38,254,oce
487,L3eT,DIAMOND I,11,13.2,219,29,190,oce
488,LYLYCMX,DIAMOND I,11,11.4,210,24,186,oce
489,fyiiiiii,DIAMOND I,10,15.2,448,68,380,oce
490,TheLittleBaws,DIAMOND I,10,14.9,428,64,364,oce
491,iKilledLAG,DIAMOND I,10,14.2,302,43,259,oce
492,AP Lucian,DIAMOND I,9,14.1,227,32,195,oce
493,yudi123,DIAMOND I,9,17.9,145,26,119,oce
494,yyy599795,DIAMOND I,9,12.2,205,25,180,oce
495,ColorblindJGWins,DIAMOND I,9,13.2,182,24,158,oce
496,StoopiDx,DIAMOND I,8,18.3,273,50,223,oce
497,wxy999,DIAMOND I,8,17.7,237,42,195,oce
498,Forget,DIAMOND I,8,19.3,171,33,138,oce
499,woshizhuh,DIAMOND I,8,18.4,163,30,133,oce
500,Huaking,DIAMOND I,8,17.8,135,24,111,oce
1,kinqmusti43,CHALLENGER I,1578,25.4,524,133,391,tr
2,Rubic,CHALLENGER I,1574,26.8,628,168,460,tr
3,MAD JOSEPH,CHALLENGER I,1263,19.9,624,124,500,tr
4,speedruzlol,CHALLENGER I,1108,24.6,439,108,331,tr
5,MAD JOSEPH 2,CHALLENGER I,962,25.0,300,75,225,tr
6,Stay ruthless,CHALLENGER I,780,27.5,781,215,566,tr
7,Benedetto,CHALLENGER I,780,22.7,330,75,255,tr
8,Ayenbe,CHALLENGER I,774,26.6,259,69,190,tr
9,keLch,CHALLENGER I,686,22.8,346,79,267,tr
10,jan uma,CHALLENGER I,639,22.0,250,55,195,tr
11,Jok3r xx,CHALLENGER I,612,21.7,295,64,231,tr
12,NİZİPLİİİ,CHALLENGER I,611,21.8,879,192,687,tr
13,Jenerik,CHALLENGER I,553,22.6,252,57,195,tr
14,Liquidzer,CHALLENGER I,535,18.4,450,83,367,tr
15,Jthie,CHALLENGER I,521,21.1,256,54,202,tr
16,GreatEagle,CHALLENGER I,508,19.0,385,73,312,tr
17,Waiden,CHALLENGER I,482,18.3,831,152,679,tr
18,lAdastra,CHALLENGER I,478,20.0,541,108,433,tr
19,SİVASLI PONÇİK,CHALLENGER I,468,16.0,337,54,283,tr
20,clssJaGG,CHALLENGER I,466,15.2,724,110,614,tr
21,Jonas Salk,CHALLENGER I,466,11.8,599,71,528,tr
22,Daldım Kazdım,CHALLENGER I,465,22.9,284,65,219,tr
23,MAC MASCARA,CHALLENGER I,457,14.9,591,88,503,tr
24,bestâ,CHALLENGER I,455,21.9,361,79,282,tr
25,zikerr,CHALLENGER I,455,14.9,517,77,440,tr
26,Meglendiel,CHALLENGER I,451,17.0,710,121,589,tr
27,FeelingTheBlanks,CHALLENGER I,439,11.9,478,57,421,tr
28,Morte D Amour,CHALLENGER I,429,16.6,646,107,539,tr
29,Perceid TFT,CHALLENGER I,426,24.5,139,34,105,tr
30,SunChos,CHALLENGER I,410,14.8,985,146,839,tr
31,Darksword02,CHALLENGER I,405,16.2,782,127,655,tr
32,TFT Colorâblê v2,CHALLENGER I,398,15.2,230,35,195,tr
33,Slay,CHALLENGER I,380,21.2,241,51,190,tr
34,Nîtratex,CHALLENGER I,366,10.6,407,43,364,tr
35,mettuzwee,CHALLENGER I,357,25.7,179,46,133,tr
36,11 04 2004,CHALLENGER I,350,14.5,495,72,423,tr
37,MUHENDİSBEY TFT,CHALLENGER I,342,17.1,403,69,334,tr
38,Rapscallion FK,CHALLENGER I,340,21.0,467,98,369,tr
39,NEXTENAAA,CHALLENGER I,339,18.4,255,47,208,tr
40,Shinzu,CHALLENGER I,330,10.0,500,50,450,tr
41,TFT Colorâblê,CHALLENGER I,329,16.1,211,34,177,tr
42,StahpItRito v2,CHALLENGER I,321,21.8,174,38,136,tr
43,THE BOSS PALA,CHALLENGER I,313,13.6,359,49,310,tr
44,BrushLeee,CHALLENGER I,312,15.7,172,27,145,tr
45,Discronatia,CHALLENGER I,311,16.7,323,54,269,tr
46,sefaFluxx,CHALLENGER I,309,19.2,948,182,766,tr
47,Spanker HS,CHALLENGER I,309,20.4,550,112,438,tr
48,ŁuciâN,CHALLENGER I,309,13.9,346,48,298,tr
49,Skinner27,CHALLENGER I,305,22.1,145,32,113,tr
50,Troll Bir Nick,CHALLENGER I,301,19.1,857,164,693,tr
51,TFT Ołrïc,"GRANDMASTER I
G",288,13.6,213,29,184,tr
52,StahpItRito,"GRANDMASTER I
G",275,25.3,182,46,136,tr
53,No Life Ceset,"GRANDMASTER I
G",252,17.9,669,120,549,tr
54,9x37,"GRANDMASTER I
G",246,14.6,604,88,516,tr
55,ƒallenGod,"GRANDMASTER I
G",240,20.1,308,62,246,tr
56,Sayonara Baby,"GRANDMASTER I
G",230,11.9,899,107,792,tr
57,ForyuS,"GRANDMASTER I
G",230,10.6,907,96,811,tr
58,Luca Toni,"GRANDMASTER I
G",229,17.1,239,41,198,tr
59,Top 8,"GRANDMASTER I
G",219,25.1,247,62,185,tr
60,TEOİSTİK,"GRANDMASTER I
G",218,13.4,329,44,285,tr
61,Phoebe,"GRANDMASTER I
G",216,19.0,373,71,302,tr
62,Furriya,"GRANDMASTER I
G",215,17.7,249,44,205,tr
63,canadianturkey,"GRANDMASTER I
G",208,24.4,168,41,127,tr
64,Prenses Irelia,"GRANDMASTER I
G",205,14.0,563,79,484,tr
65,Jâsper,"GRANDMASTER I
G",195,18.8,176,33,143,tr
66,Kemal KS,"GRANDMASTER I
G",186,15.9,673,107,566,tr
67,Riven İs Mine,"GRANDMASTER I
G",171,17.8,264,47,217,tr
68,caglar128,"GRANDMASTER I
G",166,13.6,221,30,191,tr
69,Bir Spartalı,"GRANDMASTER I
G",162,17.4,270,47,223,tr
70,qR Kai Hiwatari,"GRANDMASTER I
G",160,11.1,343,38,305,tr
71,play for a fun,"GRANDMASTER I
G",158,18.4,250,46,204,tr
72,ATC Bulbasaur,"GRANDMASTER I
G",151,17.4,242,42,200,tr
73,ŹéÐáñìêłš,"GRANDMASTER I
G",144,13.4,681,91,590,tr
74,KÜNEFE,"GRANDMASTER I
G",143,15.8,240,38,202,tr
75,Beramusluu TFT,"GRANDMASTER I
G",140,15.4,466,72,394,tr
76,Groove Street CJ,"GRANDMASTER I
G",140,11.3,539,61,478,tr
77,ÇopurBey,"GRANDMASTER I
G",138,11.7,832,97,735,tr
78,GotchaAssBoy,"GRANDMASTER I
G",129,25.8,120,31,89,tr
79,Basden,"GRANDMASTER I
G",124,18.0,450,81,369,tr
80,Dr Manhattan,"GRANDMASTER I
G",124,20.8,240,50,190,tr
81,slowly sari,"GRANDMASTER I
G",124,17.1,286,49,237,tr
82,elyêl,"GRANDMASTER I
G",120,22.5,488,110,378,tr
83,Boxerli Arap,"GRANDMASTER I
G",120,23.3,266,62,204,tr
84,BeeepbeepimaJeep,"GRANDMASTER I
G",120,15.9,208,33,175,tr
85,Motosho,"GRANDMASTER I
G",119,20.2,248,50,198,tr
86,selo sama hd,"GRANDMASTER I
G",119,16.1,149,24,125,tr
87,Kara Sevdalım,"GRANDMASTER I
G",117,19.1,681,130,551,tr
88,SUQ MADİK,"GRANDMASTER I
G",116,18.7,230,43,187,tr
89,Sağtık CEBO,"GRANDMASTER I
G",115,10.9,457,50,407,tr
90,DT Escanor,"GRANDMASTER I
G",114,15.2,250,38,212,tr
91,Ruheass,"GRANDMASTER I
G",112,18.0,445,80,365,tr
92,Berke İnan,"GRANDMASTER I
G",106,16.6,265,44,221,tr
93,AxiBy,"GRANDMASTER I
G",105,14.9,572,85,487,tr
94,Plug,"GRANDMASTER I
G",104,16.4,384,63,321,tr
95,Sir BÂGÎ,"GRANDMASTER I
G",102,12.1,372,45,327,tr
96,valiumx,"GRANDMASTER I
G",100,11.7,924,108,816,tr
97,T H O S U N,"GRANDMASTER I
G",93,16.8,202,34,168,tr
98,xTCxINFLAMES,"GRANDMASTER I
G",91,10.2,462,47,415,tr
99,Punaise,"GRANDMASTER I
G",86,12.3,1115,137,978,tr
100,MrDdad,"GRANDMASTER I
G",86,20.1,377,76,301,tr
101,Pressure Fatih,"GRANDMASTER I
G",84,16.9,189,32,157,tr
102,Gollum TFT,"GRANDMASTER I
G",83,16.7,456,76,380,tr
103,wraıth slayer,"GRANDMASTER I
G",81,16.1,224,36,188,tr
104,w0lverinee,"GRANDMASTER I
G",80,15.2,1028,156,872,tr
105,Kral Leonidass,"GRANDMASTER I
G",79,13.3,816,109,707,tr
106,guido05,"GRANDMASTER I
G",78,14.1,305,43,262,tr
107,ImCurly,"GRANDMASTER I
G",77,16.5,643,106,537,tr
108,Apo sen misin la,"GRANDMASTER I
G",75,17.3,330,57,273,tr
109,CacaReyiz1907,"GRANDMASTER I
G",72,13.2,705,93,612,tr
110,itsAƒucknComedy,"GRANDMASTER I
G",71,14.7,252,37,215,tr
111,My0neSS,"GRANDMASTER I
G",70,17.4,865,151,714,tr
112,Maegi,"GRANDMASTER I
G",70,17.3,336,58,278,tr
113,Ragyo,"GRANDMASTER I
G",69,17.1,828,142,686,tr
114,Im Ventum,"GRANDMASTER I
G",69,10.1,396,40,356,tr
115,TRANSFOURGOT,"GRANDMASTER I
G",68,8.3,217,18,199,tr
116,Nö1 TFT,"GRANDMASTER I
G",64,13.6,352,48,304,tr
117,AcviLion,"GRANDMASTER I
G",63,16.9,445,75,370,tr
118,ReachijaX,"GRANDMASTER I
G",61,13.3,820,109,711,tr
119,cropovez,"GRANDMASTER I
G",58,12.7,220,28,192,tr
120,ISGT PeaceI,"GRANDMASTER I
G",57,15.2,145,22,123,tr
121,WestosTFT,"GRANDMASTER I
G",55,10.5,332,35,297,tr
122,TFT CEBO,"GRANDMASTER I
G",54,14.6,151,22,129,tr
123,Slvers Rayleigh,"GRANDMASTER I
G",53,17.2,284,49,235,tr
124,THEPRAT,"GRANDMASTER I
G",53,11.7,403,47,356,tr
125,KissKissBangBang,"GRANDMASTER I
G",52,13.9,695,97,598,tr
126,Xaviertz,"GRANDMASTER I
G",51,18.0,389,70,319,tr
127,Mutsuz,"GRANDMASTER I
G",50,13.8,196,27,169,tr
128,sads,"GRANDMASTER I
G",49,15.7,509,80,429,tr
129,MhmtAkgl,"GRANDMASTER I
G",49,13.3,600,80,520,tr
130,KimbuLeyla,"GRANDMASTER I
G",49,16.8,149,25,124,tr
131,Thanos Pyke,"GRANDMASTER I
G",48,16.0,356,57,299,tr
132,Coria,"GRANDMASTER I
G",48,15.0,373,56,317,tr
133,Terryfold,"GRANDMASTER I
G",48,24.8,113,28,85,tr
134,N0NNstar,"GRANDMASTER I
G",47,16.7,442,74,368,tr
135,asvpxtitan,"GRANDMASTER I
G",46,13.8,671,93,578,tr
136,NeSBiTFoX,"GRANDMASTER I
G",46,18.5,379,70,309,tr
137,mFatality,"GRANDMASTER I
G",46,12.6,538,68,470,tr
138,MjoInir,"GRANDMASTER I
G",44,18.6,343,64,279,tr
139,Castiel2897,"GRANDMASTER I
G",44,18.1,271,49,222,tr
140,Usta Splinterr,"GRANDMASTER I
G",40,13.6,228,31,197,tr
141,bertugrul,"GRANDMASTER I
G",39,19.9,241,48,193,tr
142,Irrepressible,"GRANDMASTER I
G",38,17.6,261,46,215,tr
143,TFT Orfane,"GRANDMASTER I
G",37,17.5,332,58,274,tr
144,Doğay,"GRANDMASTER I
G",36,18.9,249,47,202,tr
145,ShittyName,"GRANDMASTER I
G",36,18.9,227,43,184,tr
146,xlProDRoMaLlx,"GRANDMASTER I
G",35,15.0,207,31,176,tr
147,LordCampus,"GRANDMASTER I
G",32,18.9,307,58,249,tr
148,WhackyLuck,"GRANDMASTER I
G",31,16.3,465,76,389,tr
149,veifanN,"GRANDMASTER I
G",31,24.6,244,60,184,tr
150,MertTFT,"GRANDMASTER I
G",31,12.4,331,41,290,tr
151,Boşver,MASTER I,30,18.3,459,84,375,tr
152,blobfısh,MASTER I,30,14.4,327,47,280,tr
153,ÇokTaRinTinTinV2,MASTER I,29,18.2,396,72,324,tr
154,ExeSus v1,MASTER I,28,14.2,718,102,616,tr
155,ll Mr Yılmâz TFT,MASTER I,27,15.1,405,61,344,tr
156,SKT X,MASTER I,27,12.3,447,55,392,tr
157,John Scatt,MASTER I,26,17.0,112,19,93,tr
158,Bosch Aldım,MASTER I,23,13.8,332,46,286,tr
159,AsiTatanqa,MASTER I,23,11.8,365,43,322,tr
160,TheBigWal,MASTER I,23,11.8,221,26,195,tr
161,IV Sentinel,MASTER I,22,17.6,523,92,431,tr
162,Techila,MASTER I,21,17.1,252,43,209,tr
163,Kubilata,MASTER I,21,18.4,147,27,120,tr
164,Beysal,MASTER I,19,23.1,208,48,160,tr
165,Prince Rhaegar,MASTER I,19,12.2,302,37,265,tr
166,ÜSTADIM,MASTER I,19,12.1,280,34,246,tr
167,idlemonkk,MASTER I,18,20.6,398,82,316,tr
168,hknelmsua,MASTER I,18,19.9,221,44,177,tr
169,İqos,MASTER I,17,21.5,321,69,252,tr
170,HattoriZarbo,MASTER I,17,15.7,306,48,258,tr
171,UnknownZ7,MASTER I,17,16.7,203,34,169,tr
172,Electus1,MASTER I,16,20.2,489,99,390,tr
173,ArcHaic,MASTER I,16,18.6,231,43,188,tr
174,serseratx,MASTER I,16,15.1,251,38,213,tr
175,KaanGultekin,MASTER I,16,20.4,176,36,140,tr
176,artyomdh,MASTER I,16,19.9,136,27,109,tr
177,Nerva,MASTER I,15,13.7,212,29,183,tr
178,Ralphan,MASTER I,12,15.9,744,118,626,tr
179,Ratom,MASTER I,12,19.9,332,66,266,tr
180,Necessarium,MASTER I,11,13.9,237,33,204,tr
181,Xenopa,MASTER I,9,14.3,196,28,168,tr
182,BEN THRESH NABER,MASTER I,9,12.3,220,27,193,tr
183,mustafa1t,MASTER I,7,9.8,592,58,534,tr
184,Fenrîr,MASTER I,6,14.1,474,67,407,tr
185,AçılnBenDokturm,MASTER I,6,16.5,261,43,218,tr
186,PARA,MASTER I,6,17.4,224,39,185,tr
187,Qyrieq,MASTER I,6,9.1,242,22,220,tr
188,Reis Back,MASTER I,4,12.1,340,41,299,tr
189,JoeHart35,MASTER I,4,19.0,137,26,111,tr
190,AshleyG,MASTER I,3,12.3,543,67,476,tr
191,ecivecivokkemj,MASTER I,3,21.2,165,35,130,tr
192,Simurg TFT,MASTER I,2,21.2,160,34,126,tr
193,diwine fish,MASTER I,2,21.4,154,33,121,tr
194,Plug v2,MASTER I,2,21.1,152,32,120,tr
195,Rydec,MASTER I,2,15.5,194,30,164,tr
196,nasty rabbit,MASTER I,2,29.3,92,27,65,tr
197,PSG CAT,MASTER I,1,17.0,276,47,229,tr
198,Hyperr roll babe,MASTER I,1,19.6,107,21,86,tr
199,hi im KeNji ea,MASTER I,0,13.1,756,99,657,tr
200,Bihter ZiyagiI,MASTER I,0,13.4,618,83,535,tr
201,Night Train,MASTER I,0,14.6,540,79,461,tr
202,ÜzeyirBey,MASTER I,0,18.0,423,76,347,tr
203,GrevenLosT,MASTER I,0,12.5,608,76,532,tr
204,MhRayleiphosor,MASTER I,0,20.5,297,61,236,tr
205,YaşaMustafaKemal,MASTER I,0,10.6,577,61,516,tr
206,Sendoh7,MASTER I,0,18.3,317,58,259,tr
207,COKKOTUOLDUBU,MASTER I,0,24.0,204,49,155,tr
208,LeqacyOfKaiN,MASTER I,0,14.6,322,47,275,tr
209,Rykes,MASTER I,0,17.1,263,45,218,tr
210,chessplayer752,MASTER I,0,12.8,343,44,299,tr
211,ÃŁÞhÃ,MASTER I,0,20.6,199,41,158,tr
212,ZaD,MASTER I,0,15.6,250,39,211,tr
213,KELTOŞ İRFAN xD,MASTER I,0,16.6,229,38,191,tr
214,The Ârt of Zed,MASTER I,0,19.2,161,31,130,tr
215,Durp,MASTER I,0,18.8,160,30,130,tr
216,Oscar Bey,MASTER I,0,10.0,299,30,269,tr
217,bigballsman,MASTER I,0,31.8,85,27,58,tr
218,bunupthedance,MASTER I,0,30.7,88,27,61,tr
219,ADAMLJAJİC,MASTER I,0,30.9,68,21,47,tr
220,HardcCcore XL,MASTER I,0,10.1,139,14,125,tr
221,Sinjeog Jonjae,DIAMOND I,99,21.0,229,48,181,tr
222,Rüzgâr TFT,DIAMOND I,95,22.9,153,35,118,tr
223,caydas,DIAMOND I,94,16.5,599,99,500,tr
224,Useless Shaco,DIAMOND I,93,15.4,566,87,479,tr
225,Mahluk,DIAMOND I,91,25.3,340,86,254,tr
226,IIIMeA CuLpAIII,DIAMOND I,90,16.2,173,28,145,tr
227,BABALARIN AHMET,DIAMOND I,86,13.8,469,65,404,tr
228,Alzerrax,DIAMOND I,84,22.6,208,47,161,tr
229,SÊßØ,DIAMOND I,83,17.1,304,52,252,tr
230,Hatır Huturoğlu,DIAMOND I,80,14.6,151,22,129,tr
231,SCARFÆCE,DIAMOND I,78,16.3,202,33,169,tr
232,SuBA x,DIAMOND I,77,5.6,691,39,652,tr
233,Drdilatory,DIAMOND I,76,18.2,417,76,341,tr
234,UMP,DIAMOND I,76,24.5,188,46,142,tr
235,ExTaCy xL,DIAMOND I,75,16.5,834,138,696,tr
236,MIVAC,DIAMOND I,75,28.3,389,110,279,tr
237,JesterB,DIAMOND I,75,18.0,532,96,436,tr
238,Rescue 5,DIAMOND I,75,20.4,343,70,273,tr
239,Justin FoIey,DIAMOND I,75,21.4,317,68,249,tr
240,Blodreina TFT,DIAMOND I,75,16.2,408,66,342,tr
241,jesica xd,DIAMOND I,75,15.9,414,66,348,tr
242,No come turkey,DIAMOND I,75,29.7,219,65,154,tr
243,Zoe the Gypsy,DIAMOND I,75,12.8,484,62,422,tr
244,EazyPz,DIAMOND I,75,21.7,253,55,198,tr
245,Lynter,DIAMOND I,75,16.6,331,55,276,tr
246,Taş,DIAMOND I,75,26.1,207,54,153,tr
247,Mythug,DIAMOND I,75,14.1,375,53,322,tr
248,yaegan,DIAMOND I,75,16.5,285,47,238,tr
249,tobiwan cannabis,DIAMOND I,75,21.1,213,45,168,tr
250,YVSKUTSAMACI,DIAMOND I,75,16.0,275,44,231,tr
251,twnku,DIAMOND I,75,23.6,178,42,136,tr
252,KartoncuSevo,DIAMOND I,75,23.1,173,40,133,tr
253,Gelfling,DIAMOND I,75,23.8,164,39,125,tr
254,BarRraK,DIAMOND I,75,16.3,215,35,180,tr
255,Mindutio,DIAMOND I,75,15.8,221,35,186,tr
256,Skadia,DIAMOND I,75,27.0,126,34,92,tr
257,TFT Mastèr,DIAMOND I,75,19.3,176,34,142,tr
258,Aproxima,DIAMOND I,75,16.8,202,34,168,tr
259,lYouMustDiel,DIAMOND I,75,19.5,164,32,132,tr
260,endiska,DIAMOND I,75,26.4,110,29,81,tr
261,Hugiin,DIAMOND I,75,13.6,177,24,153,tr
262,FedaMaster,DIAMOND I,75,21.0,100,21,79,tr
263,Miller Urey X,DIAMOND I,74,16.8,280,47,233,tr
264,Archelaus,DIAMOND I,74,31.0,100,31,69,tr
265,Phenomenal213,DIAMOND I,74,13.8,166,23,143,tr
266,Tavuklara aşığım,DIAMOND I,73,17.8,309,55,254,tr
267,idlemonkk 2,DIAMOND I,73,26.3,95,25,70,tr
268,Polîce,DIAMOND I,72,13.7,549,75,474,tr
269,Veichi,DIAMOND I,69,21.7,346,75,271,tr
270,CaptainFBII,DIAMOND I,68,10.3,251,26,225,tr
271,Club America,DIAMOND I,67,25.9,108,28,80,tr
272,LORD OF SAVAŞ,DIAMOND I,66,10.9,631,69,562,tr
273,I WOLFGANG I,DIAMOND I,66,15.6,282,44,238,tr
274,Sans égal,DIAMOND I,65,19.0,205,39,166,tr
275,Laportee,DIAMOND I,64,16.1,491,79,412,tr
276,Against Life,DIAMOND I,64,12.3,616,76,540,tr
277,turkuazv2,DIAMOND I,63,18.4,271,50,221,tr
278,Negabrione,DIAMOND I,63,20.4,216,44,172,tr
279,SSW,DIAMOND I,62,13.4,1189,160,1029,tr
280,HaunteD TFT,DIAMOND I,62,14.2,388,55,333,tr
281,hakes27,DIAMOND I,59,12.2,359,44,315,tr
282,Ildeniz,DIAMOND I,57,17.5,388,68,320,tr
283,TEKSİN,DIAMOND I,56,15.5,381,59,322,tr
284,TheRoseKnight,DIAMOND I,56,19.7,208,41,167,tr
285,ResqueL,DIAMOND I,56,19.8,192,38,154,tr
286,FiendStyLe,DIAMOND I,56,26.4,91,24,67,tr
287,AKHİSAR CİNGENİ,DIAMOND I,54,18.8,202,38,164,tr
288,AsSaSINTURK,DIAMOND I,54,13.0,253,33,220,tr
289,Swagger94,DIAMOND I,52,19.7,238,47,191,tr
290,Pepee16,DIAMOND I,50,13.7,849,116,733,tr
291,mertnag,DIAMOND I,50,18.6,526,98,428,tr
292,SoundOfSiIence,DIAMOND I,50,18.1,507,92,415,tr
293,lateux,DIAMOND I,50,13.2,606,80,526,tr
294,Pegnex,DIAMOND I,50,12.4,498,62,436,tr
295,Sh1vâ,DIAMOND I,50,17.9,312,56,256,tr
296,GameoweR61,DIAMOND I,50,12.8,406,52,354,tr
297,Smøøthie,DIAMOND I,50,20.2,243,49,194,tr
298,Kokarca Haydar,DIAMOND I,50,14.6,328,48,280,tr
299,Haccii,DIAMOND I,50,12.9,373,48,325,tr
300,lSkyBanel,DIAMOND I,50,16.0,294,47,247,tr
301,Yağız,DIAMOND I,50,26.9,167,45,122,tr
302,TaTux,DIAMOND I,50,10.8,408,44,364,tr
303,Akaki Akakiyeviç,DIAMOND I,50,13.1,329,43,286,tr
304,musulsezar,DIAMOND I,50,10.8,397,43,354,tr
305,Por8,DIAMOND I,50,21.8,188,41,147,tr
306,The Gurthang,DIAMOND I,50,19.3,197,38,159,tr
307,Sumo deadlift,DIAMOND I,50,16.8,220,37,183,tr
308,serdext,DIAMOND I,50,12.2,302,37,265,tr
309,yüksel812,DIAMOND I,50,16.7,215,36,179,tr
310,No Pasaran1917,DIAMOND I,50,19.4,175,34,141,tr
311,SeismicWave,DIAMOND I,50,20.4,162,33,129,tr
312,DRAGON124,DIAMOND I,50,13.9,223,31,192,tr
313,babayorgunn35,DIAMOND I,50,21.6,125,27,98,tr
314,HassickdiR,DIAMOND I,50,14.1,156,22,134,tr
315,PengueNNN2,DIAMOND I,50,13.8,152,21,131,tr
316,TSM DEMİRCELİK,DIAMOND I,49,15.7,395,62,333,tr
317,frambuazll,DIAMOND I,49,15.4,286,44,242,tr
318,Rota420,DIAMOND I,47,16.5,164,27,137,tr
319,Bunkaya,DIAMOND I,46,12.1,520,63,457,tr
320,âllen,DIAMOND I,45,18.6,145,27,118,tr
321,Ormancı Kız,DIAMOND I,44,15.1,783,118,665,tr
322,drogbaa37,DIAMOND I,44,9.8,379,37,342,tr
323,Likewindfree,DIAMOND I,43,16.6,886,147,739,tr
324,3sok,DIAMOND I,43,21.5,181,39,142,tr
325,Iyilik YaraKI,DIAMOND I,43,16.3,233,38,195,tr
326,Kılıç ustası,DIAMOND I,42,11.9,1303,155,1148,tr
327,Heisenberg CP,DIAMOND I,42,14.6,349,51,298,tr
328,Dorçe,DIAMOND I,42,20.1,209,42,167,tr
329,ExterminatioN,DIAMOND I,41,14.6,419,61,358,tr
330,Xantherâ,DIAMOND I,41,14.4,327,47,280,tr
331,İyi Kalpli Aley,DIAMOND I,41,14.0,250,35,215,tr
332,llumyos,DIAMOND I,41,15.2,223,34,189,tr
333,Endokarditt,DIAMOND I,40,14.5,393,57,336,tr
334,unforgiving,DIAMOND I,40,15.4,331,51,280,tr
335,M Ê R T J O H N,DIAMOND I,40,15.2,230,35,195,tr
336,Avicenna v2,DIAMOND I,40,10.3,319,33,286,tr
337,ROBERTO FİRMİNO,DIAMOND I,40,12.8,140,18,122,tr
338,Móoncake,DIAMOND I,39,20.7,357,74,283,tr
339,lave242,DIAMOND I,39,12.8,506,65,441,tr
340,TIFITCI,DIAMOND I,39,17.8,146,26,120,tr
341,MAFEDERİN MAF,DIAMOND I,38,22.3,641,143,498,tr
342,MaSuaé,DIAMOND I,37,13.1,1509,198,1311,tr
343,BBang,DIAMOND I,37,12.3,742,91,651,tr
344,Roswell v1,DIAMOND I,37,16.5,346,57,289,tr
345,ˆ G7 ˆ,DIAMOND I,37,17.5,315,55,260,tr
346,lmPerfect,DIAMOND I,37,23.1,186,43,143,tr
347,TeoJii,DIAMOND I,37,15.4,272,42,230,tr
348,Hısımus,DIAMOND I,37,17.6,204,36,168,tr
349,menaSUVARi,DIAMOND I,37,15.2,210,32,178,tr
350,Tasty,DIAMOND I,37,16.9,154,26,128,tr
351,sabonohiken,DIAMOND I,37,16.0,119,19,100,tr
352,karpuz çilek,DIAMOND I,37,13.4,119,16,103,tr
353,Limon ve Kimyon,DIAMOND I,36,10.5,210,22,188,tr
354,VouLDead,DIAMOND I,35,15.7,338,53,285,tr
355,AdnantalhaV,DIAMOND I,35,19.7,228,45,183,tr
356,Swarles Barkley,DIAMOND I,35,26.8,97,26,71,tr
357,Zerone,DIAMOND I,34,15.9,232,37,195,tr
358,Cleveyton,DIAMOND I,34,19.6,168,33,135,tr
359,N3squiKk,DIAMOND I,33,15.7,127,20,107,tr
360,JB Cloudy,DIAMOND I,32,13.8,671,93,578,tr
361,Gannicius,DIAMOND I,32,20.1,298,60,238,tr
362,ııııılıı,DIAMOND I,32,16.3,361,59,302,tr
363,Alpha  Yozgyur,DIAMOND I,32,12.4,420,52,368,tr
364,ANK Bofidi,DIAMOND I,32,21.7,221,48,173,tr
365,ertgskrcii,DIAMOND I,32,17.4,264,46,218,tr
366,sirchadol,DIAMOND I,32,14.4,215,31,184,tr
367,yanıyomsöndür,DIAMOND I,31,16.7,275,46,229,tr
368,Kıvırcık Pompa,DIAMOND I,31,12.2,221,27,194,tr
369,IIKRGZII,DIAMOND I,30,18.6,413,77,336,tr
370,Machope,DIAMOND I,30,15.1,218,33,185,tr
371,emre kınacı,DIAMOND I,29,17.0,522,89,433,tr
372,iHTiYaR,DIAMOND I,29,8.3,516,43,473,tr
373,Ceminson,DIAMOND I,29,13.5,303,41,262,tr
374,Goku,DIAMOND I,29,11.7,239,28,211,tr
375,ldiot sandwich,DIAMOND I,29,14.4,118,17,101,tr
376,sikkke,DIAMOND I,28,17.1,415,71,344,tr
377,CNS Undomiel,DIAMOND I,28,14.1,447,63,384,tr
378,Speraktif v2,DIAMOND I,28,19.8,162,32,130,tr
379,Itachi Uchiha,DIAMOND I,27,12.0,698,84,614,tr
380,gahpe GİRAY,DIAMOND I,27,13.8,463,64,399,tr
381,CLL,DIAMOND I,27,17.1,204,35,169,tr
382,Neuveorix,DIAMOND I,26,16.4,766,126,640,tr
383,Lunaticim,DIAMOND I,25,20.9,535,112,423,tr
384,HàrleyˇQuinn,DIAMOND I,25,19.5,400,78,322,tr
385,Seras Viktoria,DIAMOND I,25,24.2,298,72,226,tr
386,Asetaa,DIAMOND I,25,18.6,312,58,254,tr
387,avienex,DIAMOND I,25,10.8,424,46,378,tr
388,Eldjötnar,DIAMOND I,25,16.1,242,39,203,tr
389,MinionBlock,DIAMOND I,25,17.8,174,31,143,tr
390,MIVAC2,DIAMOND I,25,26.7,105,28,77,tr
391,Milli Güç,DIAMOND I,24,23.1,212,49,163,tr
392,KERZO,DIAMOND I,24,20.4,235,48,187,tr
393,Eless3r,DIAMOND I,24,17.0,247,42,205,tr
394,Twiqqy,DIAMOND I,24,16.2,247,40,207,tr
395,SoRuNumVar,DIAMOND I,24,18.5,135,25,110,tr
396,madckins2,DIAMOND I,23,10.6,717,76,641,tr
397,Maybe One Dayˆ,DIAMOND I,23,18.0,322,58,264,tr
398,TFT Hasslet,DIAMOND I,22,15.6,276,43,233,tr
399,GoyGoyyCu,DIAMOND I,21,13.1,382,50,332,tr
400,PatoShiq,DIAMOND I,20,12.9,256,33,223,tr
401,FanFinFon,DIAMOND I,19,15.3,334,51,283,tr
402,U WOT MVIII,DIAMOND I,19,25.4,177,45,132,tr
403,Hazârdous,DIAMOND I,19,20.5,161,33,128,tr
404,bunnycery,DIAMOND I,19,8.0,327,26,301,tr
405,HAMDIDMRTS TFT,DIAMOND I,18,16.6,475,79,396,tr
406,Alper,DIAMOND I,18,16.5,272,45,227,tr
407,GM Jaqen,DIAMOND I,17,14.7,991,146,845,tr
408,slm ben aspirin,DIAMOND I,17,18.3,431,79,352,tr
409,Gramer Wr,DIAMOND I,17,13.9,538,75,463,tr
410,HaydiBusteR,DIAMOND I,17,15.0,427,64,363,tr
411,ChefCef,DIAMOND I,17,14.9,363,54,309,tr
412,Phenomenal214,DIAMOND I,17,18.9,111,21,90,tr
413,FB Alucardo,DIAMOND I,16,15.2,513,78,435,tr
414,Srcnym,DIAMOND I,16,18.2,280,51,229,tr
415,Ömércan,DIAMOND I,16,21.7,152,33,119,tr
416,DuDa TFT,DIAMOND I,16,16.5,139,23,116,tr
417,HolyMan34,DIAMOND I,14,11.1,642,71,571,tr
418,The Memo,DIAMOND I,14,15.2,270,41,229,tr
419,CLOUDS GOD,DIAMOND I,13,18.8,165,31,134,tr
420,babekizm,DIAMOND I,12,12.5,840,105,735,tr
421,programlama123,DIAMOND I,12,18.5,216,40,176,tr
422,HolyTheLost,DIAMOND I,11,16.9,326,55,271,tr
423,kemalesme,DIAMOND I,11,18.9,254,48,206,tr
424,DaricK,DIAMOND I,11,13.3,346,46,300,tr
425,Honey Messalina,DIAMOND I,11,14.8,290,43,247,tr
426,IamSonGoku,DIAMOND I,10,13.9,473,66,407,tr
427,4Absinth,DIAMOND I,10,18.6,237,44,193,tr
428,UnutkanAdam,DIAMOND I,10,29.8,124,37,87,tr
429,IBlueDreamI,DIAMOND I,9,16.1,454,73,381,tr
430,Yukokano,DIAMOND I,9,20.3,236,48,188,tr
431,Xiphos,DIAMOND I,9,21.9,187,41,146,tr
432,Lilith Sahl,DIAMOND I,9,10.1,287,29,258,tr
433,Janiabin,DIAMOND I,8,20.5,205,42,163,tr
434,Minik Efsanem,DIAMOND I,8,12.5,327,41,286,tr
435,xElessaRx,DIAMOND I,8,7.5,536,40,496,tr
436,Gj MRX,DIAMOND I,7,9.3,193,18,175,tr
437,OgUzhan22,DIAMOND I,6,13.9,662,92,570,tr
438,Itachi the God,DIAMOND I,6,20.1,308,62,246,tr
439,Berladriojon,DIAMOND I,6,15.7,248,39,209,tr
440,Z1AN,DIAMOND I,6,16.2,228,37,191,tr
441,Teemoş,DIAMOND I,6,11.5,321,37,284,tr
442,Jov is Back,DIAMOND I,6,13.8,188,26,162,tr
443,Perceid,DIAMOND I,5,18.2,478,87,391,tr
444,SebastiaN1,DIAMOND I,5,13.0,347,45,302,tr
445,lolisking1,DIAMOND I,3,24.1,170,41,129,tr
446,BADFATHER,DIAMOND I,3,12.2,336,41,295,tr
447,ORMAN MESUT V2,DIAMOND I,3,11.6,318,37,281,tr
448,KarpotasiN,DIAMOND I,3,13.3,256,34,222,tr
449,Th3ng3s1z,DIAMOND I,3,17.5,177,31,146,tr
450,KİLLA ONUR,DIAMOND I,2,20.9,368,77,291,tr
451,Mustoyevski TFT,DIAMOND I,2,19.8,293,58,235,tr
452,ineffableHK,DIAMOND I,2,21.3,183,39,144,tr
453,TEKLEYEN ÇAR,DIAMOND I,1,18.4,201,37,164,tr
454,p a c i ennN,DIAMOND I,1,12.4,218,27,191,tr
455,Âmethyst,DIAMOND I,1,15.5,142,22,120,tr
456,Double Helix,DIAMOND I,1,14.1,142,20,122,tr
457,MBURAKLOL TWiTCH,DIAMOND I,0,16.6,997,166,831,tr
458,ReyNhard,DIAMOND I,0,16.7,838,140,698,tr
459,Seyfi Baba QQ,DIAMOND I,0,18.2,631,115,516,tr
460,OneTruth Aimless,DIAMOND I,0,22.3,476,106,370,tr
461,Wondabitte JR,DIAMOND I,0,17.2,564,97,467,tr
462,QTAĞ,DIAMOND I,0,13.0,691,90,601,tr
463,Ben Kahinim,DIAMOND I,0,14.7,577,85,492,tr
464,DIZDIZ EKREM,DIAMOND I,0,15.3,522,80,442,tr
465,bibakipcikcam2,DIAMOND I,0,19.3,357,69,288,tr
466,Reaper oƒ Souls,DIAMOND I,0,15.9,427,68,359,tr
467,O F L U  R E Î S,DIAMOND I,0,12.1,544,66,478,tr
468,TFT Lynch,DIAMOND I,0,12.1,531,64,467,tr
469,CBF Pscho,DIAMOND I,0,9.4,671,63,608,tr
470,ntekinn,DIAMOND I,0,14.3,434,62,372,tr
471,Herun,DIAMOND I,0,18.4,332,61,271,tr
472,XXLeonardoX,DIAMOND I,0,14.0,436,61,375,tr
473,TFT SAYGO,DIAMOND I,0,13.2,463,61,402,tr
474,M xDharma,DIAMOND I,0,11.0,536,59,477,tr
475,enjoy90,DIAMOND I,0,15.7,369,58,311,tr
476,Rachel,DIAMOND I,0,15.3,379,58,321,tr
477,WymehcKo,DIAMOND I,0,16.8,328,55,273,tr
478,fztenginyildirim,DIAMOND I,0,15.2,362,55,307,tr
479,TheKurye,DIAMOND I,0,14.4,383,55,328,tr
480,Prøphet Âs Zîyâ,DIAMOND I,0,13.9,396,55,341,tr
481,RyanHenk,DIAMOND I,0,19.2,276,53,223,tr
482,llLUNAll,DIAMOND I,0,12.0,440,53,387,tr
483,Radyum,DIAMOND I,0,14.4,361,52,309,tr
484,WORST SUPPORT,DIAMOND I,0,13.6,383,52,331,tr
485,aylakayyaş,DIAMOND I,0,15.5,316,49,267,tr
486,JackDaNieLs6750,DIAMOND I,0,15.0,327,49,278,tr
487,Only Trick,DIAMOND I,0,20.2,232,47,185,tr
488,xeâ,DIAMOND I,0,11.5,401,46,355,tr
489,IBaşKaNIRuling,DIAMOND I,0,16.1,274,44,230,tr
490,AbantAlabalık GK,DIAMOND I,0,19.4,222,43,179,tr
491,JuJuFiFi,DIAMOND I,0,13.1,329,43,286,tr
492,Zugaşi Bere,DIAMOND I,0,21.0,195,41,154,tr
493,Ðèstèk,DIAMOND I,0,16.3,252,41,211,tr
494,ReVerseSense,DIAMOND I,0,19.0,210,40,170,tr
495,JayKe,DIAMOND I,0,21.0,186,39,147,tr
496,NoWhereNear,DIAMOND I,0,18.9,206,39,167,tr
497,Neutrally,DIAMOND I,0,19.8,192,38,154,tr
498,Tiffany Twisted,DIAMOND I,0,18.3,208,38,170,tr
499,Peredhil,DIAMOND I,0,13.2,287,38,249,tr
500,XecutioneRiven,DIAMOND I,0,12.9,295,38,257,tr
1,aLeProfane,CHALLENGER I,925,26.6,368,98,270,ru
2,KroniiinepTFT,CHALLENGER I,825,27.6,351,97,254,ru
3,HORNIE MY BABY,CHALLENGER I,772,33.5,260,87,173,ru
4,chmochma,CHALLENGER I,748,24.7,295,73,222,ru
5,Dyachello,CHALLENGER I,747,20.6,398,82,316,ru
6,LMS trojancbkui,CHALLENGER I,575,14.7,592,87,505,ru
7,WuHan jiayou,CHALLENGER I,540,27.9,222,62,160,ru
8,Nycteus,CHALLENGER I,451,22.7,194,44,150,ru
9,МRAZIverniteNICK,CHALLENGER I,440,26.5,355,94,261,ru
10,L9 Rengy,CHALLENGER I,380,17.7,536,95,441,ru
11,Yablo4niy,CHALLENGER I,364,24.4,184,45,139,ru
12,Marijuanamama,CHALLENGER I,322,15.7,351,55,296,ru
13,superworldRU,CHALLENGER I,312,19.5,353,69,284,ru
14,Hardrinnz,CHALLENGER I,304,30.4,148,45,103,ru
15,Тяньци,CHALLENGER I,302,21.2,184,39,145,ru
16,KENGBI,CHALLENGER I,291,20.0,509,102,407,ru
17,VN iRabity,CHALLENGER I,287,20.1,637,128,509,ru
18,DrKaktys,CHALLENGER I,286,17.5,194,34,160,ru
19,Авиатор Платонов,CHALLENGER I,248,25.0,332,83,249,ru
20,CNGOOD,CHALLENGER I,247,24.5,257,63,194,ru
21,Theblueboy,CHALLENGER I,246,30.1,196,59,137,ru
22,kiiller,CHALLENGER I,243,18.5,205,38,167,ru
23,NMЯ NO ИМЯ,CHALLENGER I,221,20.0,310,62,248,ru
24,JoSmog,CHALLENGER I,207,16.0,614,98,516,ru
25,Zauberbiest,CHALLENGER I,207,18.1,260,47,213,ru
26,CNGOOD1,CHALLENGER I,206,21.1,227,48,179,ru
27,ENDEAVOUR,CHALLENGER I,201,18.6,306,57,249,ru
28,Không Có Link,CHALLENGER I,198,17.4,596,104,492,ru
29,Светофорчик,CHALLENGER I,198,26.6,248,66,182,ru
30,DespicabIe,CHALLENGER I,196,24.9,285,71,214,ru
31,FIMA,CHALLENGER I,195,21.9,246,54,192,ru
32,NeverTrustSoloQ,CHALLENGER I,194,24.7,194,48,146,ru
33,kobeyang,CHALLENGER I,184,28.2,517,146,371,ru
34,thanh169,CHALLENGER I,180,22.8,552,126,426,ru
35,Mark of uroboros,CHALLENGER I,170,21.7,964,209,755,ru
36,e 1,CHALLENGER I,170,17.5,348,61,287,ru
37,Sоul Reaver,CHALLENGER I,165,20.8,183,38,145,ru
38,Legenda of LOL,CHALLENGER I,162,13.3,338,45,293,ru
39,Programmer,CHALLENGER I,161,16.5,212,35,177,ru
40,yurchiv,CHALLENGER I,159,10.1,701,71,630,ru
41,ìnsane,CHALLENGER I,151,20.3,300,61,239,ru
42,Iggi 1TrickPferd,CHALLENGER I,136,27.4,168,46,122,ru
43,Kahzoo is KING,CHALLENGER I,127,32.4,102,33,69,ru
44,Кисюня,CHALLENGER I,125,27.8,108,30,78,ru
45,Torianos,CHALLENGER I,122,12.0,593,71,522,ru
46,Paprika,CHALLENGER I,118,20.9,172,36,136,ru
47,Rocket MaRin,CHALLENGER I,112,23.7,232,55,177,ru
48,fantik999,CHALLENGER I,109,16.3,172,28,144,ru
49,Bingo123456,CHALLENGER I,107,17.7,373,66,307,ru
50,CuPofCrAcK,CHALLENGER I,105,11.1,396,44,352,ru
51,Long live China,"GRANDMASTER I
G",104,18.2,274,50,224,ru
52,BEASTMXDE,"GRANDMASTER I
G",99,18.7,375,70,305,ru
53,СерёгаСПб,"GRANDMASTER I
G",75,19.1,430,82,348,ru
54,PeiPei,"GRANDMASTER I
G",71,13.0,478,62,416,ru
55,Silent Sona,"GRANDMASTER I
G",64,19.4,371,72,299,ru
56,inspekt0r,"GRANDMASTER I
G",61,18.8,330,62,268,ru
57,LegendsNeverDIE0,"GRANDMASTER I
G",58,23.5,277,65,212,ru
58,Rukashi,"GRANDMASTER I
G",50,31.5,108,34,74,ru
59,Sebastian7,"GRANDMASTER I
G",49,22.2,225,50,175,ru
60,Sacred Nоrris,"GRANDMASTER I
G",41,14.1,1344,190,1154,ru
61,BomBibomXD,"GRANDMASTER I
G",37,12.6,506,64,442,ru
62,dontlookatmepls,"GRANDMASTER I
G",36,32.2,90,29,61,ru
63,lza,"GRANDMASTER I
G",34,21.0,200,42,158,ru
64,im famous,"GRANDMASTER I
G",34,15.7,229,36,193,ru
65,Hoang,"GRANDMASTER I
G",33,20.9,201,42,159,ru
66,zhangqiling,"GRANDMASTER I
G",32,16.5,261,43,218,ru
67,ZiGZaG08,"GRANDMASTER I
G",32,16.4,262,43,219,ru
68,The Inspired One,"GRANDMASTER I
G",30,20.3,148,30,118,ru
69,Spring North,"GRANDMASTER I
G",29,18.0,233,42,191,ru
70,Killl Lov3,"GRANDMASTER I
G",28,24.4,119,29,90,ru
71,K R I P S I,"GRANDMASTER I
G",25,23.9,264,63,201,ru
72,ruComix,"GRANDMASTER I
G",23,23.5,187,44,143,ru
73,Shinkulirion,"GRANDMASTER I
G",21,21.7,378,82,296,ru
74,Morozilkin,"GRANDMASTER I
G",19,21.9,219,48,171,ru
75,Kapibaro,"GRANDMASTER I
G",17,23.2,336,78,258,ru
76,Youbanyouto,"GRANDMASTER I
G",16,18.4,190,35,155,ru
77,hornie,"GRANDMASTER I
G",15,27.2,136,37,99,ru
78,Kiss my fizz,"GRANDMASTER I
G",8,21.4,299,64,235,ru
79,1348319349,"GRANDMASTER I
G",8,21.1,270,57,213,ru
80,Remilia Scarlet,"GRANDMASTER I
G",8,22.1,204,45,159,ru
81,Ice Ivern,"GRANDMASTER I
G",8,15.4,234,36,198,ru
82,Tâm Luct,"GRANDMASTER I
G",7,16.1,224,36,188,ru
83,Крада,"GRANDMASTER I
G",6,12.8,602,77,525,ru
84,Hand off 3,"GRANDMASTER I
G",5,20.5,332,68,264,ru
85,Генерал Docta,"GRANDMASTER I
G",5,29.7,155,46,109,ru
86,ПаГа,"GRANDMASTER I
G",4,14.1,418,59,359,ru
87,bingo666fly,"GRANDMASTER I
G",1,22.9,153,35,118,ru
88,TFT tsm,"GRANDMASTER I
G",0,16.2,431,70,361,ru
89,Жабка Лиска,"GRANDMASTER I
G",0,23.8,281,67,214,ru
90,Hen predator,"GRANDMASTER I
G",0,19.8,338,67,271,ru
91,Джим Рейнор,"GRANDMASTER I
G",0,17.7,311,55,256,ru
92,Hail of Blades,"GRANDMASTER I
G",0,24.2,161,39,122,ru
93,iQuestions,"GRANDMASTER I
G",0,18.9,132,25,107,ru
94,Arclight Panda,MASTER I,18,19.3,373,72,301,ru
95,Леди Меламори,DIAMOND I,97,14.1,206,29,177,ru
96,Ksorn,DIAMOND I,90,12.7,197,25,172,ru
97,Arcade bÔÔbs,DIAMOND I,89,21.0,500,105,395,ru
98,Воруй94,DIAMOND I,86,26.2,141,37,104,ru
99,Trang4438,DIAMOND I,82,20.1,383,77,306,ru
100,VN Error RoLL,DIAMOND I,81,13.9,606,84,522,ru
101,BrotherFrank,DIAMOND I,77,26.2,126,33,93,ru
102,TOMSK7777,DIAMOND I,75,23.1,399,92,307,ru
103,ChinaNirvana,DIAMOND I,75,22.3,399,89,310,ru
104,ropo4ka,DIAMOND I,75,17.9,441,79,362,ru
105,Крушитель001,DIAMOND I,75,19.2,369,71,298,ru
106,EmperorCHN,DIAMOND I,75,25.4,264,67,197,ru
107,SUSUWE,DIAMOND I,75,17.0,383,65,318,ru
108,Lorraine,DIAMOND I,75,27.0,233,63,170,ru
109,DuongLan,DIAMOND I,75,16.1,367,59,308,ru
110,Eldrax,DIAMOND I,75,13.4,441,59,382,ru
111,lºˆºl,DIAMOND I,75,23.0,248,57,191,ru
112,Saitaf,DIAMOND I,75,23.0,226,52,174,ru
113,qsoso,DIAMOND I,75,17.2,302,52,250,ru
114,sketcheer,DIAMOND I,75,17.0,305,52,253,ru
115,NikeIII,DIAMOND I,75,28.6,178,51,127,ru
116,dyboщит,DIAMOND I,75,18.5,276,51,225,ru
117,blvckboy,DIAMOND I,75,15.3,320,49,271,ru
118,Ветра Севера,DIAMOND I,75,8.9,553,49,504,ru
119,Dunngarm,DIAMOND I,75,26.3,171,45,126,ru
120,CR0WNZ,DIAMOND I,75,16.0,269,43,226,ru
121,AlloC,DIAMOND I,75,20.7,198,41,157,ru
122,лесk urself jgl,DIAMOND I,75,20.5,200,41,159,ru
123,Make me Purr,DIAMOND I,75,20.0,200,40,160,ru
124,RaNdoOoMuK,DIAMOND I,75,20.5,190,39,151,ru
125,Just Cancer,DIAMOND I,75,18.4,207,38,169,ru
126,vulcaner,DIAMOND I,66,21.1,185,39,146,ru
127,beznika2,DIAMOND I,54,14.8,210,31,179,ru
128,Малолетка,DIAMOND I,54,33.3,75,25,50,ru
129,Callsign Kindred,DIAMOND I,52,33.0,88,29,59,ru
130,AKJSDs,DIAMOND I,49,24.9,201,50,151,ru
131,Дрeeейвен,DIAMOND I,48,11.0,662,73,589,ru
132,УРОД,DIAMOND I,48,40.1,177,71,106,ru
133,Th3Gambl3r,DIAMOND I,47,19.3,597,115,482,ru
134,NorMe,DIAMOND I,46,18.4,152,28,124,ru
135,KissTheStar,DIAMOND I,44,9.2,413,38,375,ru
136,Лёшкина игра,DIAMOND I,42,24.3,230,56,174,ru
137,TG Rot Stillness,DIAMOND I,42,11.9,393,47,346,ru
138,junestone,DIAMOND I,41,30.4,214,65,149,ru
139,royál beggar,DIAMOND I,38,23.6,186,44,142,ru
140,sasha1OOO,DIAMOND I,36,18.9,175,33,142,ru
141,ReMiXoN007,DIAMOND I,33,22.7,141,32,109,ru
142,8xm12a,DIAMOND I,32,11.6,276,32,244,ru
143,PistolMaravich,DIAMOND I,25,36.1,263,95,168,ru
144,Bushuwotoudehong,DIAMOND I,25,19.9,276,55,221,ru
145,Лапки Юми,DIAMOND I,25,16.4,324,53,271,ru
146,SUPRAAAA,DIAMOND I,25,26.3,99,26,73,ru
147,JusticeNari,DIAMOND I,24,15.3,209,32,177,ru
148,Tot,DIAMOND I,19,19.4,129,25,104,ru
149,Kimchi wang,DIAMOND I,17,34.6,127,44,83,ru
150,NickDeko,DIAMOND I,16,17.9,390,70,320,ru
151,Sapfer,DIAMOND I,14,17.5,485,85,400,ru
152,StaverOk,DIAMOND I,14,21.2,231,49,182,ru
153,Russiabang,DIAMOND I,13,11.3,194,22,172,ru
154,Фабио,DIAMOND I,12,21.0,195,41,154,ru
155,kecodon9x,DIAMOND I,12,18.0,205,37,168,ru
156,Ji Yong,DIAMOND I,11,13.3,279,37,242,ru
157,ПоНосик в Одеяле,DIAMOND I,10,28.3,191,54,137,ru
158,SorrNyak,DIAMOND I,9,18.3,197,36,161,ru
159,Evildeaad,DIAMOND I,4,27.8,90,25,65,ru
160,ktotamnukogonet,DIAMOND I,3,25.8,128,33,95,ru
161,royál beggar,DIAMOND I,3,20.7,150,31,119,ru
162,angelys,DIAMOND I,3,10.4,288,30,258,ru
163,oi SEREGA io,DIAMOND I,1,12.2,977,119,858,ru
164,LРL,DIAMOND I,0,14.6,980,143,837,ru
165,CN liang,DIAMOND I,0,16.4,420,69,351,ru
166,Janelicher,DIAMOND I,0,28.8,208,60,148,ru
167,Ruff85,DIAMOND I,0,24.3,239,58,181,ru
168,Вика Клубника,DIAMOND I,0,21.3,249,53,196,ru
169,GGJIANG,DIAMOND I,0,18.9,281,53,228,ru
170,LPL dynasty,DIAMOND I,0,21.7,212,46,166,ru
171,CK Guard,DIAMOND I,0,24.9,177,44,133,ru
172,Мёртвый принц,DIAMOND I,0,18.1,221,40,181,ru
173,EleemY,DIAMOND I,0,33.0,112,37,75,ru
174,clown syndrome,DIAMOND I,0,22.1,154,34,120,ru
175,AkitoHunter,DIAMOND I,0,11.1,296,33,263,ru
176,PINCER,DIAMOND I,0,25.6,125,32,93,ru
177,Юрa,DIAMOND I,0,15.2,204,31,173,ru
178,Takanashi Hikka,DIAMOND I,0,18.2,165,30,135,ru
179,Дым из трубы,DIAMOND I,0,27.2,103,28,75,ru
180,LHYloveLWJ,DIAMOND II,92,14.2,429,61,368,ru
181,Napyyyy,DIAMOND II,89,14.4,271,39,232,ru
182,mTxFaT,DIAMOND II,85,18.3,881,161,720,ru
183,Emma Hix,DIAMOND II,82,27.4,117,32,85,ru
184,Desperateing,DIAMOND II,76,30.8,78,24,54,ru
185,LurDOOM,DIAMOND II,75,18.1,480,87,393,ru
186,NikolayDjan,DIAMOND II,75,18.2,439,80,359,ru
187,olanva,DIAMOND II,75,20.2,391,79,312,ru
188,laojiazuishuai,DIAMOND II,75,18.6,334,62,272,ru
189,WO S LAOMAOZI,DIAMOND II,75,21.6,268,58,210,ru
190,Lord Ochinchin,DIAMOND II,75,54.1,98,53,45,ru
191,DuKeH,DIAMOND II,75,17.5,285,50,235,ru
192,RngUziJianZihao,DIAMOND II,75,18.4,266,49,217,ru
193,sitius1986,DIAMOND II,75,17.6,279,49,230,ru
194,N0SkillZz,DIAMOND II,75,36.5,126,46,80,ru
195,GEOtiger,DIAMOND II,75,16.2,277,45,232,ru
196,Мерцание,DIAMOND II,75,9.7,462,45,417,ru
197,xcvwdst,DIAMOND II,75,41.2,102,42,60,ru
198,Mofu mofu,DIAMOND II,75,55.4,65,36,29,ru
199,Zhenya29,DIAMOND II,75,13.3,270,36,234,ru
200,БистФромЗеИст,DIAMOND II,75,18.6,183,34,149,ru
201,Futaba Sakura,DIAMOND II,75,24.8,129,32,97,ru
202,Sizif,DIAMOND II,75,11.7,179,21,158,ru
203,AileenWuornos,DIAMOND II,75,7.2,250,18,232,ru
204,PewDiePew,DIAMOND II,70,22.6,221,50,171,ru
205,Jidaykin,DIAMOND II,68,16.2,283,46,237,ru
206,ASREN,DIAMOND II,66,18.8,138,26,112,ru
207,DEDASHAVAL,DIAMOND II,65,16.1,130,21,109,ru
208,DianaEatme,DIAMOND II,62,14.7,136,20,116,ru
209,DeadKedbl,DIAMOND II,61,29.8,188,56,132,ru
210,bone,DIAMOND II,56,13.7,278,38,240,ru
211,TheRedDevils,DIAMOND II,55,17.4,507,88,419,ru
212,STRMASTER,DIAMOND II,55,23.8,210,50,160,ru
213,RikQu,DIAMOND II,53,15.2,639,97,542,ru
214,MuTuZ,DIAMOND II,53,15.2,210,32,178,ru
215,LooKDKc,DIAMOND II,49,19.1,261,50,211,ru
216,nn21,DIAMOND II,48,45.0,60,27,33,ru
217,Cоming Down,DIAMOND II,45,17.1,211,36,175,ru
218,daozige,DIAMOND II,44,16.2,191,31,160,ru
219,Vla Until You,DIAMOND II,42,20.8,178,37,141,ru
220,Kalabaka,DIAMOND II,40,27.2,844,230,614,ru
221,Vladimir Syusin,DIAMOND II,40,11.2,232,26,206,ru
222,Donelly,DIAMOND II,40,14.3,175,25,150,ru
223,bpbogdan,DIAMOND II,34,14.5,738,107,631,ru
224,Anurion89,DIAMOND II,34,20.6,291,60,231,ru
225,mallaby,DIAMOND II,33,22.7,278,63,215,ru
226,Таксидермист1980,DIAMOND II,32,11.2,509,57,452,ru
227,Black Swift,DIAMOND II,31,19.7,228,45,183,ru
228,СЛЕСАРЬ СБОРЩИК,DIAMOND II,31,11.9,202,24,178,ru
229,AeCorah,DIAMOND II,29,24.9,537,134,403,ru
230,lanyuheissl55555,DIAMOND II,29,19.3,264,51,213,ru
231,Бионикл,DIAMOND II,29,12.5,367,46,321,ru
232,CHNFan,DIAMOND II,28,20.9,206,43,163,ru
233,ЛУЧШИЙ ИГРОК РУ,DIAMOND II,28,17.9,229,41,188,ru
234,E11iks,DIAMOND II,28,15.0,206,31,175,ru
235,taibox,DIAMOND II,27,12.0,309,37,272,ru
236,CapsuleZZZ,DIAMOND II,27,17.3,202,35,167,ru
237,cepl4,DIAMOND II,25,17.7,355,63,292,ru
238,Manode,DIAMOND II,25,18.4,261,48,213,ru
239,Леон Надо,DIAMOND II,25,30.3,122,37,85,ru
240,Dragon Chess,DIAMOND II,25,18.9,196,37,159,ru
241,wushengsimeng,DIAMOND II,25,26.8,127,34,93,ru
242,MyPABEu13,DIAMOND II,25,14.2,240,34,206,ru
243,Сижу чешу колоду,DIAMOND II,25,17.2,186,32,154,ru
244,Concubine,DIAMOND II,25,11.8,153,18,135,ru
245,kalan44,DIAMOND II,24,10.1,507,51,456,ru
246,Weev,DIAMOND II,24,20.0,175,35,140,ru
247,Cho Em Mãnh Thú,DIAMOND II,22,16.5,261,43,218,ru
248,minhplekhanovne,DIAMOND II,22,16.8,119,20,99,ru
249,Disnaix Kh,DIAMOND II,21,19.7,314,62,252,ru
250,Одинсан,DIAMOND II,21,16.0,307,49,258,ru
251,StrongestMalice,DIAMOND II,21,24.6,138,34,104,ru
252,HMTuanRu,DIAMOND II,19,19.0,331,63,268,ru
253,Darkwake,DIAMOND II,19,17.7,249,44,205,ru
254,BONDJik,DIAMOND II,17,10.2,441,45,396,ru
255,EbokvakXXL,DIAMOND II,15,15.3,373,57,316,ru
256,LASTURN,DIAMOND II,15,20.5,259,53,206,ru
257,John  McClane 1,DIAMOND II,15,5.3,379,20,359,ru
258,PieMaker,DIAMOND II,13,14.3,342,49,293,ru
259,Фезам,DIAMOND II,13,13.5,260,35,225,ru
260,ljx001,DIAMOND II,9,20.0,200,40,160,ru
261,PuddleOfChange,DIAMOND II,9,13.4,224,30,194,ru
262,LlosDi,DIAMOND II,7,20.5,512,105,407,ru
263,MIT811,DIAMOND II,7,16.2,581,94,487,ru
264,новый год ios,DIAMOND II,7,16.5,194,32,162,ru
265,SERHIOVIP,DIAMOND II,7,13.3,211,28,183,ru
266,Kissler99,DIAMOND II,6,17.7,282,50,232,ru
267,LoveTrucks,DIAMOND II,5,16.6,603,100,503,ru
268,Админ Кaзахстана,DIAMOND II,5,11.0,336,37,299,ru
269,BlackBURN,DIAMOND II,2,14.1,504,71,433,ru
270,China Mortal,DIAMOND II,1,24.4,156,38,118,ru
271,GMLovelyBoy,DIAMOND II,1,27.8,108,30,78,ru
272,Matt,DIAMOND II,1,30.0,90,27,63,ru
273,ЗабулдыгаНовичёк,DIAMOND II,0,10.5,1279,134,1145,ru
274,Garru poterr bl9,DIAMOND II,0,11.7,622,73,549,ru
275,iamaha,DIAMOND II,0,19.3,363,70,293,ru
276,basist0s,DIAMOND II,0,14.1,489,69,420,ru
277,ˆЛëësïnˆVNˆ,DIAMOND II,0,16.2,388,63,325,ru
278,SadSlipperS,DIAMOND II,0,11.8,523,62,461,ru
279,JVevermind,DIAMOND II,0,14.9,408,61,347,ru
280,Reyzy Ligh,DIAMOND II,0,14.6,403,59,344,ru
281,VN Troll,DIAMOND II,0,8.8,666,59,607,ru
282,Arclight JinBey,DIAMOND II,0,18.5,313,58,255,ru
283,Лирен,DIAMOND II,0,18.1,270,49,221,ru
284,4evernightmare,DIAMOND II,0,24.7,190,47,143,ru
285,кýсь,DIAMOND II,0,11.0,382,42,340,ru
286,GODLuck,DIAMOND II,0,18.6,221,41,180,ru
287,Dong XIao yu,DIAMOND II,0,20.1,189,38,151,ru
288,bloodgammy,DIAMOND II,0,8.2,424,35,389,ru
289,zonapot,DIAMOND II,0,9.2,369,34,335,ru
290,ТРУСИКИ АНДРЕАСА,DIAMOND II,0,17.6,182,32,150,ru
291,Ayumiclq313,DIAMOND II,0,23.9,117,28,89,ru
292,Toveldo,DIAMOND II,0,20.9,134,28,106,ru
293,Shanoa,DIAMOND II,0,11.4,228,26,202,ru
294,Wuaneon,DIAMOND II,0,17.4,144,25,119,ru
295,lolstars,DIAMOND II,0,7.0,284,20,264,ru
296,Popcorn,DIAMOND II,0,17.5,97,17,80,ru
297,Alvarado,DIAMOND III,98,18.1,276,50,226,ru
298,Мистер Кусь,DIAMOND III,94,18.4,271,50,221,ru
299,Britney Shears,DIAMOND III,92,12.5,311,39,272,ru
300,Grubio,DIAMOND III,83,11.3,379,43,336,ru
301,Snowman322,DIAMOND III,81,14.0,464,65,399,ru
302,DMH1996,DIAMOND III,81,15.0,160,24,136,ru
303,justmax95,DIAMOND III,79,23.3,249,58,191,ru
304,leidianfawang,DIAMOND III,79,18.8,133,25,108,ru
305,Tima444,DIAMOND III,78,21.8,174,38,136,ru
306,notnakeD,DIAMOND III,77,14.0,308,43,265,ru
307,КОРОЛЬ БОГ КОСМО,DIAMOND III,75,17.7,611,108,503,ru
308,ID RANGO,DIAMOND III,75,15.9,397,63,334,ru
309,Гриндамир,DIAMOND III,75,21.8,285,62,223,ru
310,ShroudOfMystery,DIAMOND III,75,18.3,289,53,236,ru
311,Binkan Ichiro,DIAMOND III,75,16.0,325,52,273,ru
312,GunnerMSK,DIAMOND III,75,19.7,254,50,204,ru
313,прекрасное свет,DIAMOND III,75,18.2,269,49,220,ru
314,JustSx,DIAMOND III,75,22.1,208,46,162,ru
315,Loyoish,DIAMOND III,75,23.3,189,44,145,ru
316,MJ Su Da Qiang,DIAMOND III,75,17.2,238,41,197,ru
317,ZuliuSs,DIAMOND III,75,27.5,142,39,103,ru
318,rozeva,DIAMOND III,75,20.5,185,38,147,ru
319,ZelibobaUnited,DIAMOND III,75,27.7,119,33,86,ru
320,MashironIII,DIAMOND III,75,8.0,398,32,366,ru
321,bloodlook,DIAMOND III,75,13.2,234,31,203,ru
322,10843701,DIAMOND III,75,34.9,86,30,56,ru
323,Мид это война,DIAMOND III,75,12.7,237,30,207,ru
324,Crazyyeyeye,DIAMOND III,75,20.9,134,28,106,ru
325,qqqe,DIAMOND III,75,13.8,160,22,138,ru
326,twitch tv guffee,DIAMOND III,75,41.2,51,21,30,ru
327,Akerasin,DIAMOND III,75,23.9,88,21,67,ru
328,PoisonPotion,DIAMOND III,75,11.1,135,15,120,ru
329,UmroN,DIAMOND III,73,18.9,243,46,197,ru
330,diegoMorales,DIAMOND III,72,14.3,203,29,174,ru
331,XPEHOPE33KA,DIAMOND III,71,21.9,164,36,128,ru
332,Havir,DIAMOND III,71,14.8,244,36,208,ru
333,FlorDaX,DIAMOND III,69,16.8,464,78,386,ru
334,westerin,DIAMOND III,69,9.7,391,38,353,ru
335,mAv,DIAMOND III,68,30.9,149,46,103,ru
336,одичалый мастер,DIAMOND III,68,11.7,299,35,264,ru
337,REFLY,DIAMOND III,67,19.1,356,68,288,ru
338,LikeU,DIAMOND III,67,13.8,391,54,337,ru
339,Arclight SnoopCi,DIAMOND III,67,14.9,195,29,166,ru
340,squeDzilla,DIAMOND III,66,16.2,333,54,279,ru
341,Прохиндей,DIAMOND III,66,18.2,198,36,162,ru
342,fckingay,DIAMOND III,66,21.8,101,22,79,ru
343,Lovelykira,DIAMOND III,65,16.7,276,46,230,ru
344,VNM Curly,DIAMOND III,64,17.5,251,44,207,ru
345,strikeGL,DIAMOND III,64,20.0,175,35,140,ru
346,KURISU ТИНА,DIAMOND III,63,18.9,950,180,770,ru
347,gupobiluo,DIAMOND III,63,17.6,437,77,360,ru
348,SARUMAN,DIAMOND III,63,10.3,515,53,462,ru
349,kRAKEN,DIAMOND III,63,9.5,304,29,275,ru
350,Beeeeeeee,DIAMOND III,60,19.3,456,88,368,ru
351,AkimosikTFT,DIAMOND III,59,21.5,502,108,394,ru
352,менталэхо,DIAMOND III,59,24.2,165,40,125,ru
353,burunduk13,DIAMOND III,59,12.6,246,31,215,ru
354,PGod,DIAMOND III,58,23.4,184,43,141,ru
355,Xameleon Arzamas,DIAMOND III,58,10.4,347,36,311,ru
356,Xitoriki,DIAMOND III,56,12.4,153,19,134,ru
357,Wind of Change,DIAMOND III,55,16.2,117,19,98,ru
358,EnergyDashClarko,DIAMOND III,54,14.2,268,38,230,ru
359,Monitor97,DIAMOND III,53,15.1,185,28,157,ru
360,titanin,DIAMOND III,52,11.8,821,97,724,ru
361,Вялый Перчик,DIAMOND III,51,13.3,429,57,372,ru
362,Хаоса,DIAMOND III,51,15.5,200,31,169,ru
363,Afei,DIAMOND III,50,20.9,383,80,303,ru
364,Ksan Leon,DIAMOND III,49,19.4,268,52,216,ru
365,Глубже Некуда,DIAMOND III,49,6.9,522,36,486,ru
366,ChinhChinh,DIAMOND III,49,18.2,187,34,153,ru
367,NZИ,DIAMOND III,47,15.1,238,36,202,ru
368,Collide,DIAMOND III,47,18.4,179,33,146,ru
369,NinjaTips,DIAMOND III,47,21.8,101,22,79,ru
370,Amethyst,DIAMOND III,46,23.4,124,29,95,ru
371,Smokeee,DIAMOND III,46,12.5,184,23,161,ru
372,Shankly,DIAMOND III,45,17.0,276,47,229,ru
373,Ungraved,DIAMOND III,44,16.4,342,56,286,ru
374,10 12 1997,DIAMOND III,43,16.1,485,78,407,ru
375,Justnеss,DIAMOND III,43,16.5,242,40,202,ru
376,LeBron James 23,DIAMOND III,41,15.5,316,49,267,ru
377,BaJlyxa,DIAMOND III,41,21.4,140,30,110,ru
378,великая река,DIAMOND III,40,17.5,160,28,132,ru
379,rip lil feel,DIAMOND III,40,21.9,105,23,82,ru
380,Черника,DIAMOND III,39,19.4,293,57,236,ru
381,OsKvErNiTeLь,DIAMOND III,37,14.6,417,61,356,ru
382,0SemeChka0,DIAMOND III,37,22.5,173,39,134,ru
383,Guliver17,DIAMOND III,37,20.1,189,38,151,ru
384,Alyonkaa,DIAMOND III,35,12.4,420,52,368,ru
385,Gelindjer,DIAMOND III,35,16.9,189,32,157,ru
386,AnimeDeadAngel,DIAMOND III,35,15.1,212,32,180,ru
387,nook3r,DIAMOND III,34,16.1,254,41,213,ru
388,Onemelo,DIAMOND III,33,15.3,281,43,238,ru
389,Darkrayed,DIAMOND III,33,9.2,240,22,218,ru
390,kOpets,DIAMOND III,32,16.7,629,105,524,ru
391,NeBeriLopatu,DIAMOND III,32,12.6,712,90,622,ru
392,barkit,DIAMOND III,32,23.9,373,89,284,ru
393,Francis FU96785,DIAMOND III,32,26.8,112,30,82,ru
394,Panchess,DIAMOND III,31,25.0,120,30,90,ru
395,Kotleteus,DIAMOND III,30,12.3,375,46,329,ru
396,Darak,DIAMOND III,30,17.4,178,31,147,ru
397,Antananarivu,DIAMOND III,29,16.3,430,70,360,ru
398,подражание,DIAMOND III,29,14.7,415,61,354,ru
399,iNLоve,DIAMOND III,29,12.4,347,43,304,ru
400,DIGAZAR,DIAMOND III,29,13.8,174,24,150,ru
401,The Shark Dog,DIAMOND III,26,16.2,377,61,316,ru
402,motakyji,DIAMOND III,26,18.2,296,54,242,ru
403,SS best teacherr,DIAMOND III,26,8.9,169,15,154,ru
404,M1kr0n,DIAMOND III,25,25.7,237,61,176,ru
405,eXpertFr0mChat,DIAMOND III,25,22.8,246,56,190,ru
406,МГТУ Н2О VN,DIAMOND III,25,20.4,240,49,191,ru
407,IrinaStan,DIAMOND III,25,21.1,223,47,176,ru
408,Dengziqiwang,DIAMOND III,25,26.3,171,45,126,ru
409,GG Habib,DIAMOND III,25,15.5,252,39,213,ru
410,Aha1burn,DIAMOND III,25,21.9,137,30,107,ru
411,chenghaowu,DIAMOND III,25,34.2,79,27,52,ru
412,Третийглаз,DIAMOND III,25,18.9,143,27,116,ru
413,1ittle1mmortal,DIAMOND III,25,23.2,99,23,76,ru
414,ManyFaced God,DIAMOND III,24,20.3,360,73,287,ru
415,StarburstStream,DIAMOND III,24,12.2,385,47,338,ru
416,Ajbarra,DIAMOND III,23,19.1,298,57,241,ru
417,Xopycwar,DIAMOND III,23,16.8,167,28,139,ru
418,Holy Nightroad,DIAMOND III,23,10.0,239,24,215,ru
419,GreshnikDevil,DIAMOND III,22,11.7,206,24,182,ru
420,Teax,DIAMOND III,20,17.6,170,30,140,ru
421,Aglibol,DIAMOND III,19,12.9,564,73,491,ru
422,GinGL,DIAMOND III,18,17.5,200,35,165,ru
423,Igrid1,DIAMOND III,18,11.7,120,14,106,ru
424,IDreamDiamond,DIAMOND III,18,7.6,158,12,146,ru
425,Kosma,DIAMOND III,17,21.8,266,58,208,ru
426,Dragonall,DIAMOND III,17,22.8,224,51,173,ru
427,Afоnjja,DIAMOND III,17,13.0,285,37,248,ru
428,DutchAngle,DIAMOND III,17,17.0,165,28,137,ru
429,GanjaFourWay,DIAMOND III,17,9.8,194,19,175,ru
430,3610bashmak,DIAMOND III,16,15.8,297,47,250,ru
431,zergoood,DIAMOND III,15,16.2,136,22,114,ru
432,Zelosin,DIAMOND III,15,15.9,138,22,116,ru
433,Позор Джунглей,DIAMOND III,15,12.3,146,18,128,ru
434,Bùm Bùm,DIAMOND III,13,20.3,547,111,436,ru
435,EviL Holy,DIAMOND III,13,10.7,681,73,608,ru
436,Kostanayskiy,DIAMOND III,13,19.4,227,44,183,ru
437,ikorostilev,DIAMOND III,13,16.7,150,25,125,ru
438,Dev1l Ykt,DIAMOND III,11,13.5,416,56,360,ru
439,SM2LR,DIAMOND III,11,17.8,191,34,157,ru
440,NOMADEKB,DIAMOND III,11,14.9,148,22,126,ru
441,Винча,DIAMOND III,10,17.6,188,33,155,ru
442,married isSHIT,DIAMOND III,9,22.2,203,45,158,ru
443,САМКА МАЛОЛЕТКИ,DIAMOND III,9,31.2,64,20,44,ru
444,Trollpik666,DIAMOND III,9,4.6,371,17,354,ru
445,ЛоуСкил,DIAMOND III,8,12.8,405,52,353,ru
446,7ava3eans,DIAMOND III,7,7.6,912,69,843,ru
447,отправь ню,DIAMOND III,7,22.2,90,20,70,ru
448,lywh,DIAMOND III,7,13.1,61,8,53,ru
449,lukoshko,DIAMOND III,6,7.7,443,34,409,ru
450,Herr Schrödinger,DIAMOND III,6,18.6,156,29,127,ru
451,ХхX,DIAMOND III,6,11.2,160,18,142,ru
452,DOROFEEVA NASTYA,DIAMOND III,5,13.6,162,22,140,ru
453,FaraonApple,DIAMOND III,5,9.4,235,22,213,ru
454,Benedetta Love,DIAMOND III,5,10.8,185,20,165,ru
455,Georgekubi,DIAMOND III,4,28.7,87,25,62,ru
456,Raome,DIAMOND III,3,14.6,253,37,216,ru
457,Fastshott,DIAMOND III,3,12.4,226,28,198,ru
458,Ной,DIAMOND III,2,10.0,249,25,224,ru
459,Сальери,DIAMOND III,1,9.9,506,50,456,ru
460,Brentaal,DIAMOND III,1,22.8,197,45,152,ru
461,Я ЭСКОБАР,DIAMOND III,1,8.1,405,33,372,ru
462,TDK TheDikiY,DIAMOND III,1,27.8,115,32,83,ru
463,zhangyi111,DIAMOND III,1,21.6,111,24,87,ru
464,Ignotas,DIAMOND III,1,21.9,82,18,64,ru
465,Mischif,DIAMOND III,0,12.0,792,95,697,ru
466,Sukhotin,DIAMOND III,0,24.4,311,76,235,ru
467,Stavron,DIAMOND III,0,20.8,355,74,281,ru
468,Alive4ever,DIAMOND III,0,18.1,343,62,281,ru
469,Fack you girl,DIAMOND III,0,15.9,351,56,295,ru
470,Call Me OniChan,DIAMOND III,0,10.8,516,56,460,ru
471,Hybas,DIAMOND III,0,16.6,320,53,267,ru
472,DonJuanHS,DIAMOND III,0,15.9,289,46,243,ru
473,FG KING rank1,DIAMOND III,0,19.6,230,45,185,ru
474,GothMercer,DIAMOND III,0,16.0,281,45,236,ru
475,DeathBeats,DIAMOND III,0,15.5,284,44,240,ru
476,ToxIIcTEN,DIAMOND III,0,17.1,251,43,208,ru
477,XХXTENTAСION,DIAMOND III,0,11.8,322,38,284,ru
478,Demanessa,DIAMOND III,0,24.7,150,37,113,ru
479,Luuthienan,DIAMOND III,0,26.9,134,36,98,ru
480,China BaoBao,DIAMOND III,0,26.3,133,35,98,ru
481,DeathWeeng,DIAMOND III,0,9.7,352,34,318,ru
482,Ozarin,DIAMOND III,0,8.9,383,34,349,ru
483,spaNe,DIAMOND III,0,31.4,102,32,70,ru
484,EA7 AshpAreniJ,DIAMOND III,0,19.8,162,32,130,ru
485,Die Young,DIAMOND III,0,26.5,113,30,83,ru
486,Чики Бoмбини,DIAMOND III,0,12.4,241,30,211,ru
487,55dd,DIAMOND III,0,13.3,218,29,189,ru
488,little ma,DIAMOND III,0,32.5,83,27,56,ru
489,Xлeбушeк,DIAMOND III,0,16.3,166,27,139,ru
490,Ласточка,DIAMOND III,0,13.8,166,23,143,ru
491,Angostura,DIAMOND III,0,21.6,97,21,76,ru
492,Kaitouz,DIAMOND III,0,18.8,112,21,91,ru
493,MaMa Я Не РаК,DIAMOND III,0,11.9,176,21,155,ru
494,АНГЕЛСМЕРТИ2009,DIAMOND III,0,16.9,118,20,98,ru
495,White BloodAngel,DIAMOND III,0,16.0,119,19,100,ru
496,Stan Truman,DIAMOND III,0,11.2,170,19,151,ru
497,Jedis2C2S,DIAMOND III,0,15.3,111,17,94,ru
498,SУKA,DIAMOND IV,99,16.4,542,89,453,ru
499,TiltMasta,DIAMOND IV,96,14.5,145,21,124,ru
500,AzureDn,DIAMOND IV,95,17.3,202,35,167,ru
